"user_id","n","cum","index","person","cum_prop","index_prop","tolabel"
"<anonymized_userid>",171,171,1,"Geert Wilders (PVV)",0.0030230708035004,9.50570342205323e-05,0
"<anonymized_userid>",156,327,2,"Geert Wilders (PVV)",0.00578095995757094,0.000190114068441065,0
"<anonymized_userid>",155,482,3,"Geert Wilders (PVV)",0.00852117033501282,0.000285171102661597,0
"<anonymized_userid>",145,627,4,"Geert Wilders (PVV)",0.0110845929461681,0.000380228136882129,0
"<anonymized_userid>",145,772,5,"Geert Wilders (PVV)",0.0136480155573234,0.000475285171102662,0
"<anonymized_userid>",144,916,6,"Geert Wilders (PVV)",0.0161937593918501,0.000570342205323194,0
"<anonymized_userid>",144,1060,7,"Geert Wilders (PVV)",0.0187395032263767,0.000665399239543726,0
"<anonymized_userid>",143,1203,8,"Geert Wilders (PVV)",0.0212675682842747,0.000760456273764259,0
"<anonymized_userid>",142,1345,9,"Geert Wilders (PVV)",0.0237779545655441,0.000855513307984791,0
"<anonymized_userid>",141,1486,10,"Geert Wilders (PVV)",0.0262706620701847,0.000950570342205323,0
"<anonymized_userid>",139,1625,11,"Geert Wilders (PVV)",0.0287280120215681,0.00104562737642586,0
"<anonymized_userid>",137,1762,12,"Geert Wilders (PVV)",0.0311500044196942,0.00114068441064639,0
"<anonymized_userid>",137,1899,13,"Geert Wilders (PVV)",0.0335719968178202,0.00123574144486692,0
"<anonymized_userid>",137,2036,14,"Geert Wilders (PVV)",0.0359939892159463,0.00133079847908745,0
"<anonymized_userid>",137,2173,15,"Geert Wilders (PVV)",0.0384159816140723,0.00142585551330798,0
"<anonymized_userid>",135,2308,16,"Geert Wilders (PVV)",0.040802616458941,0.00152091254752852,0
"<anonymized_userid>",134,2442,17,"Geert Wilders (PVV)",0.0431715725271811,0.00161596958174905,0
"<anonymized_userid>",127,2569,18,"Geert Wilders (PVV)",0.0454167771590206,0.00171102661596958,0
"<anonymized_userid>",125,2694,19,"Geert Wilders (PVV)",0.0476266242376028,0.00180608365019011,0
"<anonymized_userid>",124,2818,20,"Geert Wilders (PVV)",0.0498187925395563,0.00190114068441065,0
"<anonymized_userid>",123,2941,21,"Geert Wilders (PVV)",0.0519932820648811,0.00199619771863118,0
"<anonymized_userid>",123,3064,22,"Geert Wilders (PVV)",0.054167771590206,0.00209125475285171,0
"<anonymized_userid>",122,3186,23,"Geert Wilders (PVV)",0.0563245823389021,0.00218631178707224,0
"<anonymized_userid>",122,3308,24,"Geert Wilders (PVV)",0.0584813930875983,0.00228136882129278,0
"<anonymized_userid>",120,3428,25,"Geert Wilders (PVV)",0.0606028462830372,0.00237642585551331,0
"<anonymized_userid>",120,3548,26,"Geert Wilders (PVV)",0.0627242994784761,0.00247148288973384,0
"<anonymized_userid>",119,3667,27,"Geert Wilders (PVV)",0.0648280738972863,0.00256653992395437,0
"<anonymized_userid>",117,3784,28,"Geert Wilders (PVV)",0.0668964907628392,0.0026615969581749,0
"<anonymized_userid>",117,3901,29,"Geert Wilders (PVV)",0.0689649076283921,0.00275665399239544,0
"<anonymized_userid>",117,4018,30,"Geert Wilders (PVV)",0.071033324493945,0.00285171102661597,0
"<anonymized_userid>",115,4133,31,"Geert Wilders (PVV)",0.0730663838062406,0.0029467680608365,0
"<anonymized_userid>",114,4247,32,"Geert Wilders (PVV)",0.0750817643419075,0.00304182509505703,0
"<anonymized_userid>",114,4361,33,"Geert Wilders (PVV)",0.0770971448775745,0.00313688212927757,0
"<anonymized_userid>",114,4475,34,"Geert Wilders (PVV)",0.0791125254132414,0.0032319391634981,0
"<anonymized_userid>",113,4588,35,"Geert Wilders (PVV)",0.0811102271722797,0.00332699619771863,0
"<anonymized_userid>",112,4700,36,"Geert Wilders (PVV)",0.0830902501546893,0.00342205323193916,0
"<anonymized_userid>",112,4812,37,"Geert Wilders (PVV)",0.0850702731370989,0.0035171102661597,0
"<anonymized_userid>",110,4922,38,"Geert Wilders (PVV)",0.0870149385662512,0.00361216730038023,0
"<anonymized_userid>",110,5032,39,"Geert Wilders (PVV)",0.0889596039954035,0.00370722433460076,0
"<anonymized_userid>",110,5142,40,"Geert Wilders (PVV)",0.0909042694245558,0.00380228136882129,0
"<anonymized_userid>",108,5250,41,"Geert Wilders (PVV)",0.0928135773004508,0.00389733840304182,0
"<anonymized_userid>",107,5357,42,"Geert Wilders (PVV)",0.0947052063997171,0.00399239543726236,0
"<anonymized_userid>",107,5464,43,"Geert Wilders (PVV)",0.0965968354989835,0.00408745247148289,0
"<anonymized_userid>",107,5571,44,"Geert Wilders (PVV)",0.0984884645982498,0.00418250950570342,0
"<anonymized_userid>",105,5676,45,"Geert Wilders (PVV)",0.100344736144259,0.00427756653992395,0
"<anonymized_userid>",104,5780,46,"Geert Wilders (PVV)",0.102183328913639,0.00437262357414449,0
"<anonymized_userid>",104,5884,47,"Geert Wilders (PVV)",0.10402192168302,0.00446768060836502,0
"<anonymized_userid>",104,5988,48,"Geert Wilders (PVV)",0.1058605144524,0.00456273764258555,0
"<anonymized_userid>",103,6091,49,"Geert Wilders (PVV)",0.107681428445152,0.00465779467680608,0
"<anonymized_userid>",101,6192,50,"Geert Wilders (PVV)",0.109466984884646,0.00475285171102662,0
"<anonymized_userid>",100,6292,51,"Geert Wilders (PVV)",0.111234862547512,0.00484790874524715,0
"<anonymized_userid>",98,6390,52,"Geert Wilders (PVV)",0.11296738265712,0.00494296577946768,0
"<anonymized_userid>",98,6488,53,"Geert Wilders (PVV)",0.114699902766729,0.00503802281368821,0
"<anonymized_userid>",97,6585,54,"Geert Wilders (PVV)",0.116414744099708,0.00513307984790875,0
"<anonymized_userid>",95,6680,55,"Geert Wilders (PVV)",0.118094227879431,0.00522813688212928,0
"<anonymized_userid>",95,6775,56,"Geert Wilders (PVV)",0.119773711659153,0.00532319391634981,0
"<anonymized_userid>",95,6870,57,"Geert Wilders (PVV)",0.121453195438876,0.00541825095057034,0
"<anonymized_userid>",95,6965,58,"Geert Wilders (PVV)",0.123132679218598,0.00551330798479087,0
"<anonymized_userid>",94,7059,59,"Geert Wilders (PVV)",0.124794484221692,0.00560836501901141,0
"<anonymized_userid>",93,7152,60,"Geert Wilders (PVV)",0.126438610448157,0.00570342205323194,0
"<anonymized_userid>",92,7244,61,"Geert Wilders (PVV)",0.128065057897993,0.00579847908745247,0
"<anonymized_userid>",90,7334,62,"Geert Wilders (PVV)",0.129656147794573,0.005893536121673,0
"<anonymized_userid>",90,7424,63,"Geert Wilders (PVV)",0.131247237691152,0.00598859315589354,0
"<anonymized_userid>",90,7514,64,"Geert Wilders (PVV)",0.132838327587731,0.00608365019011407,0
"<anonymized_userid>",89,7603,65,"Geert Wilders (PVV)",0.134411738707681,0.0061787072243346,0
"<anonymized_userid>",88,7691,66,"Geert Wilders (PVV)",0.135967471051003,0.00627376425855513,0
"<anonymized_userid>",87,7778,67,"Geert Wilders (PVV)",0.137505524617696,0.00636882129277567,0
"<anonymized_userid>",86,7864,68,"Geert Wilders (PVV)",0.139025899407761,0.0064638783269962,0
"<anonymized_userid>",86,7950,69,"Geert Wilders (PVV)",0.140546274197826,0.00655893536121673,0
"<anonymized_userid>",85,8035,70,"Geert Wilders (PVV)",0.142048970211261,0.00665399239543726,0
"<anonymized_userid>",85,8120,71,"Geert Wilders (PVV)",0.143551666224697,0.00674904942965779,0
"<anonymized_userid>",85,8205,72,"Geert Wilders (PVV)",0.145054362238133,0.00684410646387833,0
"<anonymized_userid>",84,8289,73,"Geert Wilders (PVV)",0.14653937947494,0.00693916349809886,0
"<anonymized_userid>",84,8373,74,"Geert Wilders (PVV)",0.148024396711748,0.00703422053231939,0
"<anonymized_userid>",83,8456,75,"Geert Wilders (PVV)",0.149491735171926,0.00712927756653992,0
"<anonymized_userid>",82,8538,76,"Geert Wilders (PVV)",0.150941394855476,0.00722433460076046,0
"<anonymized_userid>",81,8619,77,"Geert Wilders (PVV)",0.152373375762397,0.00731939163498099,0
"<anonymized_userid>",81,8700,78,"Geert Wilders (PVV)",0.153805356669318,0.00741444866920152,0
"<anonymized_userid>",81,8781,79,"Geert Wilders (PVV)",0.15523733757624,0.00750950570342205,0
"<anonymized_userid>",80,8861,80,"Geert Wilders (PVV)",0.156651639706532,0.00760456273764259,0
"<anonymized_userid>",80,8941,81,"Geert Wilders (PVV)",0.158065941836825,0.00769961977186312,0
"<anonymized_userid>",80,9021,82,"Geert Wilders (PVV)",0.159480243967117,0.00779467680608365,0
"<anonymized_userid>",80,9101,83,"Geert Wilders (PVV)",0.16089454609741,0.00788973384030418,0
"<anonymized_userid>",80,9181,84,"Geert Wilders (PVV)",0.162308848227703,0.00798479087452472,0
"<anonymized_userid>",78,9259,85,"Geert Wilders (PVV)",0.163687792804738,0.00807984790874525,0
"<anonymized_userid>",78,9337,86,"Geert Wilders (PVV)",0.165066737381773,0.00817490494296578,0
"<anonymized_userid>",78,9415,87,"Geert Wilders (PVV)",0.166445681958808,0.00826996197718631,0
"<anonymized_userid>",76,9491,88,"Geert Wilders (PVV)",0.167789268982586,0.00836501901140684,0
"<anonymized_userid>",75,9566,89,"Geert Wilders (PVV)",0.169115177229736,0.00846007604562738,0
"<anonymized_userid>",74,9640,90,"Geert Wilders (PVV)",0.170423406700256,0.00855513307984791,0
"<anonymized_userid>",74,9714,91,"Geert Wilders (PVV)",0.171731636170777,0.00865019011406844,0
"<anonymized_userid>",74,9788,92,"Geert Wilders (PVV)",0.173039865641298,0.00874524714828897,0
"<anonymized_userid>",74,9862,93,"Geert Wilders (PVV)",0.174348095111818,0.00884030418250951,0
"<anonymized_userid>",73,9935,94,"Geert Wilders (PVV)",0.17563864580571,0.00893536121673004,0
"<anonymized_userid>",72,10007,95,"Geert Wilders (PVV)",0.176911517722974,0.00903041825095057,0
"<anonymized_userid>",72,10079,96,"Geert Wilders (PVV)",0.178184389640237,0.0091254752851711,0
"<anonymized_userid>",72,10151,97,"Geert Wilders (PVV)",0.1794572615575,0.00922053231939163,0
"<anonymized_userid>",71,10222,98,"Geert Wilders (PVV)",0.180712454698135,0.00931558935361217,0
"<anonymized_userid>",71,10293,99,"Geert Wilders (PVV)",0.18196764783877,0.0094106463878327,0
"<anonymized_userid>",70,10363,100,"Geert Wilders (PVV)",0.183205162202776,0.00950570342205323,0
"<anonymized_userid>",70,10433,101,"Geert Wilders (PVV)",0.184442676566782,0.00960076045627376,0
"<anonymized_userid>",69,10502,102,"Geert Wilders (PVV)",0.185662512154159,0.0096958174904943,0
"<anonymized_userid>",69,10571,103,"Geert Wilders (PVV)",0.186882347741536,0.00979087452471483,0
"<anonymized_userid>",68,10639,104,"Geert Wilders (PVV)",0.188084504552285,0.00988593155893536,0
"<anonymized_userid>",68,10707,105,"Geert Wilders (PVV)",0.189286661363034,0.00998098859315589,0
"<anonymized_userid>",68,10775,106,"Geert Wilders (PVV)",0.190488818173782,0.0100760456273764,0
"<anonymized_userid>",68,10843,107,"Geert Wilders (PVV)",0.191690974984531,0.010171102661597,0
"<anonymized_userid>",67,10910,108,"Geert Wilders (PVV)",0.192875453018651,0.0102661596958175,0
"<anonymized_userid>",67,10977,109,"Geert Wilders (PVV)",0.194059931052771,0.010361216730038,0
"<anonymized_userid>",67,11044,110,"Geert Wilders (PVV)",0.195244409086891,0.0104562737642586,0
"<anonymized_userid>",66,11110,111,"Geert Wilders (PVV)",0.196411208344383,0.0105513307984791,0
"<anonymized_userid>",66,11176,112,"Geert Wilders (PVV)",0.197578007601874,0.0106463878326996,0
"<anonymized_userid>",66,11242,113,"Geert Wilders (PVV)",0.198744806859365,0.0107414448669202,0
"<anonymized_userid>",65,11307,114,"Geert Wilders (PVV)",0.199893927340228,0.0108365019011407,0
"<anonymized_userid>",65,11372,115,"Geert Wilders (PVV)",0.201043047821091,0.0109315589353612,0
"<anonymized_userid>",65,11437,116,"Geert Wilders (PVV)",0.202192168301953,0.0110266159695817,0
"<anonymized_userid>",64,11501,117,"Geert Wilders (PVV)",0.203323610006188,0.0111216730038023,0
"<anonymized_userid>",64,11565,118,"Geert Wilders (PVV)",0.204455051710422,0.0112167300380228,0
"<anonymized_userid>",64,11629,119,"Geert Wilders (PVV)",0.205586493414656,0.0113117870722433,0
"<anonymized_userid>",63,11692,120,"Geert Wilders (PVV)",0.206700256342261,0.0114068441064639,0
"<anonymized_userid>",63,11755,121,"Geert Wilders (PVV)",0.207814019269867,0.0115019011406844,0
"<anonymized_userid>",62,11817,122,"Geert Wilders (PVV)",0.208910103420843,0.0115969581749049,0
"<anonymized_userid>",62,11879,123,"Geert Wilders (PVV)",0.21000618757182,0.0116920152091255,0
"<anonymized_userid>",61,11940,124,"Geert Wilders (PVV)",0.211084592946168,0.011787072243346,0
"<anonymized_userid>",61,12001,125,"Geert Wilders (PVV)",0.212162998320516,0.0118821292775665,0
"<anonymized_userid>",61,12062,126,"Geert Wilders (PVV)",0.213241403694864,0.0119771863117871,0
"<anonymized_userid>",60,12122,127,"Geert Wilders (PVV)",0.214302130292584,0.0120722433460076,0
"<anonymized_userid>",60,12182,128,"Geert Wilders (PVV)",0.215362856890303,0.0121673003802281,0
"<anonymized_userid>",60,12242,129,"Geert Wilders (PVV)",0.216423583488023,0.0122623574144487,0
"<anonymized_userid>",60,12302,130,"Geert Wilders (PVV)",0.217484310085742,0.0123574144486692,0
"<anonymized_userid>",60,12362,131,"Geert Wilders (PVV)",0.218545036683462,0.0124524714828897,0
"<anonymized_userid>",59,12421,132,"Geert Wilders (PVV)",0.219588084504552,0.0125475285171103,0
"<anonymized_userid>",59,12480,133,"Geert Wilders (PVV)",0.220631132325643,0.0126425855513308,0
"<anonymized_userid>",59,12539,134,"Geert Wilders (PVV)",0.221674180146734,0.0127376425855513,0
"<anonymized_userid>",59,12598,135,"Geert Wilders (PVV)",0.222717227967825,0.0128326996197719,0
"<anonymized_userid>",59,12657,136,"Geert Wilders (PVV)",0.223760275788915,0.0129277566539924,0
"<anonymized_userid>",58,12715,137,"Geert Wilders (PVV)",0.224785644833378,0.0130228136882129,0
"<anonymized_userid>",57,12772,138,"Geert Wilders (PVV)",0.225793335101211,0.0131178707224335,0
"<anonymized_userid>",57,12829,139,"Geert Wilders (PVV)",0.226801025369044,0.013212927756654,0
"<anonymized_userid>",57,12886,140,"Geert Wilders (PVV)",0.227808715636878,0.0133079847908745,0
"<anonymized_userid>",57,12943,141,"Geert Wilders (PVV)",0.228816405904711,0.0134030418250951,0
"<anonymized_userid>",57,13000,142,"Geert Wilders (PVV)",0.229824096172545,0.0134980988593156,0
"<anonymized_userid>",57,13057,143,"Geert Wilders (PVV)",0.230831786440378,0.0135931558935361,0
"<anonymized_userid>",56,13113,144,"Geert Wilders (PVV)",0.231821797931583,0.0136882129277567,0
"<anonymized_userid>",56,13169,145,"Geert Wilders (PVV)",0.232811809422788,0.0137832699619772,0
"<anonymized_userid>",56,13225,146,"Geert Wilders (PVV)",0.233801820913993,0.0138783269961977,0
"<anonymized_userid>",56,13281,147,"Geert Wilders (PVV)",0.234791832405198,0.0139733840304183,0
"<anonymized_userid>",56,13337,148,"Geert Wilders (PVV)",0.235781843896402,0.0140684410646388,0
"<anonymized_userid>",55,13392,149,"Geert Wilders (PVV)",0.236754176610979,0.0141634980988593,0
"<anonymized_userid>",55,13447,150,"Geert Wilders (PVV)",0.237726509325555,0.0142585551330798,0
"<anonymized_userid>",55,13502,151,"Geert Wilders (PVV)",0.238698842040131,0.0143536121673004,0
"<anonymized_userid>",55,13557,152,"Geert Wilders (PVV)",0.239671174754707,0.0144486692015209,0
"<anonymized_userid>",55,13612,153,"Geert Wilders (PVV)",0.240643507469283,0.0145437262357414,0
"<anonymized_userid>",54,13666,154,"Geert Wilders (PVV)",0.241598161407231,0.014638783269962,0
"<anonymized_userid>",54,13720,155,"Geert Wilders (PVV)",0.242552815345178,0.0147338403041825,0
"<anonymized_userid>",54,13774,156,"Geert Wilders (PVV)",0.243507469283126,0.014828897338403,0
"<anonymized_userid>",54,13828,157,"Geert Wilders (PVV)",0.244462123221073,0.0149239543726236,0
"<anonymized_userid>",54,13882,158,"Geert Wilders (PVV)",0.245416777159021,0.0150190114068441,0
"<anonymized_userid>",54,13936,159,"Geert Wilders (PVV)",0.246371431096968,0.0151140684410646,0
"<anonymized_userid>",54,13990,160,"Geert Wilders (PVV)",0.247326085034916,0.0152091254752852,0
"<anonymized_userid>",53,14043,161,"Geert Wilders (PVV)",0.248263060196234,0.0153041825095057,0
"<anonymized_userid>",53,14096,162,"Geert Wilders (PVV)",0.249200035357553,0.0153992395437262,0
"<anonymized_userid>",53,14149,163,"Geert Wilders (PVV)",0.250137010518872,0.0154942965779468,0
"<anonymized_userid>",53,14202,164,"Geert Wilders (PVV)",0.251073985680191,0.0155893536121673,0
"<anonymized_userid>",53,14255,165,"Geert Wilders (PVV)",0.25201096084151,0.0156844106463878,0
"<anonymized_userid>",52,14307,166,"Geert Wilders (PVV)",0.2529302572262,0.0157794676806084,0
"<anonymized_userid>",52,14359,167,"Geert Wilders (PVV)",0.25384955361089,0.0158745247148289,0
"<anonymized_userid>",52,14411,168,"Geert Wilders (PVV)",0.25476884999558,0.0159695817490494,0
"<anonymized_userid>",52,14463,169,"Geert Wilders (PVV)",0.25568814638027,0.01606463878327,0
"<anonymized_userid>",52,14515,170,"Geert Wilders (PVV)",0.256607442764961,0.0161596958174905,0
"<anonymized_userid>",52,14567,171,"Geert Wilders (PVV)",0.257526739149651,0.016254752851711,0
"<anonymized_userid>",51,14618,172,"Geert Wilders (PVV)",0.258428356757712,0.0163498098859316,0
"<anonymized_userid>",51,14669,173,"Geert Wilders (PVV)",0.259329974365774,0.0164448669201521,0
"<anonymized_userid>",51,14720,174,"Geert Wilders (PVV)",0.260231591973835,0.0165399239543726,0
"<anonymized_userid>",51,14771,175,"Geert Wilders (PVV)",0.261133209581897,0.0166349809885932,0
"<anonymized_userid>",50,14821,176,"Geert Wilders (PVV)",0.26201714841333,0.0167300380228137,0
"<anonymized_userid>",50,14871,177,"Geert Wilders (PVV)",0.262901087244763,0.0168250950570342,0
"<anonymized_userid>",50,14921,178,"Geert Wilders (PVV)",0.263785026076196,0.0169201520912548,0
"<anonymized_userid>",50,14971,179,"Geert Wilders (PVV)",0.264668964907628,0.0170152091254753,0
"<anonymized_userid>",50,15021,180,"Geert Wilders (PVV)",0.265552903739061,0.0171102661596958,0
"<anonymized_userid>",50,15071,181,"Geert Wilders (PVV)",0.266436842570494,0.0172053231939163,0
"<anonymized_userid>",49,15120,182,"Geert Wilders (PVV)",0.267303102625298,0.0173003802281369,0
"<anonymized_userid>",49,15169,183,"Geert Wilders (PVV)",0.268169362680103,0.0173954372623574,0
"<anonymized_userid>",49,15218,184,"Geert Wilders (PVV)",0.269035622734907,0.0174904942965779,0
"<anonymized_userid>",49,15267,185,"Geert Wilders (PVV)",0.269901882789711,0.0175855513307985,0
"<anonymized_userid>",49,15316,186,"Geert Wilders (PVV)",0.270768142844515,0.017680608365019,0
"<anonymized_userid>",49,15365,187,"Geert Wilders (PVV)",0.271634402899319,0.0177756653992395,0
"<anonymized_userid>",49,15414,188,"Geert Wilders (PVV)",0.272500662954124,0.0178707224334601,0
"<anonymized_userid>",49,15463,189,"Geert Wilders (PVV)",0.273366923008928,0.0179657794676806,0
"<anonymized_userid>",49,15512,190,"Geert Wilders (PVV)",0.274233183063732,0.0180608365019011,0
"<anonymized_userid>",49,15561,191,"Geert Wilders (PVV)",0.275099443118536,0.0181558935361217,0
"<anonymized_userid>",48,15609,192,"Geert Wilders (PVV)",0.275948024396712,0.0182509505703422,0
"<anonymized_userid>",48,15657,193,"Geert Wilders (PVV)",0.276796605674887,0.0183460076045627,0
"<anonymized_userid>",48,15705,194,"Geert Wilders (PVV)",0.277645186953063,0.0184410646387833,0
"<anonymized_userid>",48,15753,195,"Geert Wilders (PVV)",0.278493768231238,0.0185361216730038,0
"<anonymized_userid>",48,15801,196,"Geert Wilders (PVV)",0.279342349509414,0.0186311787072243,0
"<anonymized_userid>",48,15849,197,"Geert Wilders (PVV)",0.280190930787589,0.0187262357414449,0
"<anonymized_userid>",48,15897,198,"Geert Wilders (PVV)",0.281039512065765,0.0188212927756654,0
"<anonymized_userid>",48,15945,199,"Geert Wilders (PVV)",0.281888093343941,0.0189163498098859,0
"<anonymized_userid>",48,15993,200,"Geert Wilders (PVV)",0.282736674622116,0.0190114068441065,0
"<anonymized_userid>",47,16040,201,"Geert Wilders (PVV)",0.283567577123663,0.019106463878327,0
"<anonymized_userid>",47,16087,202,"Geert Wilders (PVV)",0.28439847962521,0.0192015209125475,0
"<anonymized_userid>",47,16134,203,"Geert Wilders (PVV)",0.285229382126757,0.0192965779467681,0
"<anonymized_userid>",47,16181,204,"Geert Wilders (PVV)",0.286060284628304,0.0193916349809886,0
"<anonymized_userid>",47,16228,205,"Geert Wilders (PVV)",0.286891187129851,0.0194866920152091,0
"<anonymized_userid>",47,16275,206,"Geert Wilders (PVV)",0.287722089631398,0.0195817490494297,0
"<anonymized_userid>",47,16322,207,"Geert Wilders (PVV)",0.288552992132944,0.0196768060836502,0
"<anonymized_userid>",47,16369,208,"Geert Wilders (PVV)",0.289383894634491,0.0197718631178707,0
"<anonymized_userid>",46,16415,209,"Geert Wilders (PVV)",0.29019711835941,0.0198669201520913,0
"<anonymized_userid>",46,16461,210,"Geert Wilders (PVV)",0.291010342084328,0.0199619771863118,0
"<anonymized_userid>",46,16507,211,"Geert Wilders (PVV)",0.291823565809246,0.0200570342205323,0
"<anonymized_userid>",45,16552,212,"Geert Wilders (PVV)",0.292619110757536,0.0201520912547529,0
"<anonymized_userid>",45,16597,213,"Geert Wilders (PVV)",0.293414655705825,0.0202471482889734,0
"<anonymized_userid>",45,16642,214,"Geert Wilders (PVV)",0.294210200654115,0.0203422053231939,0
"<anonymized_userid>",45,16687,215,"Geert Wilders (PVV)",0.295005745602404,0.0204372623574144,0
"<anonymized_userid>",45,16732,216,"Geert Wilders (PVV)",0.295801290550694,0.020532319391635,0
"<anonymized_userid>",45,16777,217,"Geert Wilders (PVV)",0.296596835498983,0.0206273764258555,0
"<anonymized_userid>",45,16822,218,"Geert Wilders (PVV)",0.297392380447273,0.020722433460076,0
"<anonymized_userid>",44,16866,219,"Geert Wilders (PVV)",0.298170246618934,0.0208174904942966,0
"<anonymized_userid>",44,16910,220,"Geert Wilders (PVV)",0.298948112790595,0.0209125475285171,0
"<anonymized_userid>",44,16954,221,"Geert Wilders (PVV)",0.299725978962256,0.0210076045627376,0
"<anonymized_userid>",44,16998,222,"Geert Wilders (PVV)",0.300503845133917,0.0211026615969582,0
"<anonymized_userid>",44,17042,223,"Geert Wilders (PVV)",0.301281711305578,0.0211977186311787,0
"<anonymized_userid>",44,17086,224,"Geert Wilders (PVV)",0.302059577477239,0.0212927756653992,0
"<anonymized_userid>",44,17130,225,"Geert Wilders (PVV)",0.302837443648899,0.0213878326996198,0
"<anonymized_userid>",44,17174,226,"Geert Wilders (PVV)",0.30361530982056,0.0214828897338403,0
"<anonymized_userid>",43,17217,227,"Geert Wilders (PVV)",0.304375497215593,0.0215779467680608,0
"<anonymized_userid>",43,17260,228,"Geert Wilders (PVV)",0.305135684610625,0.0216730038022814,0
"<anonymized_userid>",43,17303,229,"Geert Wilders (PVV)",0.305895872005657,0.0217680608365019,0
"<anonymized_userid>",43,17346,230,"Geert Wilders (PVV)",0.306656059400689,0.0218631178707224,0
"<anonymized_userid>",43,17389,231,"Geert Wilders (PVV)",0.307416246795722,0.021958174904943,0
"<anonymized_userid>",43,17432,232,"Geert Wilders (PVV)",0.308176434190754,0.0220532319391635,0
"<anonymized_userid>",43,17475,233,"Geert Wilders (PVV)",0.308936621585786,0.022148288973384,0
"<anonymized_userid>",43,17518,234,"Geert Wilders (PVV)",0.309696808980819,0.0222433460076046,0
"<anonymized_userid>",43,17561,235,"Geert Wilders (PVV)",0.310456996375851,0.0223384030418251,0
"<anonymized_userid>",43,17604,236,"Geert Wilders (PVV)",0.311217183770883,0.0224334600760456,0
"<anonymized_userid>",43,17647,237,"Geert Wilders (PVV)",0.311977371165915,0.0225285171102662,0
"<anonymized_userid>",42,17689,238,"Geert Wilders (PVV)",0.312719879784319,0.0226235741444867,0
"<anonymized_userid>",42,17731,239,"Geert Wilders (PVV)",0.313462388402723,0.0227186311787072,0
"<anonymized_userid>",42,17773,240,"Geert Wilders (PVV)",0.314204897021126,0.0228136882129278,0
"<anonymized_userid>",42,17815,241,"Geert Wilders (PVV)",0.31494740563953,0.0229087452471483,0
"<anonymized_userid>",42,17857,242,"Geert Wilders (PVV)",0.315689914257933,0.0230038022813688,0
"<anonymized_userid>",42,17899,243,"Geert Wilders (PVV)",0.316432422876337,0.0230988593155894,0
"<anonymized_userid>",42,17941,244,"Geert Wilders (PVV)",0.317174931494741,0.0231939163498099,0
"<anonymized_userid>",42,17983,245,"Geert Wilders (PVV)",0.317917440113144,0.0232889733840304,0
"<anonymized_userid>",42,18025,246,"Geert Wilders (PVV)",0.318659948731548,0.023384030418251,0
"<anonymized_userid>",42,18067,247,"Geert Wilders (PVV)",0.319402457349951,0.0234790874524715,0
"<anonymized_userid>",41,18108,248,"Geert Wilders (PVV)",0.320127287191726,0.023574144486692,0
"<anonymized_userid>",41,18149,249,"Geert Wilders (PVV)",0.320852117033501,0.0236692015209125,0
"<anonymized_userid>",41,18190,250,"Geert Wilders (PVV)",0.321576946875276,0.0237642585551331,0
"<anonymized_userid>",41,18231,251,"Geert Wilders (PVV)",0.322301776717051,0.0238593155893536,0
"<anonymized_userid>",41,18272,252,"Geert Wilders (PVV)",0.323026606558826,0.0239543726235741,0
"<anonymized_userid>",41,18313,253,"Geert Wilders (PVV)",0.323751436400601,0.0240494296577947,0
"<anonymized_userid>",41,18354,254,"Geert Wilders (PVV)",0.324476266242376,0.0241444866920152,0
"<anonymized_userid>",40,18394,255,"Geert Wilders (PVV)",0.325183417307522,0.0242395437262357,0
"<anonymized_userid>",40,18434,256,"Geert Wilders (PVV)",0.325890568372669,0.0243346007604563,0
"<anonymized_userid>",40,18474,257,"Geert Wilders (PVV)",0.326597719437815,0.0244296577946768,0
"<anonymized_userid>",40,18514,258,"Geert Wilders (PVV)",0.327304870502961,0.0245247148288973,0
"<anonymized_userid>",40,18554,259,"Geert Wilders (PVV)",0.328012021568107,0.0246197718631179,0
"<anonymized_userid>",40,18594,260,"Geert Wilders (PVV)",0.328719172633254,0.0247148288973384,0
"<anonymized_userid>",40,18634,261,"Geert Wilders (PVV)",0.3294263236984,0.0248098859315589,0
"<anonymized_userid>",40,18674,262,"Geert Wilders (PVV)",0.330133474763546,0.0249049429657795,0
"<anonymized_userid>",40,18714,263,"Geert Wilders (PVV)",0.330840625828693,0.025,0
"<anonymized_userid>",40,18754,264,"Geert Wilders (PVV)",0.331547776893839,0.0250950570342205,0
"<anonymized_userid>",39,18793,265,"Geert Wilders (PVV)",0.332237249182357,0.0251901140684411,0
"<anonymized_userid>",39,18832,266,"Geert Wilders (PVV)",0.332926721470874,0.0252851711026616,0
"<anonymized_userid>",39,18871,267,"Geert Wilders (PVV)",0.333616193759392,0.0253802281368821,0
"<anonymized_userid>",39,18910,268,"Geert Wilders (PVV)",0.33430566604791,0.0254752851711027,0
"<anonymized_userid>",39,18949,269,"Geert Wilders (PVV)",0.334995138336427,0.0255703422053232,0
"<anonymized_userid>",39,18988,270,"Geert Wilders (PVV)",0.335684610624945,0.0256653992395437,0
"<anonymized_userid>",39,19027,271,"Geert Wilders (PVV)",0.336374082913462,0.0257604562737643,0
"<anonymized_userid>",39,19066,272,"Geert Wilders (PVV)",0.33706355520198,0.0258555133079848,0
"<anonymized_userid>",39,19105,273,"Geert Wilders (PVV)",0.337753027490498,0.0259505703422053,0
"<anonymized_userid>",38,19143,274,"Geert Wilders (PVV)",0.338424821002387,0.0260456273764259,0
"<anonymized_userid>",38,19181,275,"Geert Wilders (PVV)",0.339096614514276,0.0261406844106464,0
"<anonymized_userid>",38,19219,276,"Geert Wilders (PVV)",0.339768408026165,0.0262357414448669,0
"<anonymized_userid>",38,19257,277,"Geert Wilders (PVV)",0.340440201538054,0.0263307984790875,0
"<anonymized_userid>",38,19295,278,"Geert Wilders (PVV)",0.341111995049943,0.026425855513308,0
"<anonymized_userid>",38,19333,279,"Geert Wilders (PVV)",0.341783788561832,0.0265209125475285,0
"<anonymized_userid>",38,19371,280,"Geert Wilders (PVV)",0.342455582073721,0.026615969581749,0
"<anonymized_userid>",37,19408,281,"Geert Wilders (PVV)",0.343109696808981,0.0267110266159696,0
"<anonymized_userid>",37,19445,282,"Geert Wilders (PVV)",0.343763811544241,0.0268060836501901,0
"<anonymized_userid>",37,19482,283,"Geert Wilders (PVV)",0.344417926279501,0.0269011406844106,0
"<anonymized_userid>",37,19519,284,"Geert Wilders (PVV)",0.345072041014762,0.0269961977186312,0
"<anonymized_userid>",37,19556,285,"Geert Wilders (PVV)",0.345726155750022,0.0270912547528517,0
"<anonymized_userid>",37,19593,286,"Geert Wilders (PVV)",0.346380270485282,0.0271863117870722,0
"<anonymized_userid>",37,19630,287,"Geert Wilders (PVV)",0.347034385220543,0.0272813688212928,0
"<anonymized_userid>",36,19666,288,"Geert Wilders (PVV)",0.347670821179174,0.0273764258555133,0
"<anonymized_userid>",36,19702,289,"Geert Wilders (PVV)",0.348307257137806,0.0274714828897338,0
"<anonymized_userid>",36,19738,290,"Geert Wilders (PVV)",0.348943693096438,0.0275665399239544,0
"<anonymized_userid>",36,19774,291,"Geert Wilders (PVV)",0.349580129055069,0.0276615969581749,0
"<anonymized_userid>",36,19810,292,"Geert Wilders (PVV)",0.350216565013701,0.0277566539923954,0
"<anonymized_userid>",36,19846,293,"Geert Wilders (PVV)",0.350853000972333,0.027851711026616,0
"<anonymized_userid>",36,19882,294,"Geert Wilders (PVV)",0.351489436930964,0.0279467680608365,0
"<anonymized_userid>",36,19918,295,"Geert Wilders (PVV)",0.352125872889596,0.028041825095057,0
"<anonymized_userid>",36,19954,296,"Geert Wilders (PVV)",0.352762308848228,0.0281368821292776,0
"<anonymized_userid>",36,19990,297,"Geert Wilders (PVV)",0.353398744806859,0.0282319391634981,0
"<anonymized_userid>",36,20026,298,"Geert Wilders (PVV)",0.354035180765491,0.0283269961977186,0
"<anonymized_userid>",35,20061,299,"Geert Wilders (PVV)",0.354653937947494,0.0284220532319392,0
"<anonymized_userid>",35,20096,300,"Geert Wilders (PVV)",0.355272695129497,0.0285171102661597,0
"<anonymized_userid>",35,20131,301,"Geert Wilders (PVV)",0.3558914523115,0.0286121673003802,0
"<anonymized_userid>",35,20166,302,"Geert Wilders (PVV)",0.356510209493503,0.0287072243346008,0
"<anonymized_userid>",35,20201,303,"Geert Wilders (PVV)",0.357128966675506,0.0288022813688213,0
"<anonymized_userid>",35,20236,304,"Geert Wilders (PVV)",0.357747723857509,0.0288973384030418,0
"<anonymized_userid>",35,20271,305,"Geert Wilders (PVV)",0.358366481039512,0.0289923954372624,0
"<anonymized_userid>",35,20306,306,"Geert Wilders (PVV)",0.358985238221515,0.0290874524714829,0
"<anonymized_userid>",35,20341,307,"Geert Wilders (PVV)",0.359603995403518,0.0291825095057034,0
"<anonymized_userid>",35,20376,308,"Geert Wilders (PVV)",0.360222752585521,0.029277566539924,0
"<anonymized_userid>",35,20411,309,"Geert Wilders (PVV)",0.360841509767524,0.0293726235741445,0
"<anonymized_userid>",35,20446,310,"Geert Wilders (PVV)",0.361460266949527,0.029467680608365,0
"<anonymized_userid>",35,20481,311,"Geert Wilders (PVV)",0.36207902413153,0.0295627376425856,0
"<anonymized_userid>",35,20516,312,"Geert Wilders (PVV)",0.362697781313533,0.0296577946768061,0
"<anonymized_userid>",34,20550,313,"Geert Wilders (PVV)",0.363298859718907,0.0297528517110266,0
"<anonymized_userid>",34,20584,314,"Geert Wilders (PVV)",0.363899938124282,0.0298479087452471,0
"<anonymized_userid>",34,20618,315,"Geert Wilders (PVV)",0.364501016529656,0.0299429657794677,0
"<anonymized_userid>",34,20652,316,"Geert Wilders (PVV)",0.36510209493503,0.0300380228136882,0
"<anonymized_userid>",34,20686,317,"Geert Wilders (PVV)",0.365703173340405,0.0301330798479087,0
"<anonymized_userid>",34,20720,318,"Geert Wilders (PVV)",0.366304251745779,0.0302281368821293,0
"<anonymized_userid>",34,20754,319,"Geert Wilders (PVV)",0.366905330151154,0.0303231939163498,0
"<anonymized_userid>",34,20788,320,"Geert Wilders (PVV)",0.367506408556528,0.0304182509505703,0
"<anonymized_userid>",34,20822,321,"Geert Wilders (PVV)",0.368107486961902,0.0305133079847909,0
"<anonymized_userid>",34,20856,322,"Geert Wilders (PVV)",0.368708565367277,0.0306083650190114,0
"<anonymized_userid>",34,20890,323,"Geert Wilders (PVV)",0.369309643772651,0.0307034220532319,0
"<anonymized_userid>",34,20924,324,"Geert Wilders (PVV)",0.369910722178025,0.0307984790874525,0
"<anonymized_userid>",33,20957,325,"Geert Wilders (PVV)",0.370494121806771,0.030893536121673,0
"<anonymized_userid>",33,20990,326,"Geert Wilders (PVV)",0.371077521435517,0.0309885931558935,0
"<anonymized_userid>",33,21023,327,"Geert Wilders (PVV)",0.371660921064262,0.0310836501901141,0
"<anonymized_userid>",33,21056,328,"Geert Wilders (PVV)",0.372244320693008,0.0311787072243346,0
"<anonymized_userid>",33,21089,329,"Geert Wilders (PVV)",0.372827720321754,0.0312737642585551,0
"<anonymized_userid>",33,21122,330,"Geert Wilders (PVV)",0.373411119950499,0.0313688212927757,0
"<anonymized_userid>",33,21155,331,"Geert Wilders (PVV)",0.373994519579245,0.0314638783269962,0
"<anonymized_userid>",32,21187,332,"Geert Wilders (PVV)",0.374560240431362,0.0315589353612167,0
"<anonymized_userid>",32,21219,333,"Geert Wilders (PVV)",0.375125961283479,0.0316539923954373,0
"<anonymized_userid>",32,21251,334,"Geert Wilders (PVV)",0.375691682135596,0.0317490494296578,0
"<anonymized_userid>",32,21283,335,"Geert Wilders (PVV)",0.376257402987713,0.0318441064638783,0
"<anonymized_userid>",32,21315,336,"Geert Wilders (PVV)",0.37682312383983,0.0319391634980989,0
"<anonymized_userid>",32,21347,337,"Geert Wilders (PVV)",0.377388844691947,0.0320342205323194,0
"<anonymized_userid>",32,21379,338,"Geert Wilders (PVV)",0.377954565544064,0.0321292775665399,0
"<anonymized_userid>",32,21411,339,"Geert Wilders (PVV)",0.378520286396181,0.0322243346007605,0
"<anonymized_userid>",32,21443,340,"Geert Wilders (PVV)",0.379086007248298,0.032319391634981,0
"<anonymized_userid>",32,21475,341,"Geert Wilders (PVV)",0.379651728100415,0.0324144486692015,0
"<anonymized_userid>",32,21507,342,"Geert Wilders (PVV)",0.380217448952533,0.0325095057034221,0
"<anonymized_userid>",32,21539,343,"Geert Wilders (PVV)",0.380783169804649,0.0326045627376426,0
"<anonymized_userid>",32,21571,344,"Geert Wilders (PVV)",0.381348890656767,0.0326996197718631,0
"<anonymized_userid>",32,21603,345,"Geert Wilders (PVV)",0.381914611508884,0.0327946768060837,0
"<anonymized_userid>",32,21635,346,"Geert Wilders (PVV)",0.382480332361001,0.0328897338403042,0
"<anonymized_userid>",32,21667,347,"Geert Wilders (PVV)",0.383046053213118,0.0329847908745247,0
"<anonymized_userid>",32,21699,348,"Geert Wilders (PVV)",0.383611774065235,0.0330798479087452,0
"<anonymized_userid>",32,21731,349,"Geert Wilders (PVV)",0.384177494917352,0.0331749049429658,0
"<anonymized_userid>",32,21763,350,"Geert Wilders (PVV)",0.384743215769469,0.0332699619771863,0
"<anonymized_userid>",31,21794,351,"Geert Wilders (PVV)",0.385291257844957,0.0333650190114068,0
"<anonymized_userid>",31,21825,352,"Geert Wilders (PVV)",0.385839299920446,0.0334600760456274,0
"<anonymized_userid>",31,21856,353,"Geert Wilders (PVV)",0.386387341995934,0.0335551330798479,0
"<anonymized_userid>",31,21887,354,"Geert Wilders (PVV)",0.386935384071422,0.0336501901140684,0
"<anonymized_userid>",31,21918,355,"Geert Wilders (PVV)",0.387483426146911,0.033745247148289,0
"<anonymized_userid>",31,21949,356,"Geert Wilders (PVV)",0.388031468222399,0.0338403041825095,0
"<anonymized_userid>",31,21980,357,"Geert Wilders (PVV)",0.388579510297887,0.03393536121673,0
"<anonymized_userid>",31,22011,358,"Geert Wilders (PVV)",0.389127552373376,0.0340304182509506,0
"<anonymized_userid>",31,22042,359,"Geert Wilders (PVV)",0.389675594448864,0.0341254752851711,0
"<anonymized_userid>",31,22073,360,"Geert Wilders (PVV)",0.390223636524352,0.0342205323193916,0
"<anonymized_userid>",31,22104,361,"Geert Wilders (PVV)",0.390771678599841,0.0343155893536122,0
"<anonymized_userid>",31,22135,362,"Geert Wilders (PVV)",0.391319720675329,0.0344106463878327,0
"<anonymized_userid>",31,22166,363,"Geert Wilders (PVV)",0.391867762750818,0.0345057034220532,0
"<anonymized_userid>",31,22197,364,"Geert Wilders (PVV)",0.392415804826306,0.0346007604562738,0
"<anonymized_userid>",31,22228,365,"Geert Wilders (PVV)",0.392963846901794,0.0346958174904943,0
"<anonymized_userid>",31,22259,366,"Geert Wilders (PVV)",0.393511888977283,0.0347908745247148,0
"<anonymized_userid>",31,22290,367,"Geert Wilders (PVV)",0.394059931052771,0.0348859315589354,0
"<anonymized_userid>",31,22321,368,"Geert Wilders (PVV)",0.39460797312826,0.0349809885931559,0
"<anonymized_userid>",31,22352,369,"Geert Wilders (PVV)",0.395156015203748,0.0350760456273764,0
"<anonymized_userid>",30,22382,370,"Geert Wilders (PVV)",0.395686378502608,0.035171102661597,0
"<anonymized_userid>",30,22412,371,"Geert Wilders (PVV)",0.396216741801467,0.0352661596958175,0
"<anonymized_userid>",30,22442,372,"Geert Wilders (PVV)",0.396747105100327,0.035361216730038,0
"<anonymized_userid>",30,22472,373,"Geert Wilders (PVV)",0.397277468399187,0.0354562737642586,0
"<anonymized_userid>",30,22502,374,"Geert Wilders (PVV)",0.397807831698047,0.0355513307984791,0
"<anonymized_userid>",30,22532,375,"Geert Wilders (PVV)",0.398338194996906,0.0356463878326996,0
"<anonymized_userid>",30,22562,376,"Geert Wilders (PVV)",0.398868558295766,0.0357414448669202,0
"<anonymized_userid>",30,22592,377,"Geert Wilders (PVV)",0.399398921594626,0.0358365019011407,0
"<anonymized_userid>",30,22622,378,"Geert Wilders (PVV)",0.399929284893485,0.0359315589353612,0
"<anonymized_userid>",30,22652,379,"Geert Wilders (PVV)",0.400459648192345,0.0360266159695817,0
"<anonymized_userid>",30,22682,380,"Geert Wilders (PVV)",0.400990011491205,0.0361216730038023,0
"<anonymized_userid>",30,22712,381,"Geert Wilders (PVV)",0.401520374790065,0.0362167300380228,0
"<anonymized_userid>",30,22742,382,"Geert Wilders (PVV)",0.402050738088924,0.0363117870722433,0
"<anonymized_userid>",30,22772,383,"Geert Wilders (PVV)",0.402581101387784,0.0364068441064639,0
"<anonymized_userid>",29,22801,384,"Geert Wilders (PVV)",0.403093785910015,0.0365019011406844,0
"<anonymized_userid>",29,22830,385,"Geert Wilders (PVV)",0.403606470432246,0.0365969581749049,0
"<anonymized_userid>",29,22859,386,"Geert Wilders (PVV)",0.404119154954477,0.0366920152091255,0
"<anonymized_userid>",29,22888,387,"Geert Wilders (PVV)",0.404631839476708,0.036787072243346,0
"<anonymized_userid>",29,22917,388,"Geert Wilders (PVV)",0.405144523998939,0.0368821292775665,0
"<anonymized_userid>",29,22946,389,"Geert Wilders (PVV)",0.40565720852117,0.0369771863117871,0
"<anonymized_userid>",29,22975,390,"Geert Wilders (PVV)",0.406169893043401,0.0370722433460076,0
"<anonymized_userid>",29,23004,391,"Geert Wilders (PVV)",0.406682577565632,0.0371673003802281,0
"<anonymized_userid>",29,23033,392,"Geert Wilders (PVV)",0.407195262087863,0.0372623574144487,0
"<anonymized_userid>",29,23062,393,"Geert Wilders (PVV)",0.407707946610095,0.0373574144486692,0
"<anonymized_userid>",29,23091,394,"Geert Wilders (PVV)",0.408220631132326,0.0374524714828897,0
"<anonymized_userid>",29,23120,395,"Geert Wilders (PVV)",0.408733315654557,0.0375475285171103,0
"<anonymized_userid>",29,23149,396,"Geert Wilders (PVV)",0.409246000176788,0.0376425855513308,0
"<anonymized_userid>",29,23178,397,"Geert Wilders (PVV)",0.409758684699019,0.0377376425855513,0
"<anonymized_userid>",29,23207,398,"Geert Wilders (PVV)",0.41027136922125,0.0378326996197719,0
"<anonymized_userid>",29,23236,399,"Geert Wilders (PVV)",0.410784053743481,0.0379277566539924,0
"<anonymized_userid>",29,23265,400,"Geert Wilders (PVV)",0.411296738265712,0.0380228136882129,0
"<anonymized_userid>",29,23294,401,"Geert Wilders (PVV)",0.411809422787943,0.0381178707224335,0
"<anonymized_userid>",28,23322,402,"Geert Wilders (PVV)",0.412304428533545,0.038212927756654,0
"<anonymized_userid>",28,23350,403,"Geert Wilders (PVV)",0.412799434279148,0.0383079847908745,0
"<anonymized_userid>",28,23378,404,"Geert Wilders (PVV)",0.41329444002475,0.0384030418250951,0
"<anonymized_userid>",28,23406,405,"Geert Wilders (PVV)",0.413789445770353,0.0384980988593156,0
"<anonymized_userid>",28,23434,406,"Geert Wilders (PVV)",0.414284451515955,0.0385931558935361,0
"<anonymized_userid>",28,23462,407,"Geert Wilders (PVV)",0.414779457261558,0.0386882129277567,0
"<anonymized_userid>",28,23490,408,"Geert Wilders (PVV)",0.41527446300716,0.0387832699619772,0
"<anonymized_userid>",28,23518,409,"Geert Wilders (PVV)",0.415769468752762,0.0388783269961977,0
"<anonymized_userid>",28,23546,410,"Geert Wilders (PVV)",0.416264474498365,0.0389733840304183,0
"<anonymized_userid>",27,23573,411,"Geert Wilders (PVV)",0.416741801467338,0.0390684410646388,0
"<anonymized_userid>",27,23600,412,"Geert Wilders (PVV)",0.417219128436312,0.0391634980988593,0
"<anonymized_userid>",27,23627,413,"Geert Wilders (PVV)",0.417696455405286,0.0392585551330798,0
"<anonymized_userid>",27,23654,414,"Geert Wilders (PVV)",0.41817378237426,0.0393536121673004,0
"<anonymized_userid>",27,23681,415,"Geert Wilders (PVV)",0.418651109343233,0.0394486692015209,0
"<anonymized_userid>",27,23708,416,"Geert Wilders (PVV)",0.419128436312207,0.0395437262357414,0
"<anonymized_userid>",27,23735,417,"Geert Wilders (PVV)",0.419605763281181,0.039638783269962,0
"<anonymized_userid>",27,23762,418,"Geert Wilders (PVV)",0.420083090250155,0.0397338403041825,0
"<anonymized_userid>",27,23789,419,"Geert Wilders (PVV)",0.420560417219128,0.039828897338403,0
"<anonymized_userid>",27,23816,420,"Geert Wilders (PVV)",0.421037744188102,0.0399239543726236,0
"<anonymized_userid>",27,23843,421,"Geert Wilders (PVV)",0.421515071157076,0.0400190114068441,0
"<anonymized_userid>",27,23870,422,"Geert Wilders (PVV)",0.42199239812605,0.0401140684410646,0
"<anonymized_userid>",27,23897,423,"Geert Wilders (PVV)",0.422469725095023,0.0402091254752852,0
"<anonymized_userid>",27,23924,424,"Geert Wilders (PVV)",0.422947052063997,0.0403041825095057,0
"<anonymized_userid>",27,23951,425,"Geert Wilders (PVV)",0.423424379032971,0.0403992395437262,0
"<anonymized_userid>",27,23978,426,"Geert Wilders (PVV)",0.423901706001945,0.0404942965779468,0
"<anonymized_userid>",27,24005,427,"Geert Wilders (PVV)",0.424379032970918,0.0405893536121673,0
"<anonymized_userid>",27,24032,428,"Geert Wilders (PVV)",0.424856359939892,0.0406844106463878,0
"<anonymized_userid>",27,24059,429,"Geert Wilders (PVV)",0.425333686908866,0.0407794676806084,0
"<anonymized_userid>",27,24086,430,"Geert Wilders (PVV)",0.42581101387784,0.0408745247148289,0
"<anonymized_userid>",27,24113,431,"Geert Wilders (PVV)",0.426288340846813,0.0409695817490494,0
"<anonymized_userid>",27,24140,432,"Geert Wilders (PVV)",0.426765667815787,0.04106463878327,0
"<anonymized_userid>",27,24167,433,"Geert Wilders (PVV)",0.427242994784761,0.0411596958174905,0
"<anonymized_userid>",27,24194,434,"Geert Wilders (PVV)",0.427720321753735,0.041254752851711,0
"<anonymized_userid>",27,24221,435,"Geert Wilders (PVV)",0.428197648722708,0.0413498098859316,0
"<anonymized_userid>",26,24247,436,"Geert Wilders (PVV)",0.428657296915053,0.0414448669201521,0
"<anonymized_userid>",26,24273,437,"Geert Wilders (PVV)",0.429116945107399,0.0415399239543726,0
"<anonymized_userid>",26,24299,438,"Geert Wilders (PVV)",0.429576593299744,0.0416349809885932,0
"<anonymized_userid>",26,24325,439,"Geert Wilders (PVV)",0.430036241492089,0.0417300380228137,0
"<anonymized_userid>",26,24351,440,"Geert Wilders (PVV)",0.430495889684434,0.0418250950570342,0
"<anonymized_userid>",26,24377,441,"Geert Wilders (PVV)",0.430955537876779,0.0419201520912548,0
"<anonymized_userid>",26,24403,442,"Geert Wilders (PVV)",0.431415186069124,0.0420152091254753,0
"<anonymized_userid>",26,24429,443,"Geert Wilders (PVV)",0.431874834261469,0.0421102661596958,0
"<anonymized_userid>",26,24455,444,"Geert Wilders (PVV)",0.432334482453814,0.0422053231939164,0
"<anonymized_userid>",26,24481,445,"Geert Wilders (PVV)",0.432794130646159,0.0423003802281369,0
"<anonymized_userid>",26,24507,446,"Geert Wilders (PVV)",0.433253778838504,0.0423954372623574,0
"<anonymized_userid>",26,24533,447,"Geert Wilders (PVV)",0.433713427030849,0.0424904942965779,0
"<anonymized_userid>",26,24559,448,"Geert Wilders (PVV)",0.434173075223195,0.0425855513307985,0
"<anonymized_userid>",26,24585,449,"Geert Wilders (PVV)",0.43463272341554,0.042680608365019,0
"<anonymized_userid>",26,24611,450,"Geert Wilders (PVV)",0.435092371607885,0.0427756653992395,0
"<anonymized_userid>",26,24637,451,"Geert Wilders (PVV)",0.43555201980023,0.0428707224334601,0
"<anonymized_userid>",25,24662,452,"Geert Wilders (PVV)",0.435993989215946,0.0429657794676806,0
"<anonymized_userid>",25,24687,453,"Geert Wilders (PVV)",0.436435958631663,0.0430608365019011,0
"<anonymized_userid>",25,24712,454,"Geert Wilders (PVV)",0.436877928047379,0.0431558935361217,0
"<anonymized_userid>",25,24737,455,"Geert Wilders (PVV)",0.437319897463096,0.0432509505703422,0
"<anonymized_userid>",25,24762,456,"Geert Wilders (PVV)",0.437761866878812,0.0433460076045627,0
"<anonymized_userid>",25,24787,457,"Geert Wilders (PVV)",0.438203836294528,0.0434410646387833,0
"<anonymized_userid>",25,24812,458,"Geert Wilders (PVV)",0.438645805710245,0.0435361216730038,0
"<anonymized_userid>",25,24837,459,"Geert Wilders (PVV)",0.439087775125961,0.0436311787072243,0
"<anonymized_userid>",25,24862,460,"Geert Wilders (PVV)",0.439529744541678,0.0437262357414449,0
"<anonymized_userid>",25,24887,461,"Geert Wilders (PVV)",0.439971713957394,0.0438212927756654,0
"<anonymized_userid>",25,24912,462,"Geert Wilders (PVV)",0.440413683373111,0.0439163498098859,0
"<anonymized_userid>",25,24937,463,"Geert Wilders (PVV)",0.440855652788827,0.0440114068441065,0
"<anonymized_userid>",25,24962,464,"Geert Wilders (PVV)",0.441297622204543,0.044106463878327,0
"<anonymized_userid>",25,24987,465,"Geert Wilders (PVV)",0.44173959162026,0.0442015209125475,0
"<anonymized_userid>",25,25012,466,"Geert Wilders (PVV)",0.442181561035976,0.0442965779467681,0
"<anonymized_userid>",25,25037,467,"Geert Wilders (PVV)",0.442623530451693,0.0443916349809886,0
"<anonymized_userid>",25,25062,468,"Geert Wilders (PVV)",0.443065499867409,0.0444866920152091,0
"<anonymized_userid>",25,25087,469,"Geert Wilders (PVV)",0.443507469283126,0.0445817490494297,0
"<anonymized_userid>",25,25112,470,"Geert Wilders (PVV)",0.443949438698842,0.0446768060836502,0
"<anonymized_userid>",25,25137,471,"Geert Wilders (PVV)",0.444391408114558,0.0447718631178707,0
"<anonymized_userid>",24,25161,472,"Geert Wilders (PVV)",0.444815698753646,0.0448669201520913,0
"<anonymized_userid>",24,25185,473,"Geert Wilders (PVV)",0.445239989392734,0.0449619771863118,0
"<anonymized_userid>",24,25209,474,"Geert Wilders (PVV)",0.445664280031822,0.0450570342205323,0
"<anonymized_userid>",24,25233,475,"Geert Wilders (PVV)",0.44608857067091,0.0451520912547528,0
"<anonymized_userid>",24,25257,476,"Geert Wilders (PVV)",0.446512861309997,0.0452471482889734,0
"<anonymized_userid>",24,25281,477,"Geert Wilders (PVV)",0.446937151949085,0.0453422053231939,0
"<anonymized_userid>",24,25305,478,"Geert Wilders (PVV)",0.447361442588173,0.0454372623574145,0
"<anonymized_userid>",24,25329,479,"Geert Wilders (PVV)",0.447785733227261,0.045532319391635,0
"<anonymized_userid>",24,25353,480,"Geert Wilders (PVV)",0.448210023866348,0.0456273764258555,0
"<anonymized_userid>",24,25377,481,"Geert Wilders (PVV)",0.448634314505436,0.045722433460076,0
"<anonymized_userid>",24,25401,482,"Geert Wilders (PVV)",0.449058605144524,0.0458174904942966,0
"<anonymized_userid>",24,25425,483,"Geert Wilders (PVV)",0.449482895783612,0.0459125475285171,0
"<anonymized_userid>",24,25449,484,"Geert Wilders (PVV)",0.4499071864227,0.0460076045627376,0
"<anonymized_userid>",24,25473,485,"Geert Wilders (PVV)",0.450331477061787,0.0461026615969582,0
"<anonymized_userid>",24,25497,486,"Geert Wilders (PVV)",0.450755767700875,0.0461977186311787,0
"<anonymized_userid>",24,25521,487,"Geert Wilders (PVV)",0.451180058339963,0.0462927756653992,0
"<anonymized_userid>",24,25545,488,"Geert Wilders (PVV)",0.451604348979051,0.0463878326996198,0
"<anonymized_userid>",24,25569,489,"Geert Wilders (PVV)",0.452028639618138,0.0464828897338403,0
"<anonymized_userid>",24,25593,490,"Geert Wilders (PVV)",0.452452930257226,0.0465779467680608,0
"<anonymized_userid>",24,25617,491,"Geert Wilders (PVV)",0.452877220896314,0.0466730038022814,0
"<anonymized_userid>",24,25641,492,"Geert Wilders (PVV)",0.453301511535402,0.0467680608365019,0
"<anonymized_userid>",24,25665,493,"Geert Wilders (PVV)",0.45372580217449,0.0468631178707224,0
"<anonymized_userid>",24,25689,494,"Geert Wilders (PVV)",0.454150092813577,0.046958174904943,0
"<anonymized_userid>",24,25713,495,"Geert Wilders (PVV)",0.454574383452665,0.0470532319391635,0
"<anonymized_userid>",24,25737,496,"Geert Wilders (PVV)",0.454998674091753,0.047148288973384,0
"<anonymized_userid>",23,25760,497,"Geert Wilders (PVV)",0.455405285954212,0.0472433460076046,0
"<anonymized_userid>",23,25783,498,"Geert Wilders (PVV)",0.455811897816671,0.0473384030418251,0
"<anonymized_userid>",23,25806,499,"Geert Wilders (PVV)",0.45621850967913,0.0474334600760456,0
"<anonymized_userid>",23,25829,500,"Geert Wilders (PVV)",0.456625121541589,0.0475285171102662,0
"<anonymized_userid>",23,25852,501,"Geert Wilders (PVV)",0.457031733404048,0.0476235741444867,0
"<anonymized_userid>",23,25875,502,"Geert Wilders (PVV)",0.457438345266508,0.0477186311787072,0
"<anonymized_userid>",23,25898,503,"Geert Wilders (PVV)",0.457844957128967,0.0478136882129278,0
"<anonymized_userid>",23,25921,504,"Geert Wilders (PVV)",0.458251568991426,0.0479087452471483,0
"<anonymized_userid>",23,25944,505,"Geert Wilders (PVV)",0.458658180853885,0.0480038022813688,0
"<anonymized_userid>",23,25967,506,"Geert Wilders (PVV)",0.459064792716344,0.0480988593155894,0
"<anonymized_userid>",23,25990,507,"Geert Wilders (PVV)",0.459471404578803,0.0481939163498099,0
"<anonymized_userid>",23,26013,508,"Geert Wilders (PVV)",0.459878016441262,0.0482889733840304,0
"<anonymized_userid>",23,26036,509,"Geert Wilders (PVV)",0.460284628303721,0.0483840304182509,0
"<anonymized_userid>",23,26059,510,"Geert Wilders (PVV)",0.460691240166181,0.0484790874524715,0
"<anonymized_userid>",23,26082,511,"Geert Wilders (PVV)",0.46109785202864,0.048574144486692,0
"<anonymized_userid>",23,26105,512,"Geert Wilders (PVV)",0.461504463891099,0.0486692015209125,0
"<anonymized_userid>",23,26128,513,"Geert Wilders (PVV)",0.461911075753558,0.0487642585551331,0
"<anonymized_userid>",23,26151,514,"Geert Wilders (PVV)",0.462317687616017,0.0488593155893536,0
"<anonymized_userid>",23,26174,515,"Geert Wilders (PVV)",0.462724299478476,0.0489543726235741,0
"<anonymized_userid>",23,26197,516,"Geert Wilders (PVV)",0.463130911340935,0.0490494296577947,0
"<anonymized_userid>",23,26220,517,"Geert Wilders (PVV)",0.463537523203394,0.0491444866920152,0
"<anonymized_userid>",23,26243,518,"Geert Wilders (PVV)",0.463944135065853,0.0492395437262357,0
"<anonymized_userid>",23,26266,519,"Geert Wilders (PVV)",0.464350746928313,0.0493346007604563,0
"<anonymized_userid>",23,26289,520,"Geert Wilders (PVV)",0.464757358790772,0.0494296577946768,0
"<anonymized_userid>",23,26312,521,"Geert Wilders (PVV)",0.465163970653231,0.0495247148288973,0
"<anonymized_userid>",23,26335,522,"Geert Wilders (PVV)",0.46557058251569,0.0496197718631179,0
"<anonymized_userid>",23,26358,523,"Geert Wilders (PVV)",0.465977194378149,0.0497148288973384,0
"<anonymized_userid>",23,26381,524,"Geert Wilders (PVV)",0.466383806240608,0.0498098859315589,0
"<anonymized_userid>",23,26404,525,"Geert Wilders (PVV)",0.466790418103067,0.0499049429657795,0
"<anonymized_userid>",22,26426,526,"Geert Wilders (PVV)",0.467179351188898,0.05,0
"<anonymized_userid>",22,26448,527,"Geert Wilders (PVV)",0.467568284274728,0.0500950570342205,0
"<anonymized_userid>",22,26470,528,"Geert Wilders (PVV)",0.467957217360559,0.0501901140684411,0
"<anonymized_userid>",22,26492,529,"Geert Wilders (PVV)",0.468346150446389,0.0502851711026616,0
"<anonymized_userid>",22,26514,530,"Geert Wilders (PVV)",0.46873508353222,0.0503802281368821,0
"<anonymized_userid>",22,26536,531,"Geert Wilders (PVV)",0.46912401661805,0.0504752851711027,0
"<anonymized_userid>",22,26558,532,"Geert Wilders (PVV)",0.46951294970388,0.0505703422053232,0
"<anonymized_userid>",22,26580,533,"Geert Wilders (PVV)",0.469901882789711,0.0506653992395437,0
"<anonymized_userid>",22,26602,534,"Geert Wilders (PVV)",0.470290815875541,0.0507604562737643,0
"<anonymized_userid>",22,26624,535,"Geert Wilders (PVV)",0.470679748961372,0.0508555133079848,0
"<anonymized_userid>",22,26646,536,"Geert Wilders (PVV)",0.471068682047202,0.0509505703422053,0
"<anonymized_userid>",22,26668,537,"Geert Wilders (PVV)",0.471457615133033,0.0510456273764259,0
"<anonymized_userid>",22,26690,538,"Geert Wilders (PVV)",0.471846548218863,0.0511406844106464,0
"<anonymized_userid>",22,26712,539,"Geert Wilders (PVV)",0.472235481304694,0.0512357414448669,0
"<anonymized_userid>",22,26734,540,"Geert Wilders (PVV)",0.472624414390524,0.0513307984790875,0
"<anonymized_userid>",22,26756,541,"Geert Wilders (PVV)",0.473013347476355,0.051425855513308,0
"<anonymized_userid>",22,26778,542,"Geert Wilders (PVV)",0.473402280562185,0.0515209125475285,0
"<anonymized_userid>",22,26800,543,"Geert Wilders (PVV)",0.473791213648016,0.051615969581749,0
"<anonymized_userid>",22,26822,544,"Geert Wilders (PVV)",0.474180146733846,0.0517110266159696,0
"<anonymized_userid>",22,26844,545,"Geert Wilders (PVV)",0.474569079819676,0.0518060836501901,0
"<anonymized_userid>",22,26866,546,"Geert Wilders (PVV)",0.474958012905507,0.0519011406844106,0
"<anonymized_userid>",22,26888,547,"Geert Wilders (PVV)",0.475346945991337,0.0519961977186312,0
"<anonymized_userid>",22,26910,548,"Geert Wilders (PVV)",0.475735879077168,0.0520912547528517,0
"<anonymized_userid>",22,26932,549,"Geert Wilders (PVV)",0.476124812162998,0.0521863117870722,0
"<anonymized_userid>",22,26954,550,"Geert Wilders (PVV)",0.476513745248829,0.0522813688212928,0
"<anonymized_userid>",22,26976,551,"Geert Wilders (PVV)",0.476902678334659,0.0523764258555133,0
"<anonymized_userid>",21,26997,552,"Geert Wilders (PVV)",0.477273932643861,0.0524714828897338,0
"<anonymized_userid>",21,27018,553,"Geert Wilders (PVV)",0.477645186953063,0.0525665399239544,0
"<anonymized_userid>",21,27039,554,"Geert Wilders (PVV)",0.478016441262265,0.0526615969581749,0
"<anonymized_userid>",21,27060,555,"Geert Wilders (PVV)",0.478387695571466,0.0527566539923954,0
"<anonymized_userid>",21,27081,556,"Geert Wilders (PVV)",0.478758949880668,0.052851711026616,0
"<anonymized_userid>",21,27102,557,"Geert Wilders (PVV)",0.47913020418987,0.0529467680608365,0
"<anonymized_userid>",21,27123,558,"Geert Wilders (PVV)",0.479501458499072,0.053041825095057,0
"<anonymized_userid>",21,27144,559,"Geert Wilders (PVV)",0.479872712808274,0.0531368821292776,0
"<anonymized_userid>",21,27165,560,"Geert Wilders (PVV)",0.480243967117475,0.0532319391634981,0
"<anonymized_userid>",21,27186,561,"Geert Wilders (PVV)",0.480615221426677,0.0533269961977186,0
"<anonymized_userid>",21,27207,562,"Geert Wilders (PVV)",0.480986475735879,0.0534220532319392,0
"<anonymized_userid>",21,27228,563,"Geert Wilders (PVV)",0.481357730045081,0.0535171102661597,0
"<anonymized_userid>",21,27249,564,"Geert Wilders (PVV)",0.481728984354283,0.0536121673003802,0
"<anonymized_userid>",21,27270,565,"Geert Wilders (PVV)",0.482100238663485,0.0537072243346008,0
"<anonymized_userid>",21,27291,566,"Geert Wilders (PVV)",0.482471492972686,0.0538022813688213,0
"<anonymized_userid>",21,27312,567,"Geert Wilders (PVV)",0.482842747281888,0.0538973384030418,0
"<anonymized_userid>",21,27333,568,"Geert Wilders (PVV)",0.48321400159109,0.0539923954372624,0
"<anonymized_userid>",21,27354,569,"Geert Wilders (PVV)",0.483585255900292,0.0540874524714829,0
"<anonymized_userid>",21,27375,570,"Geert Wilders (PVV)",0.483956510209493,0.0541825095057034,0
"<anonymized_userid>",21,27396,571,"Geert Wilders (PVV)",0.484327764518695,0.054277566539924,0
"<anonymized_userid>",21,27417,572,"Geert Wilders (PVV)",0.484699018827897,0.0543726235741445,0
"<anonymized_userid>",21,27438,573,"Geert Wilders (PVV)",0.485070273137099,0.054467680608365,0
"<anonymized_userid>",21,27459,574,"Geert Wilders (PVV)",0.485441527446301,0.0545627376425856,0
"<anonymized_userid>",21,27480,575,"Geert Wilders (PVV)",0.485812781755503,0.0546577946768061,0
"<anonymized_userid>",21,27501,576,"Geert Wilders (PVV)",0.486184036064704,0.0547528517110266,0
"<anonymized_userid>",21,27522,577,"Geert Wilders (PVV)",0.486555290373906,0.0548479087452471,0
"<anonymized_userid>",20,27542,578,"Geert Wilders (PVV)",0.486908865906479,0.0549429657794677,0
"<anonymized_userid>",20,27562,579,"Geert Wilders (PVV)",0.487262441439052,0.0550380228136882,0
"<anonymized_userid>",20,27582,580,"Geert Wilders (PVV)",0.487616016971626,0.0551330798479087,0
"<anonymized_userid>",20,27602,581,"Geert Wilders (PVV)",0.487969592504199,0.0552281368821293,0
"<anonymized_userid>",20,27622,582,"Geert Wilders (PVV)",0.488323168036772,0.0553231939163498,0
"<anonymized_userid>",20,27642,583,"Geert Wilders (PVV)",0.488676743569345,0.0554182509505703,0
"<anonymized_userid>",20,27662,584,"Geert Wilders (PVV)",0.489030319101918,0.0555133079847909,0
"<anonymized_userid>",20,27682,585,"Geert Wilders (PVV)",0.489383894634491,0.0556083650190114,0
"<anonymized_userid>",20,27702,586,"Geert Wilders (PVV)",0.489737470167064,0.0557034220532319,0
"<anonymized_userid>",20,27722,587,"Geert Wilders (PVV)",0.490091045699638,0.0557984790874525,0
"<anonymized_userid>",20,27742,588,"Geert Wilders (PVV)",0.490444621232211,0.055893536121673,0
"<anonymized_userid>",20,27762,589,"Geert Wilders (PVV)",0.490798196764784,0.0559885931558935,0
"<anonymized_userid>",20,27782,590,"Geert Wilders (PVV)",0.491151772297357,0.0560836501901141,0
"<anonymized_userid>",20,27802,591,"Geert Wilders (PVV)",0.49150534782993,0.0561787072243346,0
"<anonymized_userid>",20,27822,592,"Geert Wilders (PVV)",0.491858923362503,0.0562737642585551,0
"<anonymized_userid>",20,27842,593,"Geert Wilders (PVV)",0.492212498895076,0.0563688212927757,0
"<anonymized_userid>",20,27862,594,"Geert Wilders (PVV)",0.49256607442765,0.0564638783269962,0
"<anonymized_userid>",20,27882,595,"Geert Wilders (PVV)",0.492919649960223,0.0565589353612167,0
"<anonymized_userid>",20,27902,596,"Geert Wilders (PVV)",0.493273225492796,0.0566539923954373,0
"<anonymized_userid>",20,27922,597,"Geert Wilders (PVV)",0.493626801025369,0.0567490494296578,0
"<anonymized_userid>",20,27942,598,"Geert Wilders (PVV)",0.493980376557942,0.0568441064638783,0
"<anonymized_userid>",20,27962,599,"Geert Wilders (PVV)",0.494333952090515,0.0569391634980989,0
"<anonymized_userid>",20,27982,600,"Geert Wilders (PVV)",0.494687527623088,0.0570342205323194,0
"<anonymized_userid>",20,28002,601,"Geert Wilders (PVV)",0.495041103155662,0.0571292775665399,0
"<anonymized_userid>",20,28022,602,"Geert Wilders (PVV)",0.495394678688235,0.0572243346007605,0
"<anonymized_userid>",20,28042,603,"Geert Wilders (PVV)",0.495748254220808,0.057319391634981,0
"<anonymized_userid>",20,28062,604,"Geert Wilders (PVV)",0.496101829753381,0.0574144486692015,0
"<anonymized_userid>",20,28082,605,"Geert Wilders (PVV)",0.496455405285954,0.0575095057034221,0
"<anonymized_userid>",20,28102,606,"Geert Wilders (PVV)",0.496808980818527,0.0576045627376426,0
"<anonymized_userid>",20,28122,607,"Geert Wilders (PVV)",0.497162556351101,0.0576996197718631,0
"<anonymized_userid>",20,28142,608,"Geert Wilders (PVV)",0.497516131883674,0.0577946768060836,0
"<anonymized_userid>",20,28162,609,"Geert Wilders (PVV)",0.497869707416247,0.0578897338403042,0
"<anonymized_userid>",20,28182,610,"Geert Wilders (PVV)",0.49822328294882,0.0579847908745247,0
"<anonymized_userid>",20,28202,611,"Geert Wilders (PVV)",0.498576858481393,0.0580798479087452,0
"<anonymized_userid>",20,28222,612,"Geert Wilders (PVV)",0.498930434013966,0.0581749049429658,0
"<anonymized_userid>",20,28242,613,"Geert Wilders (PVV)",0.499284009546539,0.0582699619771863,0
"<anonymized_userid>",20,28262,614,"Geert Wilders (PVV)",0.499637585079113,0.0583650190114068,0
"<anonymized_userid>",20,28282,615,"Geert Wilders (PVV)",0.499991160611686,0.0584600760456274,0
"<anonymized_userid>",20,28302,616,"Geert Wilders (PVV)",0.500344736144259,0.0585551330798479,0
"<anonymized_userid>",20,28322,617,"Geert Wilders (PVV)",0.500698311676832,0.0586501901140684,0
"<anonymized_userid>",19,28341,618,"Geert Wilders (PVV)",0.501034208432776,0.058745247148289,0
"<anonymized_userid>",19,28360,619,"Geert Wilders (PVV)",0.501370105188721,0.0588403041825095,0
"<anonymized_userid>",19,28379,620,"Geert Wilders (PVV)",0.501706001944665,0.05893536121673,0
"<anonymized_userid>",19,28398,621,"Geert Wilders (PVV)",0.50204189870061,0.0590304182509506,0
"<anonymized_userid>",19,28417,622,"Geert Wilders (PVV)",0.502377795456554,0.0591254752851711,0
"<anonymized_userid>",19,28436,623,"Geert Wilders (PVV)",0.502713692212499,0.0592205323193916,0
"<anonymized_userid>",19,28455,624,"Geert Wilders (PVV)",0.503049588968443,0.0593155893536122,0
"<anonymized_userid>",19,28474,625,"Geert Wilders (PVV)",0.503385485724388,0.0594106463878327,0
"<anonymized_userid>",19,28493,626,"Geert Wilders (PVV)",0.503721382480332,0.0595057034220532,0
"<anonymized_userid>",19,28512,627,"Geert Wilders (PVV)",0.504057279236277,0.0596007604562738,0
"<anonymized_userid>",19,28531,628,"Geert Wilders (PVV)",0.504393175992221,0.0596958174904943,0
"<anonymized_userid>",19,28550,629,"Geert Wilders (PVV)",0.504729072748166,0.0597908745247148,0
"<anonymized_userid>",19,28569,630,"Geert Wilders (PVV)",0.50506496950411,0.0598859315589354,0
"<anonymized_userid>",19,28588,631,"Geert Wilders (PVV)",0.505400866260055,0.0599809885931559,0
"<anonymized_userid>",19,28607,632,"Geert Wilders (PVV)",0.505736763015999,0.0600760456273764,0
"<anonymized_userid>",19,28626,633,"Geert Wilders (PVV)",0.506072659771944,0.060171102661597,0
"<anonymized_userid>",19,28645,634,"Geert Wilders (PVV)",0.506408556527888,0.0602661596958175,0
"<anonymized_userid>",19,28664,635,"Geert Wilders (PVV)",0.506744453283833,0.060361216730038,0
"<anonymized_userid>",19,28683,636,"Geert Wilders (PVV)",0.507080350039777,0.0604562737642586,0
"<anonymized_userid>",19,28702,637,"Geert Wilders (PVV)",0.507416246795722,0.0605513307984791,0
"<anonymized_userid>",19,28721,638,"Geert Wilders (PVV)",0.507752143551666,0.0606463878326996,0
"<anonymized_userid>",19,28740,639,"Geert Wilders (PVV)",0.508088040307611,0.0607414448669202,0
"<anonymized_userid>",19,28759,640,"Geert Wilders (PVV)",0.508423937063555,0.0608365019011407,0
"<anonymized_userid>",19,28778,641,"Geert Wilders (PVV)",0.5087598338195,0.0609315589353612,0
"<anonymized_userid>",19,28797,642,"Geert Wilders (PVV)",0.509095730575444,0.0610266159695817,0
"<anonymized_userid>",19,28816,643,"Geert Wilders (PVV)",0.509431627331389,0.0611216730038023,0
"<anonymized_userid>",19,28835,644,"Geert Wilders (PVV)",0.509767524087333,0.0612167300380228,0
"<anonymized_userid>",19,28854,645,"Geert Wilders (PVV)",0.510103420843278,0.0613117870722433,0
"<anonymized_userid>",19,28873,646,"Geert Wilders (PVV)",0.510439317599222,0.0614068441064639,0
"<anonymized_userid>",19,28892,647,"Geert Wilders (PVV)",0.510775214355167,0.0615019011406844,0
"<anonymized_userid>",19,28911,648,"Geert Wilders (PVV)",0.511111111111111,0.0615969581749049,0
"<anonymized_userid>",19,28930,649,"Geert Wilders (PVV)",0.511447007867056,0.0616920152091255,0
"<anonymized_userid>",19,28949,650,"Geert Wilders (PVV)",0.511782904623,0.061787072243346,0
"<anonymized_userid>",19,28968,651,"Geert Wilders (PVV)",0.512118801378945,0.0618821292775665,0
"<anonymized_userid>",18,28986,652,"Geert Wilders (PVV)",0.51243701935826,0.0619771863117871,0
"<anonymized_userid>",18,29004,653,"Geert Wilders (PVV)",0.512755237337576,0.0620722433460076,0
"<anonymized_userid>",18,29022,654,"Geert Wilders (PVV)",0.513073455316892,0.0621673003802281,0
"<anonymized_userid>",18,29040,655,"Geert Wilders (PVV)",0.513391673296208,0.0622623574144487,0
"<anonymized_userid>",18,29058,656,"Geert Wilders (PVV)",0.513709891275524,0.0623574144486692,0
"<anonymized_userid>",18,29076,657,"Geert Wilders (PVV)",0.51402810925484,0.0624524714828897,0
"<anonymized_userid>",18,29094,658,"Geert Wilders (PVV)",0.514346327234155,0.0625475285171103,0
"<anonymized_userid>",18,29112,659,"Geert Wilders (PVV)",0.514664545213471,0.0626425855513308,0
"<anonymized_userid>",18,29130,660,"Geert Wilders (PVV)",0.514982763192787,0.0627376425855513,0
"<anonymized_userid>",18,29148,661,"Geert Wilders (PVV)",0.515300981172103,0.0628326996197719,0
"<anonymized_userid>",18,29166,662,"Geert Wilders (PVV)",0.515619199151419,0.0629277566539924,0
"<anonymized_userid>",18,29184,663,"Geert Wilders (PVV)",0.515937417130735,0.0630228136882129,0
"<anonymized_userid>",18,29202,664,"Geert Wilders (PVV)",0.51625563511005,0.0631178707224335,0
"<anonymized_userid>",18,29220,665,"Geert Wilders (PVV)",0.516573853089366,0.063212927756654,0
"<anonymized_userid>",18,29238,666,"Geert Wilders (PVV)",0.516892071068682,0.0633079847908745,0
"<anonymized_userid>",18,29256,667,"Geert Wilders (PVV)",0.517210289047998,0.0634030418250951,0
"<anonymized_userid>",18,29274,668,"Geert Wilders (PVV)",0.517528507027314,0.0634980988593156,0
"<anonymized_userid>",18,29292,669,"Geert Wilders (PVV)",0.51784672500663,0.0635931558935361,0
"<anonymized_userid>",18,29310,670,"Geert Wilders (PVV)",0.518164942985945,0.0636882129277567,0
"<anonymized_userid>",18,29328,671,"Geert Wilders (PVV)",0.518483160965261,0.0637832699619772,0
"<anonymized_userid>",18,29346,672,"Geert Wilders (PVV)",0.518801378944577,0.0638783269961977,0
"<anonymized_userid>",18,29364,673,"Geert Wilders (PVV)",0.519119596923893,0.0639733840304182,0
"<anonymized_userid>",18,29382,674,"Geert Wilders (PVV)",0.519437814903209,0.0640684410646388,0
"<anonymized_userid>",18,29400,675,"Geert Wilders (PVV)",0.519756032882524,0.0641634980988593,0
"<anonymized_userid>",18,29418,676,"Geert Wilders (PVV)",0.52007425086184,0.0642585551330798,0
"<anonymized_userid>",18,29436,677,"Geert Wilders (PVV)",0.520392468841156,0.0643536121673004,0
"<anonymized_userid>",18,29454,678,"Geert Wilders (PVV)",0.520710686820472,0.0644486692015209,0
"<anonymized_userid>",18,29472,679,"Geert Wilders (PVV)",0.521028904799788,0.0645437262357414,0
"<anonymized_userid>",18,29490,680,"Geert Wilders (PVV)",0.521347122779104,0.064638783269962,0
"<anonymized_userid>",18,29508,681,"Geert Wilders (PVV)",0.52166534075842,0.0647338403041825,0
"<anonymized_userid>",18,29526,682,"Geert Wilders (PVV)",0.521983558737735,0.064828897338403,0
"<anonymized_userid>",18,29544,683,"Geert Wilders (PVV)",0.522301776717051,0.0649239543726236,0
"<anonymized_userid>",18,29562,684,"Geert Wilders (PVV)",0.522619994696367,0.0650190114068441,0
"<anonymized_userid>",18,29580,685,"Geert Wilders (PVV)",0.522938212675683,0.0651140684410646,0
"<anonymized_userid>",18,29598,686,"Geert Wilders (PVV)",0.523256430654999,0.0652091254752852,0
"<anonymized_userid>",18,29616,687,"Geert Wilders (PVV)",0.523574648634314,0.0653041825095057,0
"<anonymized_userid>",18,29634,688,"Geert Wilders (PVV)",0.52389286661363,0.0653992395437262,0
"<anonymized_userid>",18,29652,689,"Geert Wilders (PVV)",0.524211084592946,0.0654942965779468,0
"<anonymized_userid>",18,29670,690,"Geert Wilders (PVV)",0.524529302572262,0.0655893536121673,0
"<anonymized_userid>",18,29688,691,"Geert Wilders (PVV)",0.524847520551578,0.0656844106463878,0
"<anonymized_userid>",18,29706,692,"Geert Wilders (PVV)",0.525165738530894,0.0657794676806084,0
"<anonymized_userid>",18,29724,693,"Geert Wilders (PVV)",0.52548395651021,0.0658745247148289,0
"<anonymized_userid>",18,29742,694,"Geert Wilders (PVV)",0.525802174489525,0.0659695817490494,0
"<anonymized_userid>",18,29760,695,"Geert Wilders (PVV)",0.526120392468841,0.06606463878327,0
"<anonymized_userid>",18,29778,696,"Geert Wilders (PVV)",0.526438610448157,0.0661596958174905,0
"<anonymized_userid>",18,29796,697,"Geert Wilders (PVV)",0.526756828427473,0.066254752851711,0
"<anonymized_userid>",18,29814,698,"Geert Wilders (PVV)",0.527075046406789,0.0663498098859316,0
"<anonymized_userid>",18,29832,699,"Geert Wilders (PVV)",0.527393264386104,0.0664448669201521,0
"<anonymized_userid>",18,29850,700,"Geert Wilders (PVV)",0.52771148236542,0.0665399239543726,0
"<anonymized_userid>",18,29868,701,"Geert Wilders (PVV)",0.528029700344736,0.0666349809885932,0
"<anonymized_userid>",17,29885,702,"Geert Wilders (PVV)",0.528330239547423,0.0667300380228137,0
"<anonymized_userid>",17,29902,703,"Geert Wilders (PVV)",0.52863077875011,0.0668250950570342,0
"<anonymized_userid>",17,29919,704,"Geert Wilders (PVV)",0.528931317952798,0.0669201520912548,0
"<anonymized_userid>",17,29936,705,"Geert Wilders (PVV)",0.529231857155485,0.0670152091254753,0
"<anonymized_userid>",17,29953,706,"Geert Wilders (PVV)",0.529532396358172,0.0671102661596958,0
"<anonymized_userid>",17,29970,707,"Geert Wilders (PVV)",0.529832935560859,0.0672053231939164,0
"<anonymized_userid>",17,29987,708,"Geert Wilders (PVV)",0.530133474763546,0.0673003802281369,0
"<anonymized_userid>",17,30004,709,"Geert Wilders (PVV)",0.530434013966234,0.0673954372623574,0
"<anonymized_userid>",17,30021,710,"Geert Wilders (PVV)",0.530734553168921,0.0674904942965779,0
"<anonymized_userid>",17,30038,711,"Geert Wilders (PVV)",0.531035092371608,0.0675855513307985,0
"<anonymized_userid>",17,30055,712,"Geert Wilders (PVV)",0.531335631574295,0.067680608365019,0
"<anonymized_userid>",17,30072,713,"Geert Wilders (PVV)",0.531636170776982,0.0677756653992395,0
"<anonymized_userid>",17,30089,714,"Geert Wilders (PVV)",0.531936709979669,0.0678707224334601,0
"<anonymized_userid>",17,30106,715,"Geert Wilders (PVV)",0.532237249182357,0.0679657794676806,0
"<anonymized_userid>",17,30123,716,"Geert Wilders (PVV)",0.532537788385044,0.0680608365019011,0
"<anonymized_userid>",17,30140,717,"Geert Wilders (PVV)",0.532838327587731,0.0681558935361217,0
"<anonymized_userid>",17,30157,718,"Geert Wilders (PVV)",0.533138866790418,0.0682509505703422,0
"<anonymized_userid>",17,30174,719,"Geert Wilders (PVV)",0.533439405993105,0.0683460076045627,0
"<anonymized_userid>",17,30191,720,"Geert Wilders (PVV)",0.533739945195792,0.0684410646387833,0
"<anonymized_userid>",17,30208,721,"Geert Wilders (PVV)",0.53404048439848,0.0685361216730038,0
"<anonymized_userid>",17,30225,722,"Geert Wilders (PVV)",0.534341023601167,0.0686311787072243,0
"<anonymized_userid>",17,30242,723,"Geert Wilders (PVV)",0.534641562803854,0.0687262357414449,0
"<anonymized_userid>",17,30259,724,"Geert Wilders (PVV)",0.534942102006541,0.0688212927756654,0
"<anonymized_userid>",17,30276,725,"Geert Wilders (PVV)",0.535242641209228,0.0689163498098859,0
"<anonymized_userid>",17,30293,726,"Geert Wilders (PVV)",0.535543180411916,0.0690114068441065,0
"<anonymized_userid>",17,30310,727,"Geert Wilders (PVV)",0.535843719614603,0.069106463878327,0
"<anonymized_userid>",17,30327,728,"Geert Wilders (PVV)",0.53614425881729,0.0692015209125475,0
"<anonymized_userid>",17,30344,729,"Geert Wilders (PVV)",0.536444798019977,0.0692965779467681,0
"<anonymized_userid>",17,30361,730,"Geert Wilders (PVV)",0.536745337222664,0.0693916349809886,0
"<anonymized_userid>",17,30378,731,"Geert Wilders (PVV)",0.537045876425351,0.0694866920152091,0
"<anonymized_userid>",17,30395,732,"Geert Wilders (PVV)",0.537346415628039,0.0695817490494297,0
"<anonymized_userid>",17,30412,733,"Geert Wilders (PVV)",0.537646954830726,0.0696768060836502,0
"<anonymized_userid>",17,30429,734,"Geert Wilders (PVV)",0.537947494033413,0.0697718631178707,0
"<anonymized_userid>",17,30446,735,"Geert Wilders (PVV)",0.5382480332361,0.0698669201520913,0
"<anonymized_userid>",17,30463,736,"Geert Wilders (PVV)",0.538548572438787,0.0699619771863118,0
"<anonymized_userid>",17,30480,737,"Geert Wilders (PVV)",0.538849111641474,0.0700570342205323,0
"<anonymized_userid>",17,30497,738,"Geert Wilders (PVV)",0.539149650844162,0.0701520912547529,0
"<anonymized_userid>",17,30514,739,"Geert Wilders (PVV)",0.539450190046849,0.0702471482889734,0
"<anonymized_userid>",17,30531,740,"Geert Wilders (PVV)",0.539750729249536,0.0703422053231939,0
"<anonymized_userid>",17,30548,741,"Geert Wilders (PVV)",0.540051268452223,0.0704372623574144,0
"<anonymized_userid>",17,30565,742,"Geert Wilders (PVV)",0.54035180765491,0.070532319391635,0
"<anonymized_userid>",17,30582,743,"Geert Wilders (PVV)",0.540652346857597,0.0706273764258555,0
"<anonymized_userid>",17,30599,744,"Geert Wilders (PVV)",0.540952886060285,0.070722433460076,0
"<anonymized_userid>",17,30616,745,"Geert Wilders (PVV)",0.541253425262972,0.0708174904942966,0
"<anonymized_userid>",17,30633,746,"Geert Wilders (PVV)",0.541553964465659,0.0709125475285171,0
"<anonymized_userid>",17,30650,747,"Geert Wilders (PVV)",0.541854503668346,0.0710076045627376,0
"<anonymized_userid>",17,30667,748,"Geert Wilders (PVV)",0.542155042871033,0.0711026615969582,0
"<anonymized_userid>",17,30684,749,"Geert Wilders (PVV)",0.54245558207372,0.0711977186311787,0
"<anonymized_userid>",16,30700,750,"Geert Wilders (PVV)",0.542738442499779,0.0712927756653992,0
"<anonymized_userid>",16,30716,751,"Geert Wilders (PVV)",0.543021302925838,0.0713878326996198,0
"<anonymized_userid>",16,30732,752,"Geert Wilders (PVV)",0.543304163351896,0.0714828897338403,0
"<anonymized_userid>",16,30748,753,"Geert Wilders (PVV)",0.543587023777955,0.0715779467680608,0
"<anonymized_userid>",16,30764,754,"Geert Wilders (PVV)",0.543869884204013,0.0716730038022814,0
"<anonymized_userid>",16,30780,755,"Geert Wilders (PVV)",0.544152744630072,0.0717680608365019,0
"<anonymized_userid>",16,30796,756,"Geert Wilders (PVV)",0.54443560505613,0.0718631178707224,0
"<anonymized_userid>",16,30812,757,"Geert Wilders (PVV)",0.544718465482189,0.071958174904943,0
"<anonymized_userid>",16,30828,758,"Geert Wilders (PVV)",0.545001325908247,0.0720532319391635,0
"<anonymized_userid>",16,30844,759,"Geert Wilders (PVV)",0.545284186334306,0.072148288973384,0
"<anonymized_userid>",16,30860,760,"Geert Wilders (PVV)",0.545567046760364,0.0722433460076046,0
"<anonymized_userid>",16,30876,761,"Geert Wilders (PVV)",0.545849907186423,0.0723384030418251,0
"<anonymized_userid>",16,30892,762,"Geert Wilders (PVV)",0.546132767612481,0.0724334600760456,0
"<anonymized_userid>",16,30908,763,"Geert Wilders (PVV)",0.54641562803854,0.0725285171102662,0
"<anonymized_userid>",16,30924,764,"Geert Wilders (PVV)",0.546698488464598,0.0726235741444867,0
"<anonymized_userid>",16,30940,765,"Geert Wilders (PVV)",0.546981348890657,0.0727186311787072,0
"<anonymized_userid>",16,30956,766,"Geert Wilders (PVV)",0.547264209316715,0.0728136882129278,0
"<anonymized_userid>",16,30972,767,"Geert Wilders (PVV)",0.547547069742774,0.0729087452471483,0
"<anonymized_userid>",16,30988,768,"Geert Wilders (PVV)",0.547829930168832,0.0730038022813688,0
"<anonymized_userid>",16,31004,769,"Geert Wilders (PVV)",0.548112790594891,0.0730988593155893,0
"<anonymized_userid>",16,31020,770,"Geert Wilders (PVV)",0.548395651020949,0.0731939163498099,0
"<anonymized_userid>",16,31036,771,"Geert Wilders (PVV)",0.548678511447008,0.0732889733840304,0
"<anonymized_userid>",16,31052,772,"Geert Wilders (PVV)",0.548961371873066,0.073384030418251,0
"<anonymized_userid>",16,31068,773,"Geert Wilders (PVV)",0.549244232299125,0.0734790874524715,0
"<anonymized_userid>",16,31084,774,"Geert Wilders (PVV)",0.549527092725183,0.073574144486692,0
"<anonymized_userid>",16,31100,775,"Geert Wilders (PVV)",0.549809953151242,0.0736692015209126,0
"<anonymized_userid>",16,31116,776,"Geert Wilders (PVV)",0.5500928135773,0.0737642585551331,0
"<anonymized_userid>",16,31132,777,"Geert Wilders (PVV)",0.550375674003359,0.0738593155893536,0
"<anonymized_userid>",16,31148,778,"Geert Wilders (PVV)",0.550658534429417,0.0739543726235741,0
"<anonymized_userid>",16,31164,779,"Geert Wilders (PVV)",0.550941394855476,0.0740494296577947,0
"<anonymized_userid>",16,31180,780,"Geert Wilders (PVV)",0.551224255281535,0.0741444866920152,0
"<anonymized_userid>",16,31196,781,"Geert Wilders (PVV)",0.551507115707593,0.0742395437262357,0
"<anonymized_userid>",16,31212,782,"Geert Wilders (PVV)",0.551789976133652,0.0743346007604563,0
"<anonymized_userid>",16,31228,783,"Geert Wilders (PVV)",0.55207283655971,0.0744296577946768,0
"<anonymized_userid>",16,31244,784,"Geert Wilders (PVV)",0.552355696985769,0.0745247148288973,0
"<anonymized_userid>",16,31260,785,"Geert Wilders (PVV)",0.552638557411827,0.0746197718631179,0
"<anonymized_userid>",16,31276,786,"Geert Wilders (PVV)",0.552921417837886,0.0747148288973384,0
"<anonymized_userid>",16,31292,787,"Geert Wilders (PVV)",0.553204278263944,0.0748098859315589,0
"<anonymized_userid>",16,31308,788,"Geert Wilders (PVV)",0.553487138690003,0.0749049429657795,0
"<anonymized_userid>",16,31324,789,"Geert Wilders (PVV)",0.553769999116061,0.075,0
"<anonymized_userid>",16,31340,790,"Geert Wilders (PVV)",0.55405285954212,0.0750950570342205,0
"<anonymized_userid>",16,31356,791,"Geert Wilders (PVV)",0.554335719968178,0.0751901140684411,0
"<anonymized_userid>",16,31372,792,"Geert Wilders (PVV)",0.554618580394237,0.0752851711026616,0
"<anonymized_userid>",16,31388,793,"Geert Wilders (PVV)",0.554901440820295,0.0753802281368821,0
"<anonymized_userid>",16,31404,794,"Geert Wilders (PVV)",0.555184301246354,0.0754752851711027,0
"<anonymized_userid>",16,31420,795,"Geert Wilders (PVV)",0.555467161672412,0.0755703422053232,0
"<anonymized_userid>",16,31436,796,"Geert Wilders (PVV)",0.555750022098471,0.0756653992395437,0
"<anonymized_userid>",16,31452,797,"Geert Wilders (PVV)",0.556032882524529,0.0757604562737643,0
"<anonymized_userid>",16,31468,798,"Geert Wilders (PVV)",0.556315742950588,0.0758555133079848,0
"<anonymized_userid>",16,31484,799,"Geert Wilders (PVV)",0.556598603376646,0.0759505703422053,0
"<anonymized_userid>",16,31500,800,"Geert Wilders (PVV)",0.556881463802705,0.0760456273764259,0
"<anonymized_userid>",16,31516,801,"Geert Wilders (PVV)",0.557164324228763,0.0761406844106464,0
"<anonymized_userid>",16,31532,802,"Geert Wilders (PVV)",0.557447184654822,0.0762357414448669,0
"<anonymized_userid>",16,31548,803,"Geert Wilders (PVV)",0.55773004508088,0.0763307984790875,0
"<anonymized_userid>",16,31564,804,"Geert Wilders (PVV)",0.558012905506939,0.076425855513308,0
"<anonymized_userid>",15,31579,805,"Geert Wilders (PVV)",0.558278087156369,0.0765209125475285,0
"<anonymized_userid>",15,31594,806,"Geert Wilders (PVV)",0.558543268805799,0.076615969581749,0
"<anonymized_userid>",15,31609,807,"Geert Wilders (PVV)",0.558808450455229,0.0767110266159696,0
"<anonymized_userid>",15,31624,808,"Geert Wilders (PVV)",0.559073632104658,0.0768060836501901,0
"<anonymized_userid>",15,31639,809,"Geert Wilders (PVV)",0.559338813754088,0.0769011406844106,0
"<anonymized_userid>",15,31654,810,"Geert Wilders (PVV)",0.559603995403518,0.0769961977186312,0
"<anonymized_userid>",15,31669,811,"Geert Wilders (PVV)",0.559869177052948,0.0770912547528517,0
"<anonymized_userid>",15,31684,812,"Geert Wilders (PVV)",0.560134358702378,0.0771863117870722,0
"<anonymized_userid>",15,31699,813,"Geert Wilders (PVV)",0.560399540351808,0.0772813688212928,0
"<anonymized_userid>",15,31714,814,"Geert Wilders (PVV)",0.560664722001238,0.0773764258555133,0
"<anonymized_userid>",15,31729,815,"Geert Wilders (PVV)",0.560929903650667,0.0774714828897338,0
"<anonymized_userid>",15,31744,816,"Geert Wilders (PVV)",0.561195085300097,0.0775665399239544,0
"<anonymized_userid>",15,31759,817,"Geert Wilders (PVV)",0.561460266949527,0.0776615969581749,0
"<anonymized_userid>",15,31774,818,"Geert Wilders (PVV)",0.561725448598957,0.0777566539923954,0
"<anonymized_userid>",15,31789,819,"Geert Wilders (PVV)",0.561990630248387,0.077851711026616,0
"<anonymized_userid>",15,31804,820,"Geert Wilders (PVV)",0.562255811897817,0.0779467680608365,0
"<anonymized_userid>",15,31819,821,"Geert Wilders (PVV)",0.562520993547246,0.078041825095057,0
"<anonymized_userid>",15,31834,822,"Geert Wilders (PVV)",0.562786175196676,0.0781368821292776,0
"<anonymized_userid>",15,31849,823,"Geert Wilders (PVV)",0.563051356846106,0.0782319391634981,0
"<anonymized_userid>",15,31864,824,"Geert Wilders (PVV)",0.563316538495536,0.0783269961977186,0
"<anonymized_userid>",15,31879,825,"Geert Wilders (PVV)",0.563581720144966,0.0784220532319392,0
"<anonymized_userid>",15,31894,826,"Geert Wilders (PVV)",0.563846901794396,0.0785171102661597,0
"<anonymized_userid>",15,31909,827,"Geert Wilders (PVV)",0.564112083443826,0.0786121673003802,0
"<anonymized_userid>",15,31924,828,"Geert Wilders (PVV)",0.564377265093256,0.0787072243346008,0
"<anonymized_userid>",15,31939,829,"Geert Wilders (PVV)",0.564642446742685,0.0788022813688213,0
"<anonymized_userid>",15,31954,830,"Geert Wilders (PVV)",0.564907628392115,0.0788973384030418,0
"<anonymized_userid>",15,31969,831,"Geert Wilders (PVV)",0.565172810041545,0.0789923954372624,0
"<anonymized_userid>",15,31984,832,"Geert Wilders (PVV)",0.565437991690975,0.0790874524714829,0
"<anonymized_userid>",15,31999,833,"Geert Wilders (PVV)",0.565703173340405,0.0791825095057034,0
"<anonymized_userid>",15,32014,834,"Geert Wilders (PVV)",0.565968354989835,0.079277566539924,0
"<anonymized_userid>",15,32029,835,"Geert Wilders (PVV)",0.566233536639265,0.0793726235741445,0
"<anonymized_userid>",15,32044,836,"Geert Wilders (PVV)",0.566498718288694,0.079467680608365,0
"<anonymized_userid>",15,32059,837,"Geert Wilders (PVV)",0.566763899938124,0.0795627376425855,0
"<anonymized_userid>",15,32074,838,"Geert Wilders (PVV)",0.567029081587554,0.0796577946768061,0
"<anonymized_userid>",15,32089,839,"Geert Wilders (PVV)",0.567294263236984,0.0797528517110266,0
"<anonymized_userid>",15,32104,840,"Geert Wilders (PVV)",0.567559444886414,0.0798479087452472,0
"<anonymized_userid>",15,32119,841,"Geert Wilders (PVV)",0.567824626535844,0.0799429657794677,0
"<anonymized_userid>",15,32134,842,"Geert Wilders (PVV)",0.568089808185274,0.0800380228136882,0
"<anonymized_userid>",15,32149,843,"Geert Wilders (PVV)",0.568354989834703,0.0801330798479087,0
"<anonymized_userid>",15,32164,844,"Geert Wilders (PVV)",0.568620171484133,0.0802281368821293,0
"<anonymized_userid>",15,32179,845,"Geert Wilders (PVV)",0.568885353133563,0.0803231939163498,0
"<anonymized_userid>",15,32194,846,"Geert Wilders (PVV)",0.569150534782993,0.0804182509505703,0
"<anonymized_userid>",15,32209,847,"Geert Wilders (PVV)",0.569415716432423,0.0805133079847909,0
"<anonymized_userid>",15,32224,848,"Geert Wilders (PVV)",0.569680898081853,0.0806083650190114,0
"<anonymized_userid>",15,32239,849,"Geert Wilders (PVV)",0.569946079731283,0.0807034220532319,0
"<anonymized_userid>",15,32254,850,"Geert Wilders (PVV)",0.570211261380712,0.0807984790874525,0
"<anonymized_userid>",15,32269,851,"Geert Wilders (PVV)",0.570476443030142,0.080893536121673,0
"<anonymized_userid>",15,32284,852,"Geert Wilders (PVV)",0.570741624679572,0.0809885931558935,0
"<anonymized_userid>",15,32299,853,"Geert Wilders (PVV)",0.571006806329002,0.0810836501901141,0
"<anonymized_userid>",15,32314,854,"Geert Wilders (PVV)",0.571271987978432,0.0811787072243346,0
"<anonymized_userid>",15,32329,855,"Geert Wilders (PVV)",0.571537169627862,0.0812737642585551,0
"<anonymized_userid>",15,32344,856,"Geert Wilders (PVV)",0.571802351277292,0.0813688212927757,0
"<anonymized_userid>",15,32359,857,"Geert Wilders (PVV)",0.572067532926722,0.0814638783269962,0
"<anonymized_userid>",15,32374,858,"Geert Wilders (PVV)",0.572332714576151,0.0815589353612167,0
"<anonymized_userid>",15,32389,859,"Geert Wilders (PVV)",0.572597896225581,0.0816539923954373,0
"<anonymized_userid>",15,32404,860,"Geert Wilders (PVV)",0.572863077875011,0.0817490494296578,0
"<anonymized_userid>",15,32419,861,"Geert Wilders (PVV)",0.573128259524441,0.0818441064638783,0
"<anonymized_userid>",15,32434,862,"Geert Wilders (PVV)",0.573393441173871,0.0819391634980989,0
"<anonymized_userid>",15,32449,863,"Geert Wilders (PVV)",0.573658622823301,0.0820342205323194,0
"<anonymized_userid>",15,32464,864,"Geert Wilders (PVV)",0.573923804472731,0.0821292775665399,0
"<anonymized_userid>",15,32479,865,"Geert Wilders (PVV)",0.57418898612216,0.0822243346007605,0
"<anonymized_userid>",15,32494,866,"Geert Wilders (PVV)",0.57445416777159,0.082319391634981,0
"<anonymized_userid>",14,32508,867,"Geert Wilders (PVV)",0.574701670644391,0.0824144486692015,0
"<anonymized_userid>",14,32522,868,"Geert Wilders (PVV)",0.574949173517193,0.0825095057034221,0
"<anonymized_userid>",14,32536,869,"Geert Wilders (PVV)",0.575196676389994,0.0826045627376426,0
"<anonymized_userid>",14,32550,870,"Geert Wilders (PVV)",0.575444179262795,0.0826996197718631,0
"<anonymized_userid>",14,32564,871,"Geert Wilders (PVV)",0.575691682135596,0.0827946768060837,0
"<anonymized_userid>",14,32578,872,"Geert Wilders (PVV)",0.575939185008397,0.0828897338403042,0
"<anonymized_userid>",14,32592,873,"Geert Wilders (PVV)",0.576186687881199,0.0829847908745247,0
"<anonymized_userid>",14,32606,874,"Geert Wilders (PVV)",0.576434190754,0.0830798479087452,0
"<anonymized_userid>",14,32620,875,"Geert Wilders (PVV)",0.576681693626801,0.0831749049429658,0
"<anonymized_userid>",14,32634,876,"Geert Wilders (PVV)",0.576929196499602,0.0832699619771863,0
"<anonymized_userid>",14,32648,877,"Geert Wilders (PVV)",0.577176699372403,0.0833650190114068,0
"<anonymized_userid>",14,32662,878,"Geert Wilders (PVV)",0.577424202245205,0.0834600760456274,0
"<anonymized_userid>",14,32676,879,"Geert Wilders (PVV)",0.577671705118006,0.0835551330798479,0
"<anonymized_userid>",14,32690,880,"Geert Wilders (PVV)",0.577919207990807,0.0836501901140684,0
"<anonymized_userid>",14,32704,881,"Geert Wilders (PVV)",0.578166710863608,0.083745247148289,0
"<anonymized_userid>",14,32718,882,"Geert Wilders (PVV)",0.578414213736409,0.0838403041825095,0
"<anonymized_userid>",14,32732,883,"Geert Wilders (PVV)",0.578661716609211,0.08393536121673,0
"<anonymized_userid>",14,32746,884,"Geert Wilders (PVV)",0.578909219482012,0.0840304182509506,0
"<anonymized_userid>",14,32760,885,"Geert Wilders (PVV)",0.579156722354813,0.0841254752851711,0
"<anonymized_userid>",14,32774,886,"Geert Wilders (PVV)",0.579404225227614,0.0842205323193916,0
"<anonymized_userid>",14,32788,887,"Geert Wilders (PVV)",0.579651728100415,0.0843155893536122,0
"<anonymized_userid>",14,32802,888,"Geert Wilders (PVV)",0.579899230973217,0.0844106463878327,0
"<anonymized_userid>",14,32816,889,"Geert Wilders (PVV)",0.580146733846018,0.0845057034220532,0
"<anonymized_userid>",14,32830,890,"Geert Wilders (PVV)",0.580394236718819,0.0846007604562738,0
"<anonymized_userid>",14,32844,891,"Geert Wilders (PVV)",0.58064173959162,0.0846958174904943,0
"<anonymized_userid>",14,32858,892,"Geert Wilders (PVV)",0.580889242464421,0.0847908745247148,0
"<anonymized_userid>",14,32872,893,"Geert Wilders (PVV)",0.581136745337223,0.0848859315589354,0
"<anonymized_userid>",14,32886,894,"Geert Wilders (PVV)",0.581384248210024,0.0849809885931559,0
"<anonymized_userid>",14,32900,895,"Geert Wilders (PVV)",0.581631751082825,0.0850760456273764,0
"<anonymized_userid>",14,32914,896,"Geert Wilders (PVV)",0.581879253955626,0.085171102661597,0
"<anonymized_userid>",14,32928,897,"Geert Wilders (PVV)",0.582126756828428,0.0852661596958175,0
"<anonymized_userid>",14,32942,898,"Geert Wilders (PVV)",0.582374259701229,0.085361216730038,0
"<anonymized_userid>",14,32956,899,"Geert Wilders (PVV)",0.58262176257403,0.0854562737642586,0
"<anonymized_userid>",14,32970,900,"Geert Wilders (PVV)",0.582869265446831,0.0855513307984791,0
"<anonymized_userid>",14,32984,901,"Geert Wilders (PVV)",0.583116768319632,0.0856463878326996,0
"<anonymized_userid>",14,32998,902,"Geert Wilders (PVV)",0.583364271192434,0.0857414448669201,0
"<anonymized_userid>",14,33012,903,"Geert Wilders (PVV)",0.583611774065235,0.0858365019011407,0
"<anonymized_userid>",14,33026,904,"Geert Wilders (PVV)",0.583859276938036,0.0859315589353612,0
"<anonymized_userid>",14,33040,905,"Geert Wilders (PVV)",0.584106779810837,0.0860266159695817,0
"<anonymized_userid>",14,33054,906,"Geert Wilders (PVV)",0.584354282683638,0.0861216730038023,0
"<anonymized_userid>",14,33068,907,"Geert Wilders (PVV)",0.584601785556439,0.0862167300380228,0
"<anonymized_userid>",14,33082,908,"Geert Wilders (PVV)",0.584849288429241,0.0863117870722434,0
"<anonymized_userid>",14,33096,909,"Geert Wilders (PVV)",0.585096791302042,0.0864068441064639,0
"<anonymized_userid>",14,33110,910,"Geert Wilders (PVV)",0.585344294174843,0.0865019011406844,0
"<anonymized_userid>",14,33124,911,"Geert Wilders (PVV)",0.585591797047644,0.0865969581749049,0
"<anonymized_userid>",14,33138,912,"Geert Wilders (PVV)",0.585839299920445,0.0866920152091255,0
"<anonymized_userid>",14,33152,913,"Geert Wilders (PVV)",0.586086802793247,0.086787072243346,0
"<anonymized_userid>",14,33166,914,"Geert Wilders (PVV)",0.586334305666048,0.0868821292775665,0
"<anonymized_userid>",14,33180,915,"Geert Wilders (PVV)",0.586581808538849,0.0869771863117871,0
"<anonymized_userid>",14,33194,916,"Geert Wilders (PVV)",0.58682931141165,0.0870722433460076,0
"<anonymized_userid>",14,33208,917,"Geert Wilders (PVV)",0.587076814284451,0.0871673003802281,0
"<anonymized_userid>",14,33222,918,"Geert Wilders (PVV)",0.587324317157253,0.0872623574144487,0
"<anonymized_userid>",14,33236,919,"Geert Wilders (PVV)",0.587571820030054,0.0873574144486692,0
"<anonymized_userid>",14,33250,920,"Geert Wilders (PVV)",0.587819322902855,0.0874524714828897,0
"<anonymized_userid>",14,33264,921,"Geert Wilders (PVV)",0.588066825775656,0.0875475285171103,0
"<anonymized_userid>",14,33278,922,"Geert Wilders (PVV)",0.588314328648458,0.0876425855513308,0
"<anonymized_userid>",14,33292,923,"Geert Wilders (PVV)",0.588561831521259,0.0877376425855513,0
"<anonymized_userid>",14,33306,924,"Geert Wilders (PVV)",0.58880933439406,0.0878326996197719,0
"<anonymized_userid>",14,33320,925,"Geert Wilders (PVV)",0.589056837266861,0.0879277566539924,0
"<anonymized_userid>",14,33334,926,"Geert Wilders (PVV)",0.589304340139662,0.0880228136882129,0
"<anonymized_userid>",14,33348,927,"Geert Wilders (PVV)",0.589551843012464,0.0881178707224335,0
"<anonymized_userid>",14,33362,928,"Geert Wilders (PVV)",0.589799345885265,0.088212927756654,0
"<anonymized_userid>",14,33376,929,"Geert Wilders (PVV)",0.590046848758066,0.0883079847908745,0
"<anonymized_userid>",14,33390,930,"Geert Wilders (PVV)",0.590294351630867,0.0884030418250951,0
"<anonymized_userid>",14,33404,931,"Geert Wilders (PVV)",0.590541854503668,0.0884980988593156,0
"<anonymized_userid>",14,33418,932,"Geert Wilders (PVV)",0.59078935737647,0.0885931558935361,0
"<anonymized_userid>",14,33432,933,"Geert Wilders (PVV)",0.591036860249271,0.0886882129277567,0
"<anonymized_userid>",14,33446,934,"Geert Wilders (PVV)",0.591284363122072,0.0887832699619772,0
"<anonymized_userid>",14,33460,935,"Geert Wilders (PVV)",0.591531865994873,0.0888783269961977,0
"<anonymized_userid>",13,33473,936,"Geert Wilders (PVV)",0.591761690091046,0.0889733840304183,0
"<anonymized_userid>",13,33486,937,"Geert Wilders (PVV)",0.591991514187218,0.0890684410646388,0
"<anonymized_userid>",13,33499,938,"Geert Wilders (PVV)",0.592221338283391,0.0891634980988593,0
"<anonymized_userid>",13,33512,939,"Geert Wilders (PVV)",0.592451162379563,0.0892585551330798,0
"<anonymized_userid>",13,33525,940,"Geert Wilders (PVV)",0.592680986475736,0.0893536121673004,0
"<anonymized_userid>",13,33538,941,"Geert Wilders (PVV)",0.592910810571908,0.0894486692015209,0
"<anonymized_userid>",13,33551,942,"Geert Wilders (PVV)",0.593140634668081,0.0895437262357414,0
"<anonymized_userid>",13,33564,943,"Geert Wilders (PVV)",0.593370458764254,0.089638783269962,0
"<anonymized_userid>",13,33577,944,"Geert Wilders (PVV)",0.593600282860426,0.0897338403041825,0
"<anonymized_userid>",13,33590,945,"Geert Wilders (PVV)",0.593830106956599,0.089828897338403,0
"<anonymized_userid>",13,33603,946,"Geert Wilders (PVV)",0.594059931052771,0.0899239543726236,0
"<anonymized_userid>",13,33616,947,"Geert Wilders (PVV)",0.594289755148944,0.0900190114068441,0
"<anonymized_userid>",13,33629,948,"Geert Wilders (PVV)",0.594519579245116,0.0901140684410646,0
"<anonymized_userid>",13,33642,949,"Geert Wilders (PVV)",0.594749403341289,0.0902091254752852,0
"<anonymized_userid>",13,33655,950,"Geert Wilders (PVV)",0.594979227437461,0.0903041825095057,0
"<anonymized_userid>",13,33668,951,"Geert Wilders (PVV)",0.595209051533634,0.0903992395437262,0
"<anonymized_userid>",13,33681,952,"Geert Wilders (PVV)",0.595438875629806,0.0904942965779468,0
"<anonymized_userid>",13,33694,953,"Geert Wilders (PVV)",0.595668699725979,0.0905893536121673,0
"<anonymized_userid>",13,33707,954,"Geert Wilders (PVV)",0.595898523822151,0.0906844106463878,0
"<anonymized_userid>",13,33720,955,"Geert Wilders (PVV)",0.596128347918324,0.0907794676806084,0
"<anonymized_userid>",13,33733,956,"Geert Wilders (PVV)",0.596358172014497,0.0908745247148289,0
"<anonymized_userid>",13,33746,957,"Geert Wilders (PVV)",0.596587996110669,0.0909695817490494,0
"<anonymized_userid>",13,33759,958,"Geert Wilders (PVV)",0.596817820206842,0.09106463878327,0
"<anonymized_userid>",13,33772,959,"Geert Wilders (PVV)",0.597047644303014,0.0911596958174905,0
"<anonymized_userid>",13,33785,960,"Geert Wilders (PVV)",0.597277468399187,0.091254752851711,0
"<anonymized_userid>",13,33798,961,"Geert Wilders (PVV)",0.597507292495359,0.0913498098859316,0
"<anonymized_userid>",13,33811,962,"Geert Wilders (PVV)",0.597737116591532,0.0914448669201521,0
"<anonymized_userid>",13,33824,963,"Geert Wilders (PVV)",0.597966940687704,0.0915399239543726,0
"<anonymized_userid>",13,33837,964,"Geert Wilders (PVV)",0.598196764783877,0.0916349809885932,0
"<anonymized_userid>",13,33850,965,"Geert Wilders (PVV)",0.59842658888005,0.0917300380228137,0
"<anonymized_userid>",13,33863,966,"Geert Wilders (PVV)",0.598656412976222,0.0918250950570342,0
"<anonymized_userid>",13,33876,967,"Geert Wilders (PVV)",0.598886237072395,0.0919201520912548,0
"<anonymized_userid>",13,33889,968,"Geert Wilders (PVV)",0.599116061168567,0.0920152091254753,0
"<anonymized_userid>",13,33902,969,"Geert Wilders (PVV)",0.59934588526474,0.0921102661596958,0
"<anonymized_userid>",13,33915,970,"Geert Wilders (PVV)",0.599575709360912,0.0922053231939163,0
"<anonymized_userid>",13,33928,971,"Geert Wilders (PVV)",0.599805533457085,0.0923003802281369,0
"<anonymized_userid>",13,33941,972,"Geert Wilders (PVV)",0.600035357553257,0.0923954372623574,0
"<anonymized_userid>",13,33954,973,"Geert Wilders (PVV)",0.60026518164943,0.0924904942965779,0
"<anonymized_userid>",13,33967,974,"Geert Wilders (PVV)",0.600495005745602,0.0925855513307985,0
"<anonymized_userid>",13,33980,975,"Geert Wilders (PVV)",0.600724829841775,0.092680608365019,0
"<anonymized_userid>",13,33993,976,"Geert Wilders (PVV)",0.600954653937947,0.0927756653992395,0
"<anonymized_userid>",13,34006,977,"Geert Wilders (PVV)",0.60118447803412,0.0928707224334601,0
"<anonymized_userid>",13,34019,978,"Geert Wilders (PVV)",0.601414302130293,0.0929657794676806,0
"<anonymized_userid>",13,34032,979,"Geert Wilders (PVV)",0.601644126226465,0.0930608365019011,0
"<anonymized_userid>",13,34045,980,"Geert Wilders (PVV)",0.601873950322638,0.0931558935361217,0
"<anonymized_userid>",13,34058,981,"Geert Wilders (PVV)",0.60210377441881,0.0932509505703422,0
"<anonymized_userid>",13,34071,982,"Geert Wilders (PVV)",0.602333598514983,0.0933460076045627,0
"<anonymized_userid>",13,34084,983,"Geert Wilders (PVV)",0.602563422611155,0.0934410646387833,0
"<anonymized_userid>",13,34097,984,"Geert Wilders (PVV)",0.602793246707328,0.0935361216730038,0
"<anonymized_userid>",13,34110,985,"Geert Wilders (PVV)",0.6030230708035,0.0936311787072243,0
"<anonymized_userid>",13,34123,986,"Geert Wilders (PVV)",0.603252894899673,0.0937262357414449,0
"<anonymized_userid>",13,34136,987,"Geert Wilders (PVV)",0.603482718995845,0.0938212927756654,0
"<anonymized_userid>",13,34149,988,"Geert Wilders (PVV)",0.603712543092018,0.0939163498098859,0
"<anonymized_userid>",13,34162,989,"Geert Wilders (PVV)",0.603942367188191,0.0940114068441065,0
"<anonymized_userid>",13,34175,990,"Geert Wilders (PVV)",0.604172191284363,0.094106463878327,0
"<anonymized_userid>",13,34188,991,"Geert Wilders (PVV)",0.604402015380536,0.0942015209125475,0
"<anonymized_userid>",13,34201,992,"Geert Wilders (PVV)",0.604631839476708,0.0942965779467681,0
"<anonymized_userid>",13,34214,993,"Geert Wilders (PVV)",0.604861663572881,0.0943916349809886,0
"<anonymized_userid>",13,34227,994,"Geert Wilders (PVV)",0.605091487669053,0.0944866920152091,0
"<anonymized_userid>",13,34240,995,"Geert Wilders (PVV)",0.605321311765226,0.0945817490494297,0
"<anonymized_userid>",13,34253,996,"Geert Wilders (PVV)",0.605551135861398,0.0946768060836502,0
"<anonymized_userid>",13,34266,997,"Geert Wilders (PVV)",0.605780959957571,0.0947718631178707,0
"<anonymized_userid>",13,34279,998,"Geert Wilders (PVV)",0.606010784053744,0.0948669201520912,0
"<anonymized_userid>",13,34292,999,"Geert Wilders (PVV)",0.606240608149916,0.0949619771863118,0
"<anonymized_userid>",13,34305,1000,"Geert Wilders (PVV)",0.606470432246089,0.0950570342205323,0
"<anonymized_userid>",13,34318,1001,"Geert Wilders (PVV)",0.606700256342261,0.0951520912547529,0
"<anonymized_userid>",13,34331,1002,"Geert Wilders (PVV)",0.606930080438434,0.0952471482889734,0
"<anonymized_userid>",13,34344,1003,"Geert Wilders (PVV)",0.607159904534606,0.0953422053231939,0
"<anonymized_userid>",13,34357,1004,"Geert Wilders (PVV)",0.607389728630779,0.0954372623574145,0
"<anonymized_userid>",13,34370,1005,"Geert Wilders (PVV)",0.607619552726951,0.095532319391635,0
"<anonymized_userid>",13,34383,1006,"Geert Wilders (PVV)",0.607849376823124,0.0956273764258555,0
"<anonymized_userid>",13,34396,1007,"Geert Wilders (PVV)",0.608079200919296,0.095722433460076,0
"<anonymized_userid>",13,34409,1008,"Geert Wilders (PVV)",0.608309025015469,0.0958174904942966,0
"<anonymized_userid>",13,34422,1009,"Geert Wilders (PVV)",0.608538849111641,0.0959125475285171,0
"<anonymized_userid>",13,34435,1010,"Geert Wilders (PVV)",0.608768673207814,0.0960076045627376,0
"<anonymized_userid>",12,34447,1011,"Geert Wilders (PVV)",0.608980818527358,0.0961026615969582,0
"<anonymized_userid>",12,34459,1012,"Geert Wilders (PVV)",0.609192963846902,0.0961977186311787,0
"<anonymized_userid>",12,34471,1013,"Geert Wilders (PVV)",0.609405109166446,0.0962927756653992,0
"<anonymized_userid>",12,34483,1014,"Geert Wilders (PVV)",0.60961725448599,0.0963878326996198,0
"<anonymized_userid>",12,34495,1015,"Geert Wilders (PVV)",0.609829399805533,0.0964828897338403,0
"<anonymized_userid>",12,34507,1016,"Geert Wilders (PVV)",0.610041545125077,0.0965779467680608,0
"<anonymized_userid>",12,34519,1017,"Geert Wilders (PVV)",0.610253690444621,0.0966730038022814,0
"<anonymized_userid>",12,34531,1018,"Geert Wilders (PVV)",0.610465835764165,0.0967680608365019,0
"<anonymized_userid>",12,34543,1019,"Geert Wilders (PVV)",0.610677981083709,0.0968631178707224,0
"<anonymized_userid>",12,34555,1020,"Geert Wilders (PVV)",0.610890126403253,0.096958174904943,0
"<anonymized_userid>",12,34567,1021,"Geert Wilders (PVV)",0.611102271722797,0.0970532319391635,0
"<anonymized_userid>",12,34579,1022,"Geert Wilders (PVV)",0.611314417042341,0.097148288973384,0
"<anonymized_userid>",12,34591,1023,"Geert Wilders (PVV)",0.611526562361885,0.0972433460076046,0
"<anonymized_userid>",12,34603,1024,"Geert Wilders (PVV)",0.611738707681428,0.0973384030418251,0
"<anonymized_userid>",12,34615,1025,"Geert Wilders (PVV)",0.611950853000972,0.0974334600760456,0
"<anonymized_userid>",12,34627,1026,"Geert Wilders (PVV)",0.612162998320516,0.0975285171102662,0
"<anonymized_userid>",12,34639,1027,"Geert Wilders (PVV)",0.61237514364006,0.0976235741444867,0
"<anonymized_userid>",12,34651,1028,"Geert Wilders (PVV)",0.612587288959604,0.0977186311787072,0
"<anonymized_userid>",12,34663,1029,"Geert Wilders (PVV)",0.612799434279148,0.0978136882129278,0
"<anonymized_userid>",12,34675,1030,"Geert Wilders (PVV)",0.613011579598692,0.0979087452471483,0
"<anonymized_userid>",12,34687,1031,"Geert Wilders (PVV)",0.613223724918236,0.0980038022813688,0
"<anonymized_userid>",12,34699,1032,"Geert Wilders (PVV)",0.61343587023778,0.0980988593155894,0
"<anonymized_userid>",12,34711,1033,"Geert Wilders (PVV)",0.613648015557323,0.0981939163498099,0
"<anonymized_userid>",12,34723,1034,"Geert Wilders (PVV)",0.613860160876867,0.0982889733840304,0
"<anonymized_userid>",12,34735,1035,"Geert Wilders (PVV)",0.614072306196411,0.0983840304182509,0
"<anonymized_userid>",12,34747,1036,"Geert Wilders (PVV)",0.614284451515955,0.0984790874524715,0
"<anonymized_userid>",12,34759,1037,"Geert Wilders (PVV)",0.614496596835499,0.098574144486692,0
"<anonymized_userid>",12,34771,1038,"Geert Wilders (PVV)",0.614708742155043,0.0986692015209125,0
"<anonymized_userid>",12,34783,1039,"Geert Wilders (PVV)",0.614920887474587,0.0987642585551331,0
"<anonymized_userid>",12,34795,1040,"Geert Wilders (PVV)",0.615133032794131,0.0988593155893536,0
"<anonymized_userid>",12,34807,1041,"Geert Wilders (PVV)",0.615345178113675,0.0989543726235741,0
"<anonymized_userid>",12,34819,1042,"Geert Wilders (PVV)",0.615557323433218,0.0990494296577947,0
"<anonymized_userid>",12,34831,1043,"Geert Wilders (PVV)",0.615769468752762,0.0991444866920152,0
"<anonymized_userid>",12,34843,1044,"Geert Wilders (PVV)",0.615981614072306,0.0992395437262357,0
"<anonymized_userid>",12,34855,1045,"Geert Wilders (PVV)",0.61619375939185,0.0993346007604563,0
"<anonymized_userid>",12,34867,1046,"Geert Wilders (PVV)",0.616405904711394,0.0994296577946768,0
"<anonymized_userid>",12,34879,1047,"Geert Wilders (PVV)",0.616618050030938,0.0995247148288973,0
"<anonymized_userid>",12,34891,1048,"Geert Wilders (PVV)",0.616830195350482,0.0996197718631179,0
"<anonymized_userid>",12,34903,1049,"Geert Wilders (PVV)",0.617042340670026,0.0997148288973384,0
"<anonymized_userid>",12,34915,1050,"Geert Wilders (PVV)",0.61725448598957,0.0998098859315589,0
"<anonymized_userid>",12,34927,1051,"Geert Wilders (PVV)",0.617466631309113,0.0999049429657795,0
"<anonymized_userid>",12,34939,1052,"Geert Wilders (PVV)",0.617678776628657,0.1,0
"<anonymized_userid>",12,34951,1053,"Geert Wilders (PVV)",0.617890921948201,0.100095057034221,0
"<anonymized_userid>",12,34963,1054,"Geert Wilders (PVV)",0.618103067267745,0.100190114068441,0
"<anonymized_userid>",12,34975,1055,"Geert Wilders (PVV)",0.618315212587289,0.100285171102662,0
"<anonymized_userid>",12,34987,1056,"Geert Wilders (PVV)",0.618527357906833,0.100380228136882,0
"<anonymized_userid>",12,34999,1057,"Geert Wilders (PVV)",0.618739503226377,0.100475285171103,0
"<anonymized_userid>",12,35011,1058,"Geert Wilders (PVV)",0.618951648545921,0.100570342205323,0
"<anonymized_userid>",12,35023,1059,"Geert Wilders (PVV)",0.619163793865464,0.100665399239544,0
"<anonymized_userid>",12,35035,1060,"Geert Wilders (PVV)",0.619375939185008,0.100760456273764,0
"<anonymized_userid>",12,35047,1061,"Geert Wilders (PVV)",0.619588084504552,0.100855513307985,0
"<anonymized_userid>",12,35059,1062,"Geert Wilders (PVV)",0.619800229824096,0.100950570342205,0
"<anonymized_userid>",12,35071,1063,"Geert Wilders (PVV)",0.62001237514364,0.101045627376426,0
"<anonymized_userid>",12,35083,1064,"Geert Wilders (PVV)",0.620224520463184,0.101140684410646,0
"<anonymized_userid>",12,35095,1065,"Geert Wilders (PVV)",0.620436665782728,0.101235741444867,0
"<anonymized_userid>",12,35107,1066,"Geert Wilders (PVV)",0.620648811102272,0.101330798479087,0
"<anonymized_userid>",12,35119,1067,"Geert Wilders (PVV)",0.620860956421816,0.101425855513308,0
"<anonymized_userid>",12,35131,1068,"Geert Wilders (PVV)",0.62107310174136,0.101520912547529,0
"<anonymized_userid>",12,35143,1069,"Geert Wilders (PVV)",0.621285247060903,0.101615969581749,0
"<anonymized_userid>",12,35155,1070,"Geert Wilders (PVV)",0.621497392380447,0.10171102661597,0
"<anonymized_userid>",12,35167,1071,"Geert Wilders (PVV)",0.621709537699991,0.10180608365019,0
"<anonymized_userid>",12,35179,1072,"Geert Wilders (PVV)",0.621921683019535,0.101901140684411,0
"<anonymized_userid>",12,35191,1073,"Geert Wilders (PVV)",0.622133828339079,0.101996197718631,0
"<anonymized_userid>",12,35203,1074,"Geert Wilders (PVV)",0.622345973658623,0.102091254752852,0
"<anonymized_userid>",12,35215,1075,"Geert Wilders (PVV)",0.622558118978167,0.102186311787072,0
"<anonymized_userid>",12,35227,1076,"Geert Wilders (PVV)",0.622770264297711,0.102281368821293,0
"<anonymized_userid>",12,35239,1077,"Geert Wilders (PVV)",0.622982409617254,0.102376425855513,0
"<anonymized_userid>",12,35251,1078,"Geert Wilders (PVV)",0.623194554936798,0.102471482889734,0
"<anonymized_userid>",12,35263,1079,"Geert Wilders (PVV)",0.623406700256342,0.102566539923954,0
"<anonymized_userid>",12,35275,1080,"Geert Wilders (PVV)",0.623618845575886,0.102661596958175,0
"<anonymized_userid>",12,35287,1081,"Geert Wilders (PVV)",0.62383099089543,0.102756653992395,0
"<anonymized_userid>",12,35299,1082,"Geert Wilders (PVV)",0.624043136214974,0.102851711026616,0
"<anonymized_userid>",12,35311,1083,"Geert Wilders (PVV)",0.624255281534518,0.102946768060836,0
"<anonymized_userid>",12,35323,1084,"Geert Wilders (PVV)",0.624467426854062,0.103041825095057,0
"<anonymized_userid>",12,35335,1085,"Geert Wilders (PVV)",0.624679572173606,0.103136882129278,0
"<anonymized_userid>",12,35347,1086,"Geert Wilders (PVV)",0.624891717493149,0.103231939163498,0
"<anonymized_userid>",12,35359,1087,"Geert Wilders (PVV)",0.625103862812693,0.103326996197719,0
"<anonymized_userid>",12,35371,1088,"Geert Wilders (PVV)",0.625316008132237,0.103422053231939,0
"<anonymized_userid>",12,35383,1089,"Geert Wilders (PVV)",0.625528153451781,0.10351711026616,0
"<anonymized_userid>",12,35395,1090,"Geert Wilders (PVV)",0.625740298771325,0.10361216730038,0
"<anonymized_userid>",12,35407,1091,"Geert Wilders (PVV)",0.625952444090869,0.103707224334601,0
"<anonymized_userid>",12,35419,1092,"Geert Wilders (PVV)",0.626164589410413,0.103802281368821,0
"<anonymized_userid>",12,35431,1093,"Geert Wilders (PVV)",0.626376734729957,0.103897338403042,0
"<anonymized_userid>",12,35443,1094,"Geert Wilders (PVV)",0.626588880049501,0.103992395437262,0
"<anonymized_userid>",12,35455,1095,"Geert Wilders (PVV)",0.626801025369044,0.104087452471483,0
"<anonymized_userid>",11,35466,1096,"Geert Wilders (PVV)",0.62699549191196,0.104182509505703,0
"<anonymized_userid>",11,35477,1097,"Geert Wilders (PVV)",0.627189958454875,0.104277566539924,0
"<anonymized_userid>",11,35488,1098,"Geert Wilders (PVV)",0.62738442499779,0.104372623574144,0
"<anonymized_userid>",11,35499,1099,"Geert Wilders (PVV)",0.627578891540705,0.104467680608365,0
"<anonymized_userid>",11,35510,1100,"Geert Wilders (PVV)",0.627773358083621,0.104562737642586,0
"<anonymized_userid>",11,35521,1101,"Geert Wilders (PVV)",0.627967824626536,0.104657794676806,0
"<anonymized_userid>",11,35532,1102,"Geert Wilders (PVV)",0.628162291169451,0.104752851711027,0
"<anonymized_userid>",11,35543,1103,"Geert Wilders (PVV)",0.628356757712366,0.104847908745247,0
"<anonymized_userid>",11,35554,1104,"Geert Wilders (PVV)",0.628551224255282,0.104942965779468,0
"<anonymized_userid>",11,35565,1105,"Geert Wilders (PVV)",0.628745690798197,0.105038022813688,0
"<anonymized_userid>",11,35576,1106,"Geert Wilders (PVV)",0.628940157341112,0.105133079847909,0
"<anonymized_userid>",11,35587,1107,"Geert Wilders (PVV)",0.629134623884027,0.105228136882129,0
"<anonymized_userid>",11,35598,1108,"Geert Wilders (PVV)",0.629329090426942,0.10532319391635,0
"<anonymized_userid>",11,35609,1109,"Geert Wilders (PVV)",0.629523556969858,0.10541825095057,0
"<anonymized_userid>",11,35620,1110,"Geert Wilders (PVV)",0.629718023512773,0.105513307984791,0
"<anonymized_userid>",11,35631,1111,"Geert Wilders (PVV)",0.629912490055688,0.105608365019011,0
"<anonymized_userid>",11,35642,1112,"Geert Wilders (PVV)",0.630106956598603,0.105703422053232,0
"<anonymized_userid>",11,35653,1113,"Geert Wilders (PVV)",0.630301423141519,0.105798479087452,0
"<anonymized_userid>",11,35664,1114,"Geert Wilders (PVV)",0.630495889684434,0.105893536121673,0
"<anonymized_userid>",11,35675,1115,"Geert Wilders (PVV)",0.630690356227349,0.105988593155894,0
"<anonymized_userid>",11,35686,1116,"Geert Wilders (PVV)",0.630884822770264,0.106083650190114,0
"<anonymized_userid>",11,35697,1117,"Geert Wilders (PVV)",0.63107928931318,0.106178707224335,0
"<anonymized_userid>",11,35708,1118,"Geert Wilders (PVV)",0.631273755856095,0.106273764258555,0
"<anonymized_userid>",11,35719,1119,"Geert Wilders (PVV)",0.63146822239901,0.106368821292776,0
"<anonymized_userid>",11,35730,1120,"Geert Wilders (PVV)",0.631662688941925,0.106463878326996,0
"<anonymized_userid>",11,35741,1121,"Geert Wilders (PVV)",0.63185715548484,0.106558935361217,0
"<anonymized_userid>",11,35752,1122,"Geert Wilders (PVV)",0.632051622027756,0.106653992395437,0
"<anonymized_userid>",11,35763,1123,"Geert Wilders (PVV)",0.632246088570671,0.106749049429658,0
"<anonymized_userid>",11,35774,1124,"Geert Wilders (PVV)",0.632440555113586,0.106844106463878,0
"<anonymized_userid>",11,35785,1125,"Geert Wilders (PVV)",0.632635021656501,0.106939163498099,0
"<anonymized_userid>",11,35796,1126,"Geert Wilders (PVV)",0.632829488199417,0.107034220532319,0
"<anonymized_userid>",11,35807,1127,"Geert Wilders (PVV)",0.633023954742332,0.10712927756654,0
"<anonymized_userid>",11,35818,1128,"Geert Wilders (PVV)",0.633218421285247,0.10722433460076,0
"<anonymized_userid>",11,35829,1129,"Geert Wilders (PVV)",0.633412887828162,0.107319391634981,0
"<anonymized_userid>",11,35840,1130,"Geert Wilders (PVV)",0.633607354371078,0.107414448669202,0
"<anonymized_userid>",11,35851,1131,"Geert Wilders (PVV)",0.633801820913993,0.107509505703422,0
"<anonymized_userid>",11,35862,1132,"Geert Wilders (PVV)",0.633996287456908,0.107604562737643,0
"<anonymized_userid>",11,35873,1133,"Geert Wilders (PVV)",0.634190753999823,0.107699619771863,0
"<anonymized_userid>",11,35884,1134,"Geert Wilders (PVV)",0.634385220542738,0.107794676806084,0
"<anonymized_userid>",11,35895,1135,"Geert Wilders (PVV)",0.634579687085654,0.107889733840304,0
"<anonymized_userid>",11,35906,1136,"Geert Wilders (PVV)",0.634774153628569,0.107984790874525,0
"<anonymized_userid>",11,35917,1137,"Geert Wilders (PVV)",0.634968620171484,0.108079847908745,0
"<anonymized_userid>",11,35928,1138,"Geert Wilders (PVV)",0.635163086714399,0.108174904942966,0
"<anonymized_userid>",11,35939,1139,"Geert Wilders (PVV)",0.635357553257315,0.108269961977186,0
"<anonymized_userid>",11,35950,1140,"Geert Wilders (PVV)",0.63555201980023,0.108365019011407,0
"<anonymized_userid>",11,35961,1141,"Geert Wilders (PVV)",0.635746486343145,0.108460076045627,0
"<anonymized_userid>",11,35972,1142,"Geert Wilders (PVV)",0.63594095288606,0.108555133079848,0
"<anonymized_userid>",11,35983,1143,"Geert Wilders (PVV)",0.636135419428976,0.108650190114068,0
"<anonymized_userid>",11,35994,1144,"Geert Wilders (PVV)",0.636329885971891,0.108745247148289,0
"<anonymized_userid>",11,36005,1145,"Geert Wilders (PVV)",0.636524352514806,0.10884030418251,0
"<anonymized_userid>",11,36016,1146,"Geert Wilders (PVV)",0.636718819057721,0.10893536121673,0
"<anonymized_userid>",11,36027,1147,"Geert Wilders (PVV)",0.636913285600636,0.109030418250951,0
"<anonymized_userid>",11,36038,1148,"Geert Wilders (PVV)",0.637107752143552,0.109125475285171,0
"<anonymized_userid>",11,36049,1149,"Geert Wilders (PVV)",0.637302218686467,0.109220532319392,0
"<anonymized_userid>",11,36060,1150,"Geert Wilders (PVV)",0.637496685229382,0.109315589353612,0
"<anonymized_userid>",11,36071,1151,"Geert Wilders (PVV)",0.637691151772297,0.109410646387833,0
"<anonymized_userid>",11,36082,1152,"Geert Wilders (PVV)",0.637885618315213,0.109505703422053,0
"<anonymized_userid>",11,36093,1153,"Geert Wilders (PVV)",0.638080084858128,0.109600760456274,0
"<anonymized_userid>",11,36104,1154,"Geert Wilders (PVV)",0.638274551401043,0.109695817490494,0
"<anonymized_userid>",11,36115,1155,"Geert Wilders (PVV)",0.638469017943958,0.109790874524715,0
"<anonymized_userid>",11,36126,1156,"Geert Wilders (PVV)",0.638663484486873,0.109885931558935,0
"<anonymized_userid>",11,36137,1157,"Geert Wilders (PVV)",0.638857951029789,0.109980988593156,0
"<anonymized_userid>",11,36148,1158,"Geert Wilders (PVV)",0.639052417572704,0.110076045627376,0
"<anonymized_userid>",11,36159,1159,"Geert Wilders (PVV)",0.639246884115619,0.110171102661597,0
"<anonymized_userid>",11,36170,1160,"Geert Wilders (PVV)",0.639441350658534,0.110266159695817,0
"<anonymized_userid>",11,36181,1161,"Geert Wilders (PVV)",0.63963581720145,0.110361216730038,0
"<anonymized_userid>",11,36192,1162,"Geert Wilders (PVV)",0.639830283744365,0.110456273764259,0
"<anonymized_userid>",11,36203,1163,"Geert Wilders (PVV)",0.64002475028728,0.110551330798479,0
"<anonymized_userid>",11,36214,1164,"Geert Wilders (PVV)",0.640219216830195,0.1106463878327,0
"<anonymized_userid>",11,36225,1165,"Geert Wilders (PVV)",0.640413683373111,0.11074144486692,0
"<anonymized_userid>",11,36236,1166,"Geert Wilders (PVV)",0.640608149916026,0.110836501901141,0
"<anonymized_userid>",11,36247,1167,"Geert Wilders (PVV)",0.640802616458941,0.110931558935361,0
"<anonymized_userid>",11,36258,1168,"Geert Wilders (PVV)",0.640997083001856,0.111026615969582,0
"<anonymized_userid>",11,36269,1169,"Geert Wilders (PVV)",0.641191549544772,0.111121673003802,0
"<anonymized_userid>",11,36280,1170,"Geert Wilders (PVV)",0.641386016087687,0.111216730038023,0
"<anonymized_userid>",11,36291,1171,"Geert Wilders (PVV)",0.641580482630602,0.111311787072243,0
"<anonymized_userid>",11,36302,1172,"Geert Wilders (PVV)",0.641774949173517,0.111406844106464,0
"<anonymized_userid>",11,36313,1173,"Geert Wilders (PVV)",0.641969415716432,0.111501901140684,0
"<anonymized_userid>",11,36324,1174,"Geert Wilders (PVV)",0.642163882259348,0.111596958174905,0
"<anonymized_userid>",11,36335,1175,"Geert Wilders (PVV)",0.642358348802263,0.111692015209125,0
"<anonymized_userid>",11,36346,1176,"Geert Wilders (PVV)",0.642552815345178,0.111787072243346,0
"<anonymized_userid>",11,36357,1177,"Geert Wilders (PVV)",0.642747281888093,0.111882129277567,0
"<anonymized_userid>",11,36368,1178,"Geert Wilders (PVV)",0.642941748431009,0.111977186311787,0
"<anonymized_userid>",11,36379,1179,"Geert Wilders (PVV)",0.643136214973924,0.112072243346008,0
"<anonymized_userid>",11,36390,1180,"Geert Wilders (PVV)",0.643330681516839,0.112167300380228,0
"<anonymized_userid>",11,36401,1181,"Geert Wilders (PVV)",0.643525148059754,0.112262357414449,0
"<anonymized_userid>",11,36412,1182,"Geert Wilders (PVV)",0.643719614602669,0.112357414448669,0
"<anonymized_userid>",11,36423,1183,"Geert Wilders (PVV)",0.643914081145585,0.11245247148289,0
"<anonymized_userid>",11,36434,1184,"Geert Wilders (PVV)",0.6441085476885,0.11254752851711,0
"<anonymized_userid>",11,36445,1185,"Geert Wilders (PVV)",0.644303014231415,0.112642585551331,0
"<anonymized_userid>",11,36456,1186,"Geert Wilders (PVV)",0.64449748077433,0.112737642585551,0
"<anonymized_userid>",11,36467,1187,"Geert Wilders (PVV)",0.644691947317246,0.112832699619772,0
"<anonymized_userid>",11,36478,1188,"Geert Wilders (PVV)",0.644886413860161,0.112927756653992,0
"<anonymized_userid>",11,36489,1189,"Geert Wilders (PVV)",0.645080880403076,0.113022813688213,0
"<anonymized_userid>",11,36500,1190,"Geert Wilders (PVV)",0.645275346945991,0.113117870722433,0
"<anonymized_userid>",10,36510,1191,"Geert Wilders (PVV)",0.645452134712278,0.113212927756654,0
"<anonymized_userid>",10,36520,1192,"Geert Wilders (PVV)",0.645628922478565,0.113307984790875,0
"<anonymized_userid>",10,36530,1193,"Geert Wilders (PVV)",0.645805710244851,0.113403041825095,0
"<anonymized_userid>",10,36540,1194,"Geert Wilders (PVV)",0.645982498011138,0.113498098859316,0
"<anonymized_userid>",10,36550,1195,"Geert Wilders (PVV)",0.646159285777424,0.113593155893536,0
"<anonymized_userid>",10,36560,1196,"Geert Wilders (PVV)",0.646336073543711,0.113688212927757,0
"<anonymized_userid>",10,36570,1197,"Geert Wilders (PVV)",0.646512861309997,0.113783269961977,0
"<anonymized_userid>",10,36580,1198,"Geert Wilders (PVV)",0.646689649076284,0.113878326996198,0
"<anonymized_userid>",10,36590,1199,"Geert Wilders (PVV)",0.646866436842571,0.113973384030418,0
"<anonymized_userid>",10,36600,1200,"Geert Wilders (PVV)",0.647043224608857,0.114068441064639,0
"<anonymized_userid>",10,36610,1201,"Geert Wilders (PVV)",0.647220012375144,0.114163498098859,0
"<anonymized_userid>",10,36620,1202,"Geert Wilders (PVV)",0.64739680014143,0.11425855513308,0
"<anonymized_userid>",10,36630,1203,"Geert Wilders (PVV)",0.647573587907717,0.1143536121673,0
"<anonymized_userid>",10,36640,1204,"Geert Wilders (PVV)",0.647750375674003,0.114448669201521,0
"<anonymized_userid>",10,36650,1205,"Geert Wilders (PVV)",0.64792716344029,0.114543726235741,0
"<anonymized_userid>",10,36660,1206,"Geert Wilders (PVV)",0.648103951206576,0.114638783269962,0
"<anonymized_userid>",10,36670,1207,"Geert Wilders (PVV)",0.648280738972863,0.114733840304183,0
"<anonymized_userid>",10,36680,1208,"Geert Wilders (PVV)",0.64845752673915,0.114828897338403,0
"<anonymized_userid>",10,36690,1209,"Geert Wilders (PVV)",0.648634314505436,0.114923954372624,0
"<anonymized_userid>",10,36700,1210,"Geert Wilders (PVV)",0.648811102271723,0.115019011406844,0
"<anonymized_userid>",10,36710,1211,"Geert Wilders (PVV)",0.648987890038009,0.115114068441065,0
"<anonymized_userid>",10,36720,1212,"Geert Wilders (PVV)",0.649164677804296,0.115209125475285,0
"<anonymized_userid>",10,36730,1213,"Geert Wilders (PVV)",0.649341465570582,0.115304182509506,0
"<anonymized_userid>",10,36740,1214,"Geert Wilders (PVV)",0.649518253336869,0.115399239543726,0
"<anonymized_userid>",10,36750,1215,"Geert Wilders (PVV)",0.649695041103156,0.115494296577947,0
"<anonymized_userid>",10,36760,1216,"Geert Wilders (PVV)",0.649871828869442,0.115589353612167,0
"<anonymized_userid>",10,36770,1217,"Geert Wilders (PVV)",0.650048616635729,0.115684410646388,0
"<anonymized_userid>",10,36780,1218,"Geert Wilders (PVV)",0.650225404402015,0.115779467680608,0
"<anonymized_userid>",10,36790,1219,"Geert Wilders (PVV)",0.650402192168302,0.115874524714829,0
"<anonymized_userid>",10,36800,1220,"Geert Wilders (PVV)",0.650578979934589,0.115969581749049,0
"<anonymized_userid>",10,36810,1221,"Geert Wilders (PVV)",0.650755767700875,0.11606463878327,0
"<anonymized_userid>",10,36820,1222,"Geert Wilders (PVV)",0.650932555467162,0.11615969581749,0
"<anonymized_userid>",10,36830,1223,"Geert Wilders (PVV)",0.651109343233448,0.116254752851711,0
"<anonymized_userid>",10,36840,1224,"Geert Wilders (PVV)",0.651286130999735,0.116349809885932,0
"<anonymized_userid>",10,36850,1225,"Geert Wilders (PVV)",0.651462918766021,0.116444866920152,0
"<anonymized_userid>",10,36860,1226,"Geert Wilders (PVV)",0.651639706532308,0.116539923954373,0
"<anonymized_userid>",10,36870,1227,"Geert Wilders (PVV)",0.651816494298595,0.116634980988593,0
"<anonymized_userid>",10,36880,1228,"Geert Wilders (PVV)",0.651993282064881,0.116730038022814,0
"<anonymized_userid>",10,36890,1229,"Geert Wilders (PVV)",0.652170069831168,0.116825095057034,0
"<anonymized_userid>",10,36900,1230,"Geert Wilders (PVV)",0.652346857597454,0.116920152091255,0
"<anonymized_userid>",10,36910,1231,"Geert Wilders (PVV)",0.652523645363741,0.117015209125475,0
"<anonymized_userid>",10,36920,1232,"Geert Wilders (PVV)",0.652700433130027,0.117110266159696,0
"<anonymized_userid>",10,36930,1233,"Geert Wilders (PVV)",0.652877220896314,0.117205323193916,0
"<anonymized_userid>",10,36940,1234,"Geert Wilders (PVV)",0.653054008662601,0.117300380228137,0
"<anonymized_userid>",10,36950,1235,"Geert Wilders (PVV)",0.653230796428887,0.117395437262357,0
"<anonymized_userid>",10,36960,1236,"Geert Wilders (PVV)",0.653407584195174,0.117490494296578,0
"<anonymized_userid>",10,36970,1237,"Geert Wilders (PVV)",0.65358437196146,0.117585551330798,0
"<anonymized_userid>",10,36980,1238,"Geert Wilders (PVV)",0.653761159727747,0.117680608365019,0
"<anonymized_userid>",10,36990,1239,"Geert Wilders (PVV)",0.653937947494033,0.11777566539924,0
"<anonymized_userid>",10,37000,1240,"Geert Wilders (PVV)",0.65411473526032,0.11787072243346,0
"<anonymized_userid>",10,37010,1241,"Geert Wilders (PVV)",0.654291523026607,0.117965779467681,0
"<anonymized_userid>",10,37020,1242,"Geert Wilders (PVV)",0.654468310792893,0.118060836501901,0
"<anonymized_userid>",10,37030,1243,"Geert Wilders (PVV)",0.65464509855918,0.118155893536122,0
"<anonymized_userid>",10,37040,1244,"Geert Wilders (PVV)",0.654821886325466,0.118250950570342,0
"<anonymized_userid>",10,37050,1245,"Geert Wilders (PVV)",0.654998674091753,0.118346007604563,0
"<anonymized_userid>",10,37060,1246,"Geert Wilders (PVV)",0.655175461858039,0.118441064638783,0
"<anonymized_userid>",10,37070,1247,"Geert Wilders (PVV)",0.655352249624326,0.118536121673004,0
"<anonymized_userid>",10,37080,1248,"Geert Wilders (PVV)",0.655529037390613,0.118631178707224,0
"<anonymized_userid>",10,37090,1249,"Geert Wilders (PVV)",0.655705825156899,0.118726235741445,0
"<anonymized_userid>",10,37100,1250,"Geert Wilders (PVV)",0.655882612923186,0.118821292775665,0
"<anonymized_userid>",10,37110,1251,"Geert Wilders (PVV)",0.656059400689472,0.118916349809886,0
"<anonymized_userid>",10,37120,1252,"Geert Wilders (PVV)",0.656236188455759,0.119011406844106,0
"<anonymized_userid>",10,37130,1253,"Geert Wilders (PVV)",0.656412976222045,0.119106463878327,0
"<anonymized_userid>",10,37140,1254,"Geert Wilders (PVV)",0.656589763988332,0.119201520912548,0
"<anonymized_userid>",10,37150,1255,"Geert Wilders (PVV)",0.656766551754619,0.119296577946768,0
"<anonymized_userid>",10,37160,1256,"Geert Wilders (PVV)",0.656943339520905,0.119391634980989,0
"<anonymized_userid>",10,37170,1257,"Geert Wilders (PVV)",0.657120127287192,0.119486692015209,0
"<anonymized_userid>",10,37180,1258,"Geert Wilders (PVV)",0.657296915053478,0.11958174904943,0
"<anonymized_userid>",10,37190,1259,"Geert Wilders (PVV)",0.657473702819765,0.11967680608365,0
"<anonymized_userid>",10,37200,1260,"Geert Wilders (PVV)",0.657650490586051,0.119771863117871,0
"<anonymized_userid>",10,37210,1261,"Geert Wilders (PVV)",0.657827278352338,0.119866920152091,0
"<anonymized_userid>",10,37220,1262,"Geert Wilders (PVV)",0.658004066118625,0.119961977186312,0
"<anonymized_userid>",10,37230,1263,"Geert Wilders (PVV)",0.658180853884911,0.120057034220532,0
"<anonymized_userid>",10,37240,1264,"Geert Wilders (PVV)",0.658357641651198,0.120152091254753,0
"<anonymized_userid>",10,37250,1265,"Geert Wilders (PVV)",0.658534429417484,0.120247148288973,0
"<anonymized_userid>",10,37260,1266,"Geert Wilders (PVV)",0.658711217183771,0.120342205323194,0
"<anonymized_userid>",10,37270,1267,"Geert Wilders (PVV)",0.658888004950058,0.120437262357414,0
"<anonymized_userid>",10,37280,1268,"Geert Wilders (PVV)",0.659064792716344,0.120532319391635,0
"<anonymized_userid>",10,37290,1269,"Geert Wilders (PVV)",0.659241580482631,0.120627376425856,0
"<anonymized_userid>",10,37300,1270,"Geert Wilders (PVV)",0.659418368248917,0.120722433460076,0
"<anonymized_userid>",10,37310,1271,"Geert Wilders (PVV)",0.659595156015204,0.120817490494297,0
"<anonymized_userid>",10,37320,1272,"Geert Wilders (PVV)",0.65977194378149,0.120912547528517,0
"<anonymized_userid>",10,37330,1273,"Geert Wilders (PVV)",0.659948731547777,0.121007604562738,0
"<anonymized_userid>",10,37340,1274,"Geert Wilders (PVV)",0.660125519314063,0.121102661596958,0
"<anonymized_userid>",10,37350,1275,"Geert Wilders (PVV)",0.66030230708035,0.121197718631179,0
"<anonymized_userid>",10,37360,1276,"Geert Wilders (PVV)",0.660479094846637,0.121292775665399,0
"<anonymized_userid>",10,37370,1277,"Geert Wilders (PVV)",0.660655882612923,0.12138783269962,0
"<anonymized_userid>",10,37380,1278,"Geert Wilders (PVV)",0.66083267037921,0.12148288973384,0
"<anonymized_userid>",10,37390,1279,"Geert Wilders (PVV)",0.661009458145496,0.121577946768061,0
"<anonymized_userid>",10,37400,1280,"Geert Wilders (PVV)",0.661186245911783,0.121673003802281,0
"<anonymized_userid>",10,37410,1281,"Geert Wilders (PVV)",0.661363033678069,0.121768060836502,0
"<anonymized_userid>",10,37420,1282,"Geert Wilders (PVV)",0.661539821444356,0.121863117870722,0
"<anonymized_userid>",10,37430,1283,"Geert Wilders (PVV)",0.661716609210643,0.121958174904943,0
"<anonymized_userid>",10,37440,1284,"Geert Wilders (PVV)",0.661893396976929,0.122053231939163,0
"<anonymized_userid>",10,37450,1285,"Geert Wilders (PVV)",0.662070184743216,0.122148288973384,0
"<anonymized_userid>",10,37460,1286,"Geert Wilders (PVV)",0.662246972509502,0.122243346007605,0
"<anonymized_userid>",10,37470,1287,"Geert Wilders (PVV)",0.662423760275789,0.122338403041825,0
"<anonymized_userid>",10,37480,1288,"Geert Wilders (PVV)",0.662600548042075,0.122433460076046,0
"<anonymized_userid>",10,37490,1289,"Geert Wilders (PVV)",0.662777335808362,0.122528517110266,0
"<anonymized_userid>",10,37500,1290,"Geert Wilders (PVV)",0.662954123574649,0.122623574144487,0
"<anonymized_userid>",10,37510,1291,"Geert Wilders (PVV)",0.663130911340935,0.122718631178707,0
"<anonymized_userid>",10,37520,1292,"Geert Wilders (PVV)",0.663307699107222,0.122813688212928,0
"<anonymized_userid>",10,37530,1293,"Geert Wilders (PVV)",0.663484486873508,0.122908745247148,0
"<anonymized_userid>",10,37540,1294,"Geert Wilders (PVV)",0.663661274639795,0.123003802281369,0
"<anonymized_userid>",10,37550,1295,"Geert Wilders (PVV)",0.663838062406081,0.123098859315589,0
"<anonymized_userid>",10,37560,1296,"Geert Wilders (PVV)",0.664014850172368,0.12319391634981,0
"<anonymized_userid>",9,37569,1297,"Geert Wilders (PVV)",0.664173959162026,0.12328897338403,0
"<anonymized_userid>",9,37578,1298,"Geert Wilders (PVV)",0.664333068151684,0.123384030418251,0
"<anonymized_userid>",9,37587,1299,"Geert Wilders (PVV)",0.664492177141342,0.123479087452471,0
"<anonymized_userid>",9,37596,1300,"Geert Wilders (PVV)",0.664651286131,0.123574144486692,0
"<anonymized_userid>",9,37605,1301,"Geert Wilders (PVV)",0.664810395120658,0.123669201520913,0
"<anonymized_userid>",9,37614,1302,"Geert Wilders (PVV)",0.664969504110316,0.123764258555133,0
"<anonymized_userid>",9,37623,1303,"Geert Wilders (PVV)",0.665128613099974,0.123859315589354,0
"<anonymized_userid>",9,37632,1304,"Geert Wilders (PVV)",0.665287722089631,0.123954372623574,0
"<anonymized_userid>",9,37641,1305,"Geert Wilders (PVV)",0.665446831079289,0.124049429657795,0
"<anonymized_userid>",9,37650,1306,"Geert Wilders (PVV)",0.665605940068947,0.124144486692015,0
"<anonymized_userid>",9,37659,1307,"Geert Wilders (PVV)",0.665765049058605,0.124239543726236,0
"<anonymized_userid>",9,37668,1308,"Geert Wilders (PVV)",0.665924158048263,0.124334600760456,0
"<anonymized_userid>",9,37677,1309,"Geert Wilders (PVV)",0.666083267037921,0.124429657794677,0
"<anonymized_userid>",9,37686,1310,"Geert Wilders (PVV)",0.666242376027579,0.124524714828897,0
"<anonymized_userid>",9,37695,1311,"Geert Wilders (PVV)",0.666401485017237,0.124619771863118,0
"<anonymized_userid>",9,37704,1312,"Geert Wilders (PVV)",0.666560594006895,0.124714828897338,0
"<anonymized_userid>",9,37713,1313,"Geert Wilders (PVV)",0.666719702996553,0.124809885931559,0
"<anonymized_userid>",9,37722,1314,"Geert Wilders (PVV)",0.666878811986211,0.124904942965779,0
"<anonymized_userid>",9,37731,1315,"Geert Wilders (PVV)",0.667037920975868,0.125,0
"<anonymized_userid>",9,37740,1316,"Geert Wilders (PVV)",0.667197029965526,0.125095057034221,0
"<anonymized_userid>",9,37749,1317,"Geert Wilders (PVV)",0.667356138955184,0.125190114068441,0
"<anonymized_userid>",9,37758,1318,"Geert Wilders (PVV)",0.667515247944842,0.125285171102662,0
"<anonymized_userid>",9,37767,1319,"Geert Wilders (PVV)",0.6676743569345,0.125380228136882,0
"<anonymized_userid>",9,37776,1320,"Geert Wilders (PVV)",0.667833465924158,0.125475285171103,0
"<anonymized_userid>",9,37785,1321,"Geert Wilders (PVV)",0.667992574913816,0.125570342205323,0
"<anonymized_userid>",9,37794,1322,"Geert Wilders (PVV)",0.668151683903474,0.125665399239544,0
"<anonymized_userid>",9,37803,1323,"Geert Wilders (PVV)",0.668310792893132,0.125760456273764,0
"<anonymized_userid>",9,37812,1324,"Geert Wilders (PVV)",0.66846990188279,0.125855513307985,0
"<anonymized_userid>",9,37821,1325,"Geert Wilders (PVV)",0.668629010872448,0.125950570342205,0
"<anonymized_userid>",9,37830,1326,"Geert Wilders (PVV)",0.668788119862106,0.126045627376426,0
"<anonymized_userid>",9,37839,1327,"Geert Wilders (PVV)",0.668947228851763,0.126140684410646,0
"<anonymized_userid>",9,37848,1328,"Geert Wilders (PVV)",0.669106337841421,0.126235741444867,0
"<anonymized_userid>",9,37857,1329,"Geert Wilders (PVV)",0.669265446831079,0.126330798479087,0
"<anonymized_userid>",9,37866,1330,"Geert Wilders (PVV)",0.669424555820737,0.126425855513308,0
"<anonymized_userid>",9,37875,1331,"Geert Wilders (PVV)",0.669583664810395,0.126520912547529,0
"<anonymized_userid>",9,37884,1332,"Geert Wilders (PVV)",0.669742773800053,0.126615969581749,0
"<anonymized_userid>",9,37893,1333,"Geert Wilders (PVV)",0.669901882789711,0.12671102661597,0
"<anonymized_userid>",9,37902,1334,"Geert Wilders (PVV)",0.670060991779369,0.12680608365019,0
"<anonymized_userid>",9,37911,1335,"Geert Wilders (PVV)",0.670220100769027,0.126901140684411,0
"<anonymized_userid>",9,37920,1336,"Geert Wilders (PVV)",0.670379209758685,0.126996197718631,0
"<anonymized_userid>",9,37929,1337,"Geert Wilders (PVV)",0.670538318748343,0.127091254752852,0
"<anonymized_userid>",9,37938,1338,"Geert Wilders (PVV)",0.670697427738001,0.127186311787072,0
"<anonymized_userid>",9,37947,1339,"Geert Wilders (PVV)",0.670856536727658,0.127281368821293,0
"<anonymized_userid>",9,37956,1340,"Geert Wilders (PVV)",0.671015645717316,0.127376425855513,0
"<anonymized_userid>",9,37965,1341,"Geert Wilders (PVV)",0.671174754706974,0.127471482889734,0
"<anonymized_userid>",9,37974,1342,"Geert Wilders (PVV)",0.671333863696632,0.127566539923954,0
"<anonymized_userid>",9,37983,1343,"Geert Wilders (PVV)",0.67149297268629,0.127661596958175,0
"<anonymized_userid>",9,37992,1344,"Geert Wilders (PVV)",0.671652081675948,0.127756653992395,0
"<anonymized_userid>",9,38001,1345,"Geert Wilders (PVV)",0.671811190665606,0.127851711026616,0
"<anonymized_userid>",9,38010,1346,"Geert Wilders (PVV)",0.671970299655264,0.127946768060836,0
"<anonymized_userid>",9,38019,1347,"Geert Wilders (PVV)",0.672129408644922,0.128041825095057,0
"<anonymized_userid>",9,38028,1348,"Geert Wilders (PVV)",0.67228851763458,0.128136882129278,0
"<anonymized_userid>",9,38037,1349,"Geert Wilders (PVV)",0.672447626624238,0.128231939163498,0
"<anonymized_userid>",9,38046,1350,"Geert Wilders (PVV)",0.672606735613896,0.128326996197719,0
"<anonymized_userid>",9,38055,1351,"Geert Wilders (PVV)",0.672765844603553,0.128422053231939,0
"<anonymized_userid>",9,38064,1352,"Geert Wilders (PVV)",0.672924953593211,0.12851711026616,0
"<anonymized_userid>",9,38073,1353,"Geert Wilders (PVV)",0.673084062582869,0.12861216730038,0
"<anonymized_userid>",9,38082,1354,"Geert Wilders (PVV)",0.673243171572527,0.128707224334601,0
"<anonymized_userid>",9,38091,1355,"Geert Wilders (PVV)",0.673402280562185,0.128802281368821,0
"<anonymized_userid>",9,38100,1356,"Geert Wilders (PVV)",0.673561389551843,0.128897338403042,0
"<anonymized_userid>",9,38109,1357,"Geert Wilders (PVV)",0.673720498541501,0.128992395437262,0
"<anonymized_userid>",9,38118,1358,"Geert Wilders (PVV)",0.673879607531159,0.129087452471483,0
"<anonymized_userid>",9,38127,1359,"Geert Wilders (PVV)",0.674038716520817,0.129182509505703,0
"<anonymized_userid>",9,38136,1360,"Geert Wilders (PVV)",0.674197825510475,0.129277566539924,0
"<anonymized_userid>",9,38145,1361,"Geert Wilders (PVV)",0.674356934500133,0.129372623574144,0
"<anonymized_userid>",9,38154,1362,"Geert Wilders (PVV)",0.674516043489791,0.129467680608365,0
"<anonymized_userid>",9,38163,1363,"Geert Wilders (PVV)",0.674675152479448,0.129562737642586,0
"<anonymized_userid>",9,38172,1364,"Geert Wilders (PVV)",0.674834261469106,0.129657794676806,0
"<anonymized_userid>",9,38181,1365,"Geert Wilders (PVV)",0.674993370458764,0.129752851711027,0
"<anonymized_userid>",9,38190,1366,"Geert Wilders (PVV)",0.675152479448422,0.129847908745247,0
"<anonymized_userid>",9,38199,1367,"Geert Wilders (PVV)",0.67531158843808,0.129942965779468,0
"<anonymized_userid>",9,38208,1368,"Geert Wilders (PVV)",0.675470697427738,0.130038022813688,0
"<anonymized_userid>",9,38217,1369,"Geert Wilders (PVV)",0.675629806417396,0.130133079847909,0
"<anonymized_userid>",9,38226,1370,"Geert Wilders (PVV)",0.675788915407054,0.130228136882129,0
"<anonymized_userid>",9,38235,1371,"Geert Wilders (PVV)",0.675948024396712,0.13032319391635,0
"<anonymized_userid>",9,38244,1372,"Geert Wilders (PVV)",0.67610713338637,0.13041825095057,0
"<anonymized_userid>",9,38253,1373,"Geert Wilders (PVV)",0.676266242376028,0.130513307984791,0
"<anonymized_userid>",9,38262,1374,"Geert Wilders (PVV)",0.676425351365685,0.130608365019011,0
"<anonymized_userid>",9,38271,1375,"Geert Wilders (PVV)",0.676584460355343,0.130703422053232,0
"<anonymized_userid>",9,38280,1376,"Geert Wilders (PVV)",0.676743569345001,0.130798479087452,0
"<anonymized_userid>",9,38289,1377,"Geert Wilders (PVV)",0.676902678334659,0.130893536121673,0
"<anonymized_userid>",9,38298,1378,"Geert Wilders (PVV)",0.677061787324317,0.130988593155894,0
"<anonymized_userid>",9,38307,1379,"Geert Wilders (PVV)",0.677220896313975,0.131083650190114,0
"<anonymized_userid>",9,38316,1380,"Geert Wilders (PVV)",0.677380005303633,0.131178707224335,0
"<anonymized_userid>",9,38325,1381,"Geert Wilders (PVV)",0.677539114293291,0.131273764258555,0
"<anonymized_userid>",9,38334,1382,"Geert Wilders (PVV)",0.677698223282949,0.131368821292776,0
"<anonymized_userid>",9,38343,1383,"Geert Wilders (PVV)",0.677857332272607,0.131463878326996,0
"<anonymized_userid>",9,38352,1384,"Geert Wilders (PVV)",0.678016441262265,0.131558935361217,0
"<anonymized_userid>",9,38361,1385,"Geert Wilders (PVV)",0.678175550251923,0.131653992395437,0
"<anonymized_userid>",9,38370,1386,"Geert Wilders (PVV)",0.67833465924158,0.131749049429658,0
"<anonymized_userid>",9,38379,1387,"Geert Wilders (PVV)",0.678493768231238,0.131844106463878,0
"<anonymized_userid>",9,38388,1388,"Geert Wilders (PVV)",0.678652877220896,0.131939163498099,0
"<anonymized_userid>",9,38397,1389,"Geert Wilders (PVV)",0.678811986210554,0.132034220532319,0
"<anonymized_userid>",9,38406,1390,"Geert Wilders (PVV)",0.678971095200212,0.13212927756654,0
"<anonymized_userid>",9,38415,1391,"Geert Wilders (PVV)",0.67913020418987,0.13222433460076,0
"<anonymized_userid>",9,38424,1392,"Geert Wilders (PVV)",0.679289313179528,0.132319391634981,0
"<anonymized_userid>",9,38433,1393,"Geert Wilders (PVV)",0.679448422169186,0.132414448669202,0
"<anonymized_userid>",9,38442,1394,"Geert Wilders (PVV)",0.679607531158844,0.132509505703422,0
"<anonymized_userid>",9,38451,1395,"Geert Wilders (PVV)",0.679766640148502,0.132604562737643,0
"<anonymized_userid>",9,38460,1396,"Geert Wilders (PVV)",0.67992574913816,0.132699619771863,0
"<anonymized_userid>",9,38469,1397,"Geert Wilders (PVV)",0.680084858127818,0.132794676806084,0
"<anonymized_userid>",9,38478,1398,"Geert Wilders (PVV)",0.680243967117475,0.132889733840304,0
"<anonymized_userid>",9,38487,1399,"Geert Wilders (PVV)",0.680403076107133,0.132984790874525,0
"<anonymized_userid>",9,38496,1400,"Geert Wilders (PVV)",0.680562185096791,0.133079847908745,0
"<anonymized_userid>",8,38504,1401,"Geert Wilders (PVV)",0.680703615309821,0.133174904942966,0
"<anonymized_userid>",8,38512,1402,"Geert Wilders (PVV)",0.68084504552285,0.133269961977186,0
"<anonymized_userid>",8,38520,1403,"Geert Wilders (PVV)",0.680986475735879,0.133365019011407,0
"<anonymized_userid>",8,38528,1404,"Geert Wilders (PVV)",0.681127905948908,0.133460076045627,0
"<anonymized_userid>",8,38536,1405,"Geert Wilders (PVV)",0.681269336161938,0.133555133079848,0
"<anonymized_userid>",8,38544,1406,"Geert Wilders (PVV)",0.681410766374967,0.133650190114068,0
"<anonymized_userid>",8,38552,1407,"Geert Wilders (PVV)",0.681552196587996,0.133745247148289,0
"<anonymized_userid>",8,38560,1408,"Geert Wilders (PVV)",0.681693626801025,0.13384030418251,0
"<anonymized_userid>",8,38568,1409,"Geert Wilders (PVV)",0.681835057014055,0.13393536121673,0
"<anonymized_userid>",8,38576,1410,"Geert Wilders (PVV)",0.681976487227084,0.134030418250951,0
"<anonymized_userid>",8,38584,1411,"Geert Wilders (PVV)",0.682117917440113,0.134125475285171,0
"<anonymized_userid>",8,38592,1412,"Geert Wilders (PVV)",0.682259347653142,0.134220532319392,0
"<anonymized_userid>",8,38600,1413,"Geert Wilders (PVV)",0.682400777866172,0.134315589353612,0
"<anonymized_userid>",8,38608,1414,"Geert Wilders (PVV)",0.682542208079201,0.134410646387833,0
"<anonymized_userid>",8,38616,1415,"Geert Wilders (PVV)",0.68268363829223,0.134505703422053,0
"<anonymized_userid>",8,38624,1416,"Geert Wilders (PVV)",0.682825068505259,0.134600760456274,0
"<anonymized_userid>",8,38632,1417,"Geert Wilders (PVV)",0.682966498718289,0.134695817490494,0
"<anonymized_userid>",8,38640,1418,"Geert Wilders (PVV)",0.683107928931318,0.134790874524715,0
"<anonymized_userid>",8,38648,1419,"Geert Wilders (PVV)",0.683249359144347,0.134885931558935,0
"<anonymized_userid>",8,38656,1420,"Geert Wilders (PVV)",0.683390789357377,0.134980988593156,0
"<anonymized_userid>",8,38664,1421,"Geert Wilders (PVV)",0.683532219570406,0.135076045627376,0
"<anonymized_userid>",8,38672,1422,"Geert Wilders (PVV)",0.683673649783435,0.135171102661597,0
"<anonymized_userid>",8,38680,1423,"Geert Wilders (PVV)",0.683815079996464,0.135266159695817,0
"<anonymized_userid>",8,38688,1424,"Geert Wilders (PVV)",0.683956510209494,0.135361216730038,0
"<anonymized_userid>",8,38696,1425,"Geert Wilders (PVV)",0.684097940422523,0.135456273764259,0
"<anonymized_userid>",8,38704,1426,"Geert Wilders (PVV)",0.684239370635552,0.135551330798479,0
"<anonymized_userid>",8,38712,1427,"Geert Wilders (PVV)",0.684380800848581,0.1356463878327,0
"<anonymized_userid>",8,38720,1428,"Geert Wilders (PVV)",0.684522231061611,0.13574144486692,0
"<anonymized_userid>",8,38728,1429,"Geert Wilders (PVV)",0.68466366127464,0.135836501901141,0
"<anonymized_userid>",8,38736,1430,"Geert Wilders (PVV)",0.684805091487669,0.135931558935361,0
"<anonymized_userid>",8,38744,1431,"Geert Wilders (PVV)",0.684946521700698,0.136026615969582,0
"<anonymized_userid>",8,38752,1432,"Geert Wilders (PVV)",0.685087951913728,0.136121673003802,0
"<anonymized_userid>",8,38760,1433,"Geert Wilders (PVV)",0.685229382126757,0.136216730038023,0
"<anonymized_userid>",8,38768,1434,"Geert Wilders (PVV)",0.685370812339786,0.136311787072243,0
"<anonymized_userid>",8,38776,1435,"Geert Wilders (PVV)",0.685512242552815,0.136406844106464,0
"<anonymized_userid>",8,38784,1436,"Geert Wilders (PVV)",0.685653672765845,0.136501901140684,0
"<anonymized_userid>",8,38792,1437,"Geert Wilders (PVV)",0.685795102978874,0.136596958174905,0
"<anonymized_userid>",8,38800,1438,"Geert Wilders (PVV)",0.685936533191903,0.136692015209125,0
"<anonymized_userid>",8,38808,1439,"Geert Wilders (PVV)",0.686077963404932,0.136787072243346,0
"<anonymized_userid>",8,38816,1440,"Geert Wilders (PVV)",0.686219393617962,0.136882129277567,0
"<anonymized_userid>",8,38824,1441,"Geert Wilders (PVV)",0.686360823830991,0.136977186311787,0
"<anonymized_userid>",8,38832,1442,"Geert Wilders (PVV)",0.68650225404402,0.137072243346008,0
"<anonymized_userid>",8,38840,1443,"Geert Wilders (PVV)",0.686643684257049,0.137167300380228,0
"<anonymized_userid>",8,38848,1444,"Geert Wilders (PVV)",0.686785114470079,0.137262357414449,0
"<anonymized_userid>",8,38856,1445,"Geert Wilders (PVV)",0.686926544683108,0.137357414448669,0
"<anonymized_userid>",8,38864,1446,"Geert Wilders (PVV)",0.687067974896137,0.13745247148289,0
"<anonymized_userid>",8,38872,1447,"Geert Wilders (PVV)",0.687209405109166,0.13754752851711,0
"<anonymized_userid>",8,38880,1448,"Geert Wilders (PVV)",0.687350835322196,0.137642585551331,0
"<anonymized_userid>",8,38888,1449,"Geert Wilders (PVV)",0.687492265535225,0.137737642585551,0
"<anonymized_userid>",8,38896,1450,"Geert Wilders (PVV)",0.687633695748254,0.137832699619772,0
"<anonymized_userid>",8,38904,1451,"Geert Wilders (PVV)",0.687775125961283,0.137927756653992,0
"<anonymized_userid>",8,38912,1452,"Geert Wilders (PVV)",0.687916556174313,0.138022813688213,0
"<anonymized_userid>",8,38920,1453,"Geert Wilders (PVV)",0.688057986387342,0.138117870722433,0
"<anonymized_userid>",8,38928,1454,"Geert Wilders (PVV)",0.688199416600371,0.138212927756654,0
"<anonymized_userid>",8,38936,1455,"Geert Wilders (PVV)",0.6883408468134,0.138307984790875,0
"<anonymized_userid>",8,38944,1456,"Geert Wilders (PVV)",0.68848227702643,0.138403041825095,0
"<anonymized_userid>",8,38952,1457,"Geert Wilders (PVV)",0.688623707239459,0.138498098859316,0
"<anonymized_userid>",8,38960,1458,"Geert Wilders (PVV)",0.688765137452488,0.138593155893536,0
"<anonymized_userid>",8,38968,1459,"Geert Wilders (PVV)",0.688906567665517,0.138688212927757,0
"<anonymized_userid>",8,38976,1460,"Geert Wilders (PVV)",0.689047997878547,0.138783269961977,0
"<anonymized_userid>",8,38984,1461,"Geert Wilders (PVV)",0.689189428091576,0.138878326996198,0
"<anonymized_userid>",8,38992,1462,"Geert Wilders (PVV)",0.689330858304605,0.138973384030418,0
"<anonymized_userid>",8,39000,1463,"Geert Wilders (PVV)",0.689472288517635,0.139068441064639,0
"<anonymized_userid>",8,39008,1464,"Geert Wilders (PVV)",0.689613718730664,0.139163498098859,0
"<anonymized_userid>",8,39016,1465,"Geert Wilders (PVV)",0.689755148943693,0.13925855513308,0
"<anonymized_userid>",8,39024,1466,"Geert Wilders (PVV)",0.689896579156722,0.1393536121673,0
"<anonymized_userid>",8,39032,1467,"Geert Wilders (PVV)",0.690038009369752,0.139448669201521,0
"<anonymized_userid>",8,39040,1468,"Geert Wilders (PVV)",0.690179439582781,0.139543726235741,0
"<anonymized_userid>",8,39048,1469,"Geert Wilders (PVV)",0.69032086979581,0.139638783269962,0
"<anonymized_userid>",8,39056,1470,"Geert Wilders (PVV)",0.690462300008839,0.139733840304183,0
"<anonymized_userid>",8,39064,1471,"Geert Wilders (PVV)",0.690603730221869,0.139828897338403,0
"<anonymized_userid>",8,39072,1472,"Geert Wilders (PVV)",0.690745160434898,0.139923954372624,0
"<anonymized_userid>",8,39080,1473,"Geert Wilders (PVV)",0.690886590647927,0.140019011406844,0
"<anonymized_userid>",8,39088,1474,"Geert Wilders (PVV)",0.691028020860956,0.140114068441065,0
"<anonymized_userid>",8,39096,1475,"Geert Wilders (PVV)",0.691169451073986,0.140209125475285,0
"<anonymized_userid>",8,39104,1476,"Geert Wilders (PVV)",0.691310881287015,0.140304182509506,0
"<anonymized_userid>",8,39112,1477,"Geert Wilders (PVV)",0.691452311500044,0.140399239543726,0
"<anonymized_userid>",8,39120,1478,"Geert Wilders (PVV)",0.691593741713073,0.140494296577947,0
"<anonymized_userid>",8,39128,1479,"Geert Wilders (PVV)",0.691735171926103,0.140589353612167,0
"<anonymized_userid>",8,39136,1480,"Geert Wilders (PVV)",0.691876602139132,0.140684410646388,0
"<anonymized_userid>",8,39144,1481,"Geert Wilders (PVV)",0.692018032352161,0.140779467680608,0
"<anonymized_userid>",8,39152,1482,"Geert Wilders (PVV)",0.69215946256519,0.140874524714829,0
"<anonymized_userid>",8,39160,1483,"Geert Wilders (PVV)",0.69230089277822,0.140969581749049,0
"<anonymized_userid>",8,39168,1484,"Geert Wilders (PVV)",0.692442322991249,0.14106463878327,0
"<anonymized_userid>",8,39176,1485,"Geert Wilders (PVV)",0.692583753204278,0.14115969581749,0
"<anonymized_userid>",8,39184,1486,"Geert Wilders (PVV)",0.692725183417307,0.141254752851711,0
"<anonymized_userid>",8,39192,1487,"Geert Wilders (PVV)",0.692866613630337,0.141349809885932,0
"<anonymized_userid>",8,39200,1488,"Geert Wilders (PVV)",0.693008043843366,0.141444866920152,0
"<anonymized_userid>",8,39208,1489,"Geert Wilders (PVV)",0.693149474056395,0.141539923954373,0
"<anonymized_userid>",8,39216,1490,"Geert Wilders (PVV)",0.693290904269425,0.141634980988593,0
"<anonymized_userid>",8,39224,1491,"Geert Wilders (PVV)",0.693432334482454,0.141730038022814,0
"<anonymized_userid>",8,39232,1492,"Geert Wilders (PVV)",0.693573764695483,0.141825095057034,0
"<anonymized_userid>",8,39240,1493,"Geert Wilders (PVV)",0.693715194908512,0.141920152091255,0
"<anonymized_userid>",8,39248,1494,"Geert Wilders (PVV)",0.693856625121542,0.142015209125475,0
"<anonymized_userid>",8,39256,1495,"Geert Wilders (PVV)",0.693998055334571,0.142110266159696,0
"<anonymized_userid>",8,39264,1496,"Geert Wilders (PVV)",0.6941394855476,0.142205323193916,0
"<anonymized_userid>",8,39272,1497,"Geert Wilders (PVV)",0.694280915760629,0.142300380228137,0
"<anonymized_userid>",8,39280,1498,"Geert Wilders (PVV)",0.694422345973659,0.142395437262357,0
"<anonymized_userid>",8,39288,1499,"Geert Wilders (PVV)",0.694563776186688,0.142490494296578,0
"<anonymized_userid>",8,39296,1500,"Geert Wilders (PVV)",0.694705206399717,0.142585551330798,0
"<anonymized_userid>",8,39304,1501,"Geert Wilders (PVV)",0.694846636612746,0.142680608365019,0
"<anonymized_userid>",8,39312,1502,"Geert Wilders (PVV)",0.694988066825776,0.14277566539924,0
"<anonymized_userid>",8,39320,1503,"Geert Wilders (PVV)",0.695129497038805,0.14287072243346,0
"<anonymized_userid>",8,39328,1504,"Geert Wilders (PVV)",0.695270927251834,0.142965779467681,0
"<anonymized_userid>",8,39336,1505,"Geert Wilders (PVV)",0.695412357464863,0.143060836501901,0
"<anonymized_userid>",8,39344,1506,"Geert Wilders (PVV)",0.695553787677893,0.143155893536122,0
"<anonymized_userid>",8,39352,1507,"Geert Wilders (PVV)",0.695695217890922,0.143250950570342,0
"<anonymized_userid>",8,39360,1508,"Geert Wilders (PVV)",0.695836648103951,0.143346007604563,0
"<anonymized_userid>",8,39368,1509,"Geert Wilders (PVV)",0.69597807831698,0.143441064638783,0
"<anonymized_userid>",8,39376,1510,"Geert Wilders (PVV)",0.69611950853001,0.143536121673004,0
"<anonymized_userid>",8,39384,1511,"Geert Wilders (PVV)",0.696260938743039,0.143631178707224,0
"<anonymized_userid>",8,39392,1512,"Geert Wilders (PVV)",0.696402368956068,0.143726235741445,0
"<anonymized_userid>",8,39400,1513,"Geert Wilders (PVV)",0.696543799169097,0.143821292775665,0
"<anonymized_userid>",8,39408,1514,"Geert Wilders (PVV)",0.696685229382127,0.143916349809886,0
"<anonymized_userid>",8,39416,1515,"Geert Wilders (PVV)",0.696826659595156,0.144011406844106,0
"<anonymized_userid>",8,39424,1516,"Geert Wilders (PVV)",0.696968089808185,0.144106463878327,0
"<anonymized_userid>",8,39432,1517,"Geert Wilders (PVV)",0.697109520021215,0.144201520912548,0
"<anonymized_userid>",8,39440,1518,"Geert Wilders (PVV)",0.697250950234244,0.144296577946768,0
"<anonymized_userid>",8,39448,1519,"Geert Wilders (PVV)",0.697392380447273,0.144391634980989,0
"<anonymized_userid>",8,39456,1520,"Geert Wilders (PVV)",0.697533810660302,0.144486692015209,0
"<anonymized_userid>",8,39464,1521,"Geert Wilders (PVV)",0.697675240873332,0.14458174904943,0
"<anonymized_userid>",8,39472,1522,"Geert Wilders (PVV)",0.697816671086361,0.14467680608365,0
"<anonymized_userid>",8,39480,1523,"Geert Wilders (PVV)",0.69795810129939,0.144771863117871,0
"<anonymized_userid>",8,39488,1524,"Geert Wilders (PVV)",0.698099531512419,0.144866920152091,0
"<anonymized_userid>",8,39496,1525,"Geert Wilders (PVV)",0.698240961725449,0.144961977186312,0
"<anonymized_userid>",8,39504,1526,"Geert Wilders (PVV)",0.698382391938478,0.145057034220532,0
"<anonymized_userid>",8,39512,1527,"Geert Wilders (PVV)",0.698523822151507,0.145152091254753,0
"<anonymized_userid>",8,39520,1528,"Geert Wilders (PVV)",0.698665252364536,0.145247148288973,0
"<anonymized_userid>",8,39528,1529,"Geert Wilders (PVV)",0.698806682577566,0.145342205323194,0
"<anonymized_userid>",8,39536,1530,"Geert Wilders (PVV)",0.698948112790595,0.145437262357414,0
"<anonymized_userid>",8,39544,1531,"Geert Wilders (PVV)",0.699089543003624,0.145532319391635,0
"<anonymized_userid>",8,39552,1532,"Geert Wilders (PVV)",0.699230973216653,0.145627376425856,0
"<anonymized_userid>",8,39560,1533,"Geert Wilders (PVV)",0.699372403429683,0.145722433460076,0
"<anonymized_userid>",8,39568,1534,"Geert Wilders (PVV)",0.699513833642712,0.145817490494297,0
"<anonymized_userid>",8,39576,1535,"Geert Wilders (PVV)",0.699655263855741,0.145912547528517,0
"<anonymized_userid>",8,39584,1536,"Geert Wilders (PVV)",0.69979669406877,0.146007604562738,0
"<anonymized_userid>",8,39592,1537,"Geert Wilders (PVV)",0.6999381242818,0.146102661596958,0
"<anonymized_userid>",8,39600,1538,"Geert Wilders (PVV)",0.700079554494829,0.146197718631179,0
"<anonymized_userid>",8,39608,1539,"Geert Wilders (PVV)",0.700220984707858,0.146292775665399,0
"<anonymized_userid>",8,39616,1540,"Geert Wilders (PVV)",0.700362414920887,0.14638783269962,0
"<anonymized_userid>",8,39624,1541,"Geert Wilders (PVV)",0.700503845133917,0.14648288973384,0
"<anonymized_userid>",8,39632,1542,"Geert Wilders (PVV)",0.700645275346946,0.146577946768061,0
"<anonymized_userid>",8,39640,1543,"Geert Wilders (PVV)",0.700786705559975,0.146673003802281,0
"<anonymized_userid>",8,39648,1544,"Geert Wilders (PVV)",0.700928135773005,0.146768060836502,0
"<anonymized_userid>",8,39656,1545,"Geert Wilders (PVV)",0.701069565986034,0.146863117870722,0
"<anonymized_userid>",8,39664,1546,"Geert Wilders (PVV)",0.701210996199063,0.146958174904943,0
"<anonymized_userid>",8,39672,1547,"Geert Wilders (PVV)",0.701352426412092,0.147053231939164,0
"<anonymized_userid>",8,39680,1548,"Geert Wilders (PVV)",0.701493856625122,0.147148288973384,0
"<anonymized_userid>",8,39688,1549,"Geert Wilders (PVV)",0.701635286838151,0.147243346007605,0
"<anonymized_userid>",8,39696,1550,"Geert Wilders (PVV)",0.70177671705118,0.147338403041825,0
"<anonymized_userid>",8,39704,1551,"Geert Wilders (PVV)",0.701918147264209,0.147433460076046,0
"<anonymized_userid>",8,39712,1552,"Geert Wilders (PVV)",0.702059577477239,0.147528517110266,0
"<anonymized_userid>",8,39720,1553,"Geert Wilders (PVV)",0.702201007690268,0.147623574144487,0
"<anonymized_userid>",8,39728,1554,"Geert Wilders (PVV)",0.702342437903297,0.147718631178707,0
"<anonymized_userid>",8,39736,1555,"Geert Wilders (PVV)",0.702483868116326,0.147813688212928,0
"<anonymized_userid>",8,39744,1556,"Geert Wilders (PVV)",0.702625298329356,0.147908745247148,0
"<anonymized_userid>",8,39752,1557,"Geert Wilders (PVV)",0.702766728542385,0.148003802281369,0
"<anonymized_userid>",8,39760,1558,"Geert Wilders (PVV)",0.702908158755414,0.148098859315589,0
"<anonymized_userid>",8,39768,1559,"Geert Wilders (PVV)",0.703049588968443,0.14819391634981,0
"<anonymized_userid>",8,39776,1560,"Geert Wilders (PVV)",0.703191019181473,0.14828897338403,0
"<anonymized_userid>",7,39783,1561,"Geert Wilders (PVV)",0.703314770617873,0.148384030418251,0
"<anonymized_userid>",7,39790,1562,"Geert Wilders (PVV)",0.703438522054274,0.148479087452471,0
"<anonymized_userid>",7,39797,1563,"Geert Wilders (PVV)",0.703562273490674,0.148574144486692,0
"<anonymized_userid>",7,39804,1564,"Geert Wilders (PVV)",0.703686024927075,0.148669201520913,0
"<anonymized_userid>",7,39811,1565,"Geert Wilders (PVV)",0.703809776363476,0.148764258555133,0
"<anonymized_userid>",7,39818,1566,"Geert Wilders (PVV)",0.703933527799876,0.148859315589354,0
"<anonymized_userid>",7,39825,1567,"Geert Wilders (PVV)",0.704057279236277,0.148954372623574,0
"<anonymized_userid>",7,39832,1568,"Geert Wilders (PVV)",0.704181030672677,0.149049429657795,0
"<anonymized_userid>",7,39839,1569,"Geert Wilders (PVV)",0.704304782109078,0.149144486692015,0
"<anonymized_userid>",7,39846,1570,"Geert Wilders (PVV)",0.704428533545479,0.149239543726236,0
"<anonymized_userid>",7,39853,1571,"Geert Wilders (PVV)",0.704552284981879,0.149334600760456,0
"<anonymized_userid>",7,39860,1572,"Geert Wilders (PVV)",0.70467603641828,0.149429657794677,0
"<anonymized_userid>",7,39867,1573,"Geert Wilders (PVV)",0.70479978785468,0.149524714828897,0
"<anonymized_userid>",7,39874,1574,"Geert Wilders (PVV)",0.704923539291081,0.149619771863118,0
"<anonymized_userid>",7,39881,1575,"Geert Wilders (PVV)",0.705047290727482,0.149714828897338,0
"<anonymized_userid>",7,39888,1576,"Geert Wilders (PVV)",0.705171042163882,0.149809885931559,0
"<anonymized_userid>",7,39895,1577,"Geert Wilders (PVV)",0.705294793600283,0.149904942965779,0
"<anonymized_userid>",7,39902,1578,"Geert Wilders (PVV)",0.705418545036683,0.15,0
"<anonymized_userid>",7,39909,1579,"Geert Wilders (PVV)",0.705542296473084,0.150095057034221,0
"<anonymized_userid>",7,39916,1580,"Geert Wilders (PVV)",0.705666047909485,0.150190114068441,0
"<anonymized_userid>",7,39923,1581,"Geert Wilders (PVV)",0.705789799345885,0.150285171102662,0
"<anonymized_userid>",7,39930,1582,"Geert Wilders (PVV)",0.705913550782286,0.150380228136882,0
"<anonymized_userid>",7,39937,1583,"Geert Wilders (PVV)",0.706037302218686,0.150475285171103,0
"<anonymized_userid>",7,39944,1584,"Geert Wilders (PVV)",0.706161053655087,0.150570342205323,0
"<anonymized_userid>",7,39951,1585,"Geert Wilders (PVV)",0.706284805091488,0.150665399239544,0
"<anonymized_userid>",7,39958,1586,"Geert Wilders (PVV)",0.706408556527888,0.150760456273764,0
"<anonymized_userid>",7,39965,1587,"Geert Wilders (PVV)",0.706532307964289,0.150855513307985,0
"<anonymized_userid>",7,39972,1588,"Geert Wilders (PVV)",0.706656059400689,0.150950570342205,0
"<anonymized_userid>",7,39979,1589,"Geert Wilders (PVV)",0.70677981083709,0.151045627376426,0
"<anonymized_userid>",7,39986,1590,"Geert Wilders (PVV)",0.706903562273491,0.151140684410646,0
"<anonymized_userid>",7,39993,1591,"Geert Wilders (PVV)",0.707027313709891,0.151235741444867,0
"<anonymized_userid>",7,40000,1592,"Geert Wilders (PVV)",0.707151065146292,0.151330798479087,0
"<anonymized_userid>",7,40007,1593,"Geert Wilders (PVV)",0.707274816582692,0.151425855513308,0
"<anonymized_userid>",7,40014,1594,"Geert Wilders (PVV)",0.707398568019093,0.151520912547529,0
"<anonymized_userid>",7,40021,1595,"Geert Wilders (PVV)",0.707522319455494,0.151615969581749,0
"<anonymized_userid>",7,40028,1596,"Geert Wilders (PVV)",0.707646070891894,0.15171102661597,0
"<anonymized_userid>",7,40035,1597,"Geert Wilders (PVV)",0.707769822328295,0.15180608365019,0
"<anonymized_userid>",7,40042,1598,"Geert Wilders (PVV)",0.707893573764696,0.151901140684411,0
"<anonymized_userid>",7,40049,1599,"Geert Wilders (PVV)",0.708017325201096,0.151996197718631,0
"<anonymized_userid>",7,40056,1600,"Geert Wilders (PVV)",0.708141076637497,0.152091254752852,0
"<anonymized_userid>",7,40063,1601,"Geert Wilders (PVV)",0.708264828073897,0.152186311787072,0
"<anonymized_userid>",7,40070,1602,"Geert Wilders (PVV)",0.708388579510298,0.152281368821293,0
"<anonymized_userid>",7,40077,1603,"Geert Wilders (PVV)",0.708512330946699,0.152376425855513,0
"<anonymized_userid>",7,40084,1604,"Geert Wilders (PVV)",0.708636082383099,0.152471482889734,0
"<anonymized_userid>",7,40091,1605,"Geert Wilders (PVV)",0.7087598338195,0.152566539923954,0
"<anonymized_userid>",7,40098,1606,"Geert Wilders (PVV)",0.7088835852559,0.152661596958175,0
"<anonymized_userid>",7,40105,1607,"Geert Wilders (PVV)",0.709007336692301,0.152756653992395,0
"<anonymized_userid>",7,40112,1608,"Geert Wilders (PVV)",0.709131088128702,0.152851711026616,0
"<anonymized_userid>",7,40119,1609,"Geert Wilders (PVV)",0.709254839565102,0.152946768060837,0
"<anonymized_userid>",7,40126,1610,"Geert Wilders (PVV)",0.709378591001503,0.153041825095057,0
"<anonymized_userid>",7,40133,1611,"Geert Wilders (PVV)",0.709502342437903,0.153136882129278,0
"<anonymized_userid>",7,40140,1612,"Geert Wilders (PVV)",0.709626093874304,0.153231939163498,0
"<anonymized_userid>",7,40147,1613,"Geert Wilders (PVV)",0.709749845310705,0.153326996197719,0
"<anonymized_userid>",7,40154,1614,"Geert Wilders (PVV)",0.709873596747105,0.153422053231939,0
"<anonymized_userid>",7,40161,1615,"Geert Wilders (PVV)",0.709997348183506,0.15351711026616,0
"<anonymized_userid>",7,40168,1616,"Geert Wilders (PVV)",0.710121099619906,0.15361216730038,0
"<anonymized_userid>",7,40175,1617,"Geert Wilders (PVV)",0.710244851056307,0.153707224334601,0
"<anonymized_userid>",7,40182,1618,"Geert Wilders (PVV)",0.710368602492708,0.153802281368821,0
"<anonymized_userid>",7,40189,1619,"Geert Wilders (PVV)",0.710492353929108,0.153897338403042,0
"<anonymized_userid>",7,40196,1620,"Geert Wilders (PVV)",0.710616105365509,0.153992395437262,0
"<anonymized_userid>",7,40203,1621,"Geert Wilders (PVV)",0.710739856801909,0.154087452471483,0
"<anonymized_userid>",7,40210,1622,"Geert Wilders (PVV)",0.71086360823831,0.154182509505703,0
"<anonymized_userid>",7,40217,1623,"Geert Wilders (PVV)",0.71098735967471,0.154277566539924,0
"<anonymized_userid>",7,40224,1624,"Geert Wilders (PVV)",0.711111111111111,0.154372623574144,0
"<anonymized_userid>",7,40231,1625,"Geert Wilders (PVV)",0.711234862547512,0.154467680608365,0
"<anonymized_userid>",7,40238,1626,"Geert Wilders (PVV)",0.711358613983912,0.154562737642586,0
"<anonymized_userid>",7,40245,1627,"Geert Wilders (PVV)",0.711482365420313,0.154657794676806,0
"<anonymized_userid>",7,40252,1628,"Geert Wilders (PVV)",0.711606116856713,0.154752851711027,0
"<anonymized_userid>",7,40259,1629,"Geert Wilders (PVV)",0.711729868293114,0.154847908745247,0
"<anonymized_userid>",7,40266,1630,"Geert Wilders (PVV)",0.711853619729515,0.154942965779468,0
"<anonymized_userid>",7,40273,1631,"Geert Wilders (PVV)",0.711977371165915,0.155038022813688,0
"<anonymized_userid>",7,40280,1632,"Geert Wilders (PVV)",0.712101122602316,0.155133079847909,0
"<anonymized_userid>",7,40287,1633,"Geert Wilders (PVV)",0.712224874038716,0.155228136882129,0
"<anonymized_userid>",7,40294,1634,"Geert Wilders (PVV)",0.712348625475117,0.15532319391635,0
"<anonymized_userid>",7,40301,1635,"Geert Wilders (PVV)",0.712472376911518,0.15541825095057,0
"<anonymized_userid>",7,40308,1636,"Geert Wilders (PVV)",0.712596128347918,0.155513307984791,0
"<anonymized_userid>",7,40315,1637,"Geert Wilders (PVV)",0.712719879784319,0.155608365019011,0
"<anonymized_userid>",7,40322,1638,"Geert Wilders (PVV)",0.712843631220719,0.155703422053232,0
"<anonymized_userid>",7,40329,1639,"Geert Wilders (PVV)",0.71296738265712,0.155798479087452,0
"<anonymized_userid>",7,40336,1640,"Geert Wilders (PVV)",0.713091134093521,0.155893536121673,0
"<anonymized_userid>",7,40343,1641,"Geert Wilders (PVV)",0.713214885529921,0.155988593155894,0
"<anonymized_userid>",7,40350,1642,"Geert Wilders (PVV)",0.713338636966322,0.156083650190114,0
"<anonymized_userid>",7,40357,1643,"Geert Wilders (PVV)",0.713462388402723,0.156178707224335,0
"<anonymized_userid>",7,40364,1644,"Geert Wilders (PVV)",0.713586139839123,0.156273764258555,0
"<anonymized_userid>",7,40371,1645,"Geert Wilders (PVV)",0.713709891275524,0.156368821292776,0
"<anonymized_userid>",7,40378,1646,"Geert Wilders (PVV)",0.713833642711924,0.156463878326996,0
"<anonymized_userid>",7,40385,1647,"Geert Wilders (PVV)",0.713957394148325,0.156558935361217,0
"<anonymized_userid>",7,40392,1648,"Geert Wilders (PVV)",0.714081145584726,0.156653992395437,0
"<anonymized_userid>",7,40399,1649,"Geert Wilders (PVV)",0.714204897021126,0.156749049429658,0
"<anonymized_userid>",7,40406,1650,"Geert Wilders (PVV)",0.714328648457527,0.156844106463878,0
"<anonymized_userid>",7,40413,1651,"Geert Wilders (PVV)",0.714452399893927,0.156939163498099,0
"<anonymized_userid>",7,40420,1652,"Geert Wilders (PVV)",0.714576151330328,0.157034220532319,0
"<anonymized_userid>",7,40427,1653,"Geert Wilders (PVV)",0.714699902766729,0.15712927756654,0
"<anonymized_userid>",7,40434,1654,"Geert Wilders (PVV)",0.714823654203129,0.15722433460076,0
"<anonymized_userid>",7,40441,1655,"Geert Wilders (PVV)",0.71494740563953,0.157319391634981,0
"<anonymized_userid>",7,40448,1656,"Geert Wilders (PVV)",0.71507115707593,0.157414448669202,0
"<anonymized_userid>",7,40455,1657,"Geert Wilders (PVV)",0.715194908512331,0.157509505703422,0
"<anonymized_userid>",7,40462,1658,"Geert Wilders (PVV)",0.715318659948732,0.157604562737643,0
"<anonymized_userid>",7,40469,1659,"Geert Wilders (PVV)",0.715442411385132,0.157699619771863,0
"<anonymized_userid>",7,40476,1660,"Geert Wilders (PVV)",0.715566162821533,0.157794676806084,0
"<anonymized_userid>",7,40483,1661,"Geert Wilders (PVV)",0.715689914257933,0.157889733840304,0
"<anonymized_userid>",7,40490,1662,"Geert Wilders (PVV)",0.715813665694334,0.157984790874525,0
"<anonymized_userid>",7,40497,1663,"Geert Wilders (PVV)",0.715937417130735,0.158079847908745,0
"<anonymized_userid>",7,40504,1664,"Geert Wilders (PVV)",0.716061168567135,0.158174904942966,0
"<anonymized_userid>",7,40511,1665,"Geert Wilders (PVV)",0.716184920003536,0.158269961977186,0
"<anonymized_userid>",7,40518,1666,"Geert Wilders (PVV)",0.716308671439936,0.158365019011407,0
"<anonymized_userid>",7,40525,1667,"Geert Wilders (PVV)",0.716432422876337,0.158460076045627,0
"<anonymized_userid>",7,40532,1668,"Geert Wilders (PVV)",0.716556174312738,0.158555133079848,0
"<anonymized_userid>",7,40539,1669,"Geert Wilders (PVV)",0.716679925749138,0.158650190114068,0
"<anonymized_userid>",7,40546,1670,"Geert Wilders (PVV)",0.716803677185539,0.158745247148289,0
"<anonymized_userid>",7,40553,1671,"Geert Wilders (PVV)",0.716927428621939,0.158840304182509,0
"<anonymized_userid>",7,40560,1672,"Geert Wilders (PVV)",0.71705118005834,0.15893536121673,0
"<anonymized_userid>",7,40567,1673,"Geert Wilders (PVV)",0.717174931494741,0.159030418250951,0
"<anonymized_userid>",7,40574,1674,"Geert Wilders (PVV)",0.717298682931141,0.159125475285171,0
"<anonymized_userid>",7,40581,1675,"Geert Wilders (PVV)",0.717422434367542,0.159220532319392,0
"<anonymized_userid>",7,40588,1676,"Geert Wilders (PVV)",0.717546185803942,0.159315589353612,0
"<anonymized_userid>",7,40595,1677,"Geert Wilders (PVV)",0.717669937240343,0.159410646387833,0
"<anonymized_userid>",7,40602,1678,"Geert Wilders (PVV)",0.717793688676744,0.159505703422053,0
"<anonymized_userid>",7,40609,1679,"Geert Wilders (PVV)",0.717917440113144,0.159600760456274,0
"<anonymized_userid>",7,40616,1680,"Geert Wilders (PVV)",0.718041191549545,0.159695817490494,0
"<anonymized_userid>",7,40623,1681,"Geert Wilders (PVV)",0.718164942985945,0.159790874524715,0
"<anonymized_userid>",7,40630,1682,"Geert Wilders (PVV)",0.718288694422346,0.159885931558935,0
"<anonymized_userid>",7,40637,1683,"Geert Wilders (PVV)",0.718412445858747,0.159980988593156,0
"<anonymized_userid>",7,40644,1684,"Geert Wilders (PVV)",0.718536197295147,0.160076045627376,0
"<anonymized_userid>",7,40651,1685,"Geert Wilders (PVV)",0.718659948731548,0.160171102661597,0
"<anonymized_userid>",7,40658,1686,"Geert Wilders (PVV)",0.718783700167948,0.160266159695817,0
"<anonymized_userid>",7,40665,1687,"Geert Wilders (PVV)",0.718907451604349,0.160361216730038,0
"<anonymized_userid>",7,40672,1688,"Geert Wilders (PVV)",0.71903120304075,0.160456273764259,0
"<anonymized_userid>",7,40679,1689,"Geert Wilders (PVV)",0.71915495447715,0.160551330798479,0
"<anonymized_userid>",7,40686,1690,"Geert Wilders (PVV)",0.719278705913551,0.1606463878327,0
"<anonymized_userid>",7,40693,1691,"Geert Wilders (PVV)",0.719402457349951,0.16074144486692,0
"<anonymized_userid>",7,40700,1692,"Geert Wilders (PVV)",0.719526208786352,0.160836501901141,0
"<anonymized_userid>",7,40707,1693,"Geert Wilders (PVV)",0.719649960222753,0.160931558935361,0
"<anonymized_userid>",7,40714,1694,"Geert Wilders (PVV)",0.719773711659153,0.161026615969582,0
"<anonymized_userid>",7,40721,1695,"Geert Wilders (PVV)",0.719897463095554,0.161121673003802,0
"<anonymized_userid>",7,40728,1696,"Geert Wilders (PVV)",0.720021214531954,0.161216730038023,0
"<anonymized_userid>",7,40735,1697,"Geert Wilders (PVV)",0.720144965968355,0.161311787072243,0
"<anonymized_userid>",7,40742,1698,"Geert Wilders (PVV)",0.720268717404756,0.161406844106464,0
"<anonymized_userid>",7,40749,1699,"Geert Wilders (PVV)",0.720392468841156,0.161501901140684,0
"<anonymized_userid>",7,40756,1700,"Geert Wilders (PVV)",0.720516220277557,0.161596958174905,0
"<anonymized_userid>",7,40763,1701,"Geert Wilders (PVV)",0.720639971713957,0.161692015209125,0
"<anonymized_userid>",7,40770,1702,"Geert Wilders (PVV)",0.720763723150358,0.161787072243346,0
"<anonymized_userid>",7,40777,1703,"Geert Wilders (PVV)",0.720887474586759,0.161882129277567,0
"<anonymized_userid>",7,40784,1704,"Geert Wilders (PVV)",0.721011226023159,0.161977186311787,0
"<anonymized_userid>",7,40791,1705,"Geert Wilders (PVV)",0.72113497745956,0.162072243346008,0
"<anonymized_userid>",7,40798,1706,"Geert Wilders (PVV)",0.72125872889596,0.162167300380228,0
"<anonymized_userid>",7,40805,1707,"Geert Wilders (PVV)",0.721382480332361,0.162262357414449,0
"<anonymized_userid>",7,40812,1708,"Geert Wilders (PVV)",0.721506231768762,0.162357414448669,0
"<anonymized_userid>",7,40819,1709,"Geert Wilders (PVV)",0.721629983205162,0.16245247148289,0
"<anonymized_userid>",7,40826,1710,"Geert Wilders (PVV)",0.721753734641563,0.16254752851711,0
"<anonymized_userid>",7,40833,1711,"Geert Wilders (PVV)",0.721877486077963,0.162642585551331,0
"<anonymized_userid>",7,40840,1712,"Geert Wilders (PVV)",0.722001237514364,0.162737642585551,0
"<anonymized_userid>",7,40847,1713,"Geert Wilders (PVV)",0.722124988950765,0.162832699619772,0
"<anonymized_userid>",7,40854,1714,"Geert Wilders (PVV)",0.722248740387165,0.162927756653992,0
"<anonymized_userid>",7,40861,1715,"Geert Wilders (PVV)",0.722372491823566,0.163022813688213,0
"<anonymized_userid>",7,40868,1716,"Geert Wilders (PVV)",0.722496243259966,0.163117870722433,0
"<anonymized_userid>",7,40875,1717,"Geert Wilders (PVV)",0.722619994696367,0.163212927756654,0
"<anonymized_userid>",7,40882,1718,"Geert Wilders (PVV)",0.722743746132768,0.163307984790875,0
"<anonymized_userid>",7,40889,1719,"Geert Wilders (PVV)",0.722867497569168,0.163403041825095,0
"<anonymized_userid>",7,40896,1720,"Geert Wilders (PVV)",0.722991249005569,0.163498098859316,0
"<anonymized_userid>",7,40903,1721,"Geert Wilders (PVV)",0.723115000441969,0.163593155893536,0
"<anonymized_userid>",7,40910,1722,"Geert Wilders (PVV)",0.72323875187837,0.163688212927757,0
"<anonymized_userid>",7,40917,1723,"Geert Wilders (PVV)",0.723362503314771,0.163783269961977,0
"<anonymized_userid>",7,40924,1724,"Geert Wilders (PVV)",0.723486254751171,0.163878326996198,0
"<anonymized_userid>",7,40931,1725,"Geert Wilders (PVV)",0.723610006187572,0.163973384030418,0
"<anonymized_userid>",7,40938,1726,"Geert Wilders (PVV)",0.723733757623972,0.164068441064639,0
"<anonymized_userid>",7,40945,1727,"Geert Wilders (PVV)",0.723857509060373,0.164163498098859,0
"<anonymized_userid>",7,40952,1728,"Geert Wilders (PVV)",0.723981260496774,0.16425855513308,0
"<anonymized_userid>",7,40959,1729,"Geert Wilders (PVV)",0.724105011933174,0.1643536121673,0
"<anonymized_userid>",7,40966,1730,"Geert Wilders (PVV)",0.724228763369575,0.164448669201521,0
"<anonymized_userid>",7,40973,1731,"Geert Wilders (PVV)",0.724352514805975,0.164543726235741,0
"<anonymized_userid>",7,40980,1732,"Geert Wilders (PVV)",0.724476266242376,0.164638783269962,0
"<anonymized_userid>",7,40987,1733,"Geert Wilders (PVV)",0.724600017678777,0.164733840304183,0
"<anonymized_userid>",7,40994,1734,"Geert Wilders (PVV)",0.724723769115177,0.164828897338403,0
"<anonymized_userid>",7,41001,1735,"Geert Wilders (PVV)",0.724847520551578,0.164923954372624,0
"<anonymized_userid>",7,41008,1736,"Geert Wilders (PVV)",0.724971271987978,0.165019011406844,0
"<anonymized_userid>",7,41015,1737,"Geert Wilders (PVV)",0.725095023424379,0.165114068441065,0
"<anonymized_userid>",7,41022,1738,"Geert Wilders (PVV)",0.72521877486078,0.165209125475285,0
"<anonymized_userid>",7,41029,1739,"Geert Wilders (PVV)",0.72534252629718,0.165304182509506,0
"<anonymized_userid>",7,41036,1740,"Geert Wilders (PVV)",0.725466277733581,0.165399239543726,0
"<anonymized_userid>",7,41043,1741,"Geert Wilders (PVV)",0.725590029169981,0.165494296577947,0
"<anonymized_userid>",7,41050,1742,"Geert Wilders (PVV)",0.725713780606382,0.165589353612167,0
"<anonymized_userid>",7,41057,1743,"Geert Wilders (PVV)",0.725837532042783,0.165684410646388,0
"<anonymized_userid>",7,41064,1744,"Geert Wilders (PVV)",0.725961283479183,0.165779467680608,0
"<anonymized_userid>",7,41071,1745,"Geert Wilders (PVV)",0.726085034915584,0.165874524714829,0
"<anonymized_userid>",7,41078,1746,"Geert Wilders (PVV)",0.726208786351984,0.165969581749049,0
"<anonymized_userid>",7,41085,1747,"Geert Wilders (PVV)",0.726332537788385,0.16606463878327,0
"<anonymized_userid>",7,41092,1748,"Geert Wilders (PVV)",0.726456289224786,0.16615969581749,0
"<anonymized_userid>",7,41099,1749,"Geert Wilders (PVV)",0.726580040661186,0.166254752851711,0
"<anonymized_userid>",7,41106,1750,"Geert Wilders (PVV)",0.726703792097587,0.166349809885932,0
"<anonymized_userid>",7,41113,1751,"Geert Wilders (PVV)",0.726827543533987,0.166444866920152,0
"<anonymized_userid>",7,41120,1752,"Geert Wilders (PVV)",0.726951294970388,0.166539923954373,0
"<anonymized_userid>",7,41127,1753,"Geert Wilders (PVV)",0.727075046406789,0.166634980988593,0
"<anonymized_userid>",7,41134,1754,"Geert Wilders (PVV)",0.727198797843189,0.166730038022814,0
"<anonymized_userid>",7,41141,1755,"Geert Wilders (PVV)",0.72732254927959,0.166825095057034,0
"<anonymized_userid>",6,41147,1756,"Geert Wilders (PVV)",0.727428621939362,0.166920152091255,0
"<anonymized_userid>",6,41153,1757,"Geert Wilders (PVV)",0.727534694599134,0.167015209125475,0
"<anonymized_userid>",6,41159,1758,"Geert Wilders (PVV)",0.727640767258906,0.167110266159696,0
"<anonymized_userid>",6,41165,1759,"Geert Wilders (PVV)",0.727746839918678,0.167205323193916,0
"<anonymized_userid>",6,41171,1760,"Geert Wilders (PVV)",0.72785291257845,0.167300380228137,0
"<anonymized_userid>",6,41177,1761,"Geert Wilders (PVV)",0.727958985238222,0.167395437262357,0
"<anonymized_userid>",6,41183,1762,"Geert Wilders (PVV)",0.728065057897993,0.167490494296578,0
"<anonymized_userid>",6,41189,1763,"Geert Wilders (PVV)",0.728171130557765,0.167585551330798,0
"<anonymized_userid>",6,41195,1764,"Geert Wilders (PVV)",0.728277203217537,0.167680608365019,0
"<anonymized_userid>",6,41201,1765,"Geert Wilders (PVV)",0.728383275877309,0.16777566539924,0
"<anonymized_userid>",6,41207,1766,"Geert Wilders (PVV)",0.728489348537081,0.16787072243346,0
"<anonymized_userid>",6,41213,1767,"Geert Wilders (PVV)",0.728595421196853,0.167965779467681,0
"<anonymized_userid>",6,41219,1768,"Geert Wilders (PVV)",0.728701493856625,0.168060836501901,0
"<anonymized_userid>",6,41225,1769,"Geert Wilders (PVV)",0.728807566516397,0.168155893536122,0
"<anonymized_userid>",6,41231,1770,"Geert Wilders (PVV)",0.728913639176169,0.168250950570342,0
"<anonymized_userid>",6,41237,1771,"Geert Wilders (PVV)",0.729019711835941,0.168346007604563,0
"<anonymized_userid>",6,41243,1772,"Geert Wilders (PVV)",0.729125784495713,0.168441064638783,0
"<anonymized_userid>",6,41249,1773,"Geert Wilders (PVV)",0.729231857155485,0.168536121673004,0
"<anonymized_userid>",6,41255,1774,"Geert Wilders (PVV)",0.729337929815257,0.168631178707224,0
"<anonymized_userid>",6,41261,1775,"Geert Wilders (PVV)",0.729444002475029,0.168726235741445,0
"<anonymized_userid>",6,41267,1776,"Geert Wilders (PVV)",0.729550075134801,0.168821292775665,0
"<anonymized_userid>",6,41273,1777,"Geert Wilders (PVV)",0.729656147794573,0.168916349809886,0
"<anonymized_userid>",6,41279,1778,"Geert Wilders (PVV)",0.729762220454345,0.169011406844106,0
"<anonymized_userid>",6,41285,1779,"Geert Wilders (PVV)",0.729868293114116,0.169106463878327,0
"<anonymized_userid>",6,41291,1780,"Geert Wilders (PVV)",0.729974365773888,0.169201520912548,0
"<anonymized_userid>",6,41297,1781,"Geert Wilders (PVV)",0.73008043843366,0.169296577946768,0
"<anonymized_userid>",6,41303,1782,"Geert Wilders (PVV)",0.730186511093432,0.169391634980989,0
"<anonymized_userid>",6,41309,1783,"Geert Wilders (PVV)",0.730292583753204,0.169486692015209,0
"<anonymized_userid>",6,41315,1784,"Geert Wilders (PVV)",0.730398656412976,0.16958174904943,0
"<anonymized_userid>",6,41321,1785,"Geert Wilders (PVV)",0.730504729072748,0.16967680608365,0
"<anonymized_userid>",6,41327,1786,"Geert Wilders (PVV)",0.73061080173252,0.169771863117871,0
"<anonymized_userid>",6,41333,1787,"Geert Wilders (PVV)",0.730716874392292,0.169866920152091,0
"<anonymized_userid>",6,41339,1788,"Geert Wilders (PVV)",0.730822947052064,0.169961977186312,0
"<anonymized_userid>",6,41345,1789,"Geert Wilders (PVV)",0.730929019711836,0.170057034220532,0
"<anonymized_userid>",6,41351,1790,"Geert Wilders (PVV)",0.731035092371608,0.170152091254753,0
"<anonymized_userid>",6,41357,1791,"Geert Wilders (PVV)",0.73114116503138,0.170247148288973,0
"<anonymized_userid>",6,41363,1792,"Geert Wilders (PVV)",0.731247237691152,0.170342205323194,0
"<anonymized_userid>",6,41369,1793,"Geert Wilders (PVV)",0.731353310350924,0.170437262357414,0
"<anonymized_userid>",6,41375,1794,"Geert Wilders (PVV)",0.731459383010696,0.170532319391635,0
"<anonymized_userid>",6,41381,1795,"Geert Wilders (PVV)",0.731565455670468,0.170627376425856,0
"<anonymized_userid>",6,41387,1796,"Geert Wilders (PVV)",0.73167152833024,0.170722433460076,0
"<anonymized_userid>",6,41393,1797,"Geert Wilders (PVV)",0.731777600990012,0.170817490494297,0
"<anonymized_userid>",6,41399,1798,"Geert Wilders (PVV)",0.731883673649783,0.170912547528517,0
"<anonymized_userid>",6,41405,1799,"Geert Wilders (PVV)",0.731989746309555,0.171007604562738,0
"<anonymized_userid>",6,41411,1800,"Geert Wilders (PVV)",0.732095818969327,0.171102661596958,0
"<anonymized_userid>",6,41417,1801,"Geert Wilders (PVV)",0.732201891629099,0.171197718631179,0
"<anonymized_userid>",6,41423,1802,"Geert Wilders (PVV)",0.732307964288871,0.171292775665399,0
"<anonymized_userid>",6,41429,1803,"Geert Wilders (PVV)",0.732414036948643,0.17138783269962,0
"<anonymized_userid>",6,41435,1804,"Geert Wilders (PVV)",0.732520109608415,0.17148288973384,0
"<anonymized_userid>",6,41441,1805,"Geert Wilders (PVV)",0.732626182268187,0.171577946768061,0
"<anonymized_userid>",6,41447,1806,"Geert Wilders (PVV)",0.732732254927959,0.171673003802281,0
"<anonymized_userid>",6,41453,1807,"Geert Wilders (PVV)",0.732838327587731,0.171768060836502,0
"<anonymized_userid>",6,41459,1808,"Geert Wilders (PVV)",0.732944400247503,0.171863117870722,0
"<anonymized_userid>",6,41465,1809,"Geert Wilders (PVV)",0.733050472907275,0.171958174904943,0
"<anonymized_userid>",6,41471,1810,"Geert Wilders (PVV)",0.733156545567047,0.172053231939163,0
"<anonymized_userid>",6,41477,1811,"Geert Wilders (PVV)",0.733262618226819,0.172148288973384,0
"<anonymized_userid>",6,41483,1812,"Geert Wilders (PVV)",0.733368690886591,0.172243346007605,0
"<anonymized_userid>",6,41489,1813,"Geert Wilders (PVV)",0.733474763546363,0.172338403041825,0
"<anonymized_userid>",6,41495,1814,"Geert Wilders (PVV)",0.733580836206135,0.172433460076046,0
"<anonymized_userid>",6,41501,1815,"Geert Wilders (PVV)",0.733686908865906,0.172528517110266,0
"<anonymized_userid>",6,41507,1816,"Geert Wilders (PVV)",0.733792981525678,0.172623574144487,0
"<anonymized_userid>",6,41513,1817,"Geert Wilders (PVV)",0.73389905418545,0.172718631178707,0
"<anonymized_userid>",6,41519,1818,"Geert Wilders (PVV)",0.734005126845222,0.172813688212928,0
"<anonymized_userid>",6,41525,1819,"Geert Wilders (PVV)",0.734111199504994,0.172908745247148,0
"<anonymized_userid>",6,41531,1820,"Geert Wilders (PVV)",0.734217272164766,0.173003802281369,0
"<anonymized_userid>",6,41537,1821,"Geert Wilders (PVV)",0.734323344824538,0.173098859315589,0
"<anonymized_userid>",6,41543,1822,"Geert Wilders (PVV)",0.73442941748431,0.17319391634981,0
"<anonymized_userid>",6,41549,1823,"Geert Wilders (PVV)",0.734535490144082,0.17328897338403,0
"<anonymized_userid>",6,41555,1824,"Geert Wilders (PVV)",0.734641562803854,0.173384030418251,0
"<anonymized_userid>",6,41561,1825,"Geert Wilders (PVV)",0.734747635463626,0.173479087452471,0
"<anonymized_userid>",6,41567,1826,"Geert Wilders (PVV)",0.734853708123398,0.173574144486692,0
"<anonymized_userid>",6,41573,1827,"Geert Wilders (PVV)",0.73495978078317,0.173669201520913,0
"<anonymized_userid>",6,41579,1828,"Geert Wilders (PVV)",0.735065853442942,0.173764258555133,0
"<anonymized_userid>",6,41585,1829,"Geert Wilders (PVV)",0.735171926102714,0.173859315589354,0
"<anonymized_userid>",6,41591,1830,"Geert Wilders (PVV)",0.735277998762486,0.173954372623574,0
"<anonymized_userid>",6,41597,1831,"Geert Wilders (PVV)",0.735384071422258,0.174049429657795,0
"<anonymized_userid>",6,41603,1832,"Geert Wilders (PVV)",0.73549014408203,0.174144486692015,0
"<anonymized_userid>",6,41609,1833,"Geert Wilders (PVV)",0.735596216741801,0.174239543726236,0
"<anonymized_userid>",6,41615,1834,"Geert Wilders (PVV)",0.735702289401573,0.174334600760456,0
"<anonymized_userid>",6,41621,1835,"Geert Wilders (PVV)",0.735808362061345,0.174429657794677,0
"<anonymized_userid>",6,41627,1836,"Geert Wilders (PVV)",0.735914434721117,0.174524714828897,0
"<anonymized_userid>",6,41633,1837,"Geert Wilders (PVV)",0.736020507380889,0.174619771863118,0
"<anonymized_userid>",6,41639,1838,"Geert Wilders (PVV)",0.736126580040661,0.174714828897338,0
"<anonymized_userid>",6,41645,1839,"Geert Wilders (PVV)",0.736232652700433,0.174809885931559,0
"<anonymized_userid>",6,41651,1840,"Geert Wilders (PVV)",0.736338725360205,0.174904942965779,0
"<anonymized_userid>",6,41657,1841,"Geert Wilders (PVV)",0.736444798019977,0.175,0
"<anonymized_userid>",6,41663,1842,"Geert Wilders (PVV)",0.736550870679749,0.175095057034221,0
"<anonymized_userid>",6,41669,1843,"Geert Wilders (PVV)",0.736656943339521,0.175190114068441,0
"<anonymized_userid>",6,41675,1844,"Geert Wilders (PVV)",0.736763015999293,0.175285171102662,0
"<anonymized_userid>",6,41681,1845,"Geert Wilders (PVV)",0.736869088659065,0.175380228136882,0
"<anonymized_userid>",6,41687,1846,"Geert Wilders (PVV)",0.736975161318837,0.175475285171103,0
"<anonymized_userid>",6,41693,1847,"Geert Wilders (PVV)",0.737081233978609,0.175570342205323,0
"<anonymized_userid>",6,41699,1848,"Geert Wilders (PVV)",0.737187306638381,0.175665399239544,0
"<anonymized_userid>",6,41705,1849,"Geert Wilders (PVV)",0.737293379298153,0.175760456273764,0
"<anonymized_userid>",6,41711,1850,"Geert Wilders (PVV)",0.737399451957925,0.175855513307985,0
"<anonymized_userid>",6,41717,1851,"Geert Wilders (PVV)",0.737505524617696,0.175950570342205,0
"<anonymized_userid>",6,41723,1852,"Geert Wilders (PVV)",0.737611597277468,0.176045627376426,0
"<anonymized_userid>",6,41729,1853,"Geert Wilders (PVV)",0.73771766993724,0.176140684410646,0
"<anonymized_userid>",6,41735,1854,"Geert Wilders (PVV)",0.737823742597012,0.176235741444867,0
"<anonymized_userid>",6,41741,1855,"Geert Wilders (PVV)",0.737929815256784,0.176330798479087,0
"<anonymized_userid>",6,41747,1856,"Geert Wilders (PVV)",0.738035887916556,0.176425855513308,0
"<anonymized_userid>",6,41753,1857,"Geert Wilders (PVV)",0.738141960576328,0.176520912547529,0
"<anonymized_userid>",6,41759,1858,"Geert Wilders (PVV)",0.7382480332361,0.176615969581749,0
"<anonymized_userid>",6,41765,1859,"Geert Wilders (PVV)",0.738354105895872,0.17671102661597,0
"<anonymized_userid>",6,41771,1860,"Geert Wilders (PVV)",0.738460178555644,0.17680608365019,0
"<anonymized_userid>",6,41777,1861,"Geert Wilders (PVV)",0.738566251215416,0.176901140684411,0
"<anonymized_userid>",6,41783,1862,"Geert Wilders (PVV)",0.738672323875188,0.176996197718631,0
"<anonymized_userid>",6,41789,1863,"Geert Wilders (PVV)",0.73877839653496,0.177091254752852,0
"<anonymized_userid>",6,41795,1864,"Geert Wilders (PVV)",0.738884469194732,0.177186311787072,0
"<anonymized_userid>",6,41801,1865,"Geert Wilders (PVV)",0.738990541854504,0.177281368821293,0
"<anonymized_userid>",6,41807,1866,"Geert Wilders (PVV)",0.739096614514276,0.177376425855513,0
"<anonymized_userid>",6,41813,1867,"Geert Wilders (PVV)",0.739202687174048,0.177471482889734,0
"<anonymized_userid>",6,41819,1868,"Geert Wilders (PVV)",0.739308759833819,0.177566539923954,0
"<anonymized_userid>",6,41825,1869,"Geert Wilders (PVV)",0.739414832493591,0.177661596958175,0
"<anonymized_userid>",6,41831,1870,"Geert Wilders (PVV)",0.739520905153363,0.177756653992395,0
"<anonymized_userid>",6,41837,1871,"Geert Wilders (PVV)",0.739626977813135,0.177851711026616,0
"<anonymized_userid>",6,41843,1872,"Geert Wilders (PVV)",0.739733050472907,0.177946768060837,0
"<anonymized_userid>",6,41849,1873,"Geert Wilders (PVV)",0.739839123132679,0.178041825095057,0
"<anonymized_userid>",6,41855,1874,"Geert Wilders (PVV)",0.739945195792451,0.178136882129278,0
"<anonymized_userid>",6,41861,1875,"Geert Wilders (PVV)",0.740051268452223,0.178231939163498,0
"<anonymized_userid>",6,41867,1876,"Geert Wilders (PVV)",0.740157341111995,0.178326996197719,0
"<anonymized_userid>",6,41873,1877,"Geert Wilders (PVV)",0.740263413771767,0.178422053231939,0
"<anonymized_userid>",6,41879,1878,"Geert Wilders (PVV)",0.740369486431539,0.17851711026616,0
"<anonymized_userid>",6,41885,1879,"Geert Wilders (PVV)",0.740475559091311,0.17861216730038,0
"<anonymized_userid>",6,41891,1880,"Geert Wilders (PVV)",0.740581631751083,0.178707224334601,0
"<anonymized_userid>",6,41897,1881,"Geert Wilders (PVV)",0.740687704410855,0.178802281368821,0
"<anonymized_userid>",6,41903,1882,"Geert Wilders (PVV)",0.740793777070627,0.178897338403042,0
"<anonymized_userid>",6,41909,1883,"Geert Wilders (PVV)",0.740899849730399,0.178992395437262,0
"<anonymized_userid>",6,41915,1884,"Geert Wilders (PVV)",0.741005922390171,0.179087452471483,0
"<anonymized_userid>",6,41921,1885,"Geert Wilders (PVV)",0.741111995049943,0.179182509505703,0
"<anonymized_userid>",6,41927,1886,"Geert Wilders (PVV)",0.741218067709714,0.179277566539924,0
"<anonymized_userid>",6,41933,1887,"Geert Wilders (PVV)",0.741324140369486,0.179372623574144,0
"<anonymized_userid>",6,41939,1888,"Geert Wilders (PVV)",0.741430213029258,0.179467680608365,0
"<anonymized_userid>",6,41945,1889,"Geert Wilders (PVV)",0.74153628568903,0.179562737642586,0
"<anonymized_userid>",6,41951,1890,"Geert Wilders (PVV)",0.741642358348802,0.179657794676806,0
"<anonymized_userid>",6,41957,1891,"Geert Wilders (PVV)",0.741748431008574,0.179752851711027,0
"<anonymized_userid>",6,41963,1892,"Geert Wilders (PVV)",0.741854503668346,0.179847908745247,0
"<anonymized_userid>",6,41969,1893,"Geert Wilders (PVV)",0.741960576328118,0.179942965779468,0
"<anonymized_userid>",6,41975,1894,"Geert Wilders (PVV)",0.74206664898789,0.180038022813688,0
"<anonymized_userid>",6,41981,1895,"Geert Wilders (PVV)",0.742172721647662,0.180133079847909,0
"<anonymized_userid>",6,41987,1896,"Geert Wilders (PVV)",0.742278794307434,0.180228136882129,0
"<anonymized_userid>",6,41993,1897,"Geert Wilders (PVV)",0.742384866967206,0.18032319391635,0
"<anonymized_userid>",6,41999,1898,"Geert Wilders (PVV)",0.742490939626978,0.18041825095057,0
"<anonymized_userid>",6,42005,1899,"Geert Wilders (PVV)",0.74259701228675,0.180513307984791,0
"<anonymized_userid>",6,42011,1900,"Geert Wilders (PVV)",0.742703084946522,0.180608365019011,0
"<anonymized_userid>",6,42017,1901,"Geert Wilders (PVV)",0.742809157606294,0.180703422053232,0
"<anonymized_userid>",6,42023,1902,"Geert Wilders (PVV)",0.742915230266066,0.180798479087452,0
"<anonymized_userid>",6,42029,1903,"Geert Wilders (PVV)",0.743021302925838,0.180893536121673,0
"<anonymized_userid>",6,42035,1904,"Geert Wilders (PVV)",0.743127375585609,0.180988593155894,0
"<anonymized_userid>",6,42041,1905,"Geert Wilders (PVV)",0.743233448245381,0.181083650190114,0
"<anonymized_userid>",6,42047,1906,"Geert Wilders (PVV)",0.743339520905153,0.181178707224335,0
"<anonymized_userid>",6,42053,1907,"Geert Wilders (PVV)",0.743445593564925,0.181273764258555,0
"<anonymized_userid>",6,42059,1908,"Geert Wilders (PVV)",0.743551666224697,0.181368821292776,0
"<anonymized_userid>",6,42065,1909,"Geert Wilders (PVV)",0.743657738884469,0.181463878326996,0
"<anonymized_userid>",6,42071,1910,"Geert Wilders (PVV)",0.743763811544241,0.181558935361217,0
"<anonymized_userid>",6,42077,1911,"Geert Wilders (PVV)",0.743869884204013,0.181653992395437,0
"<anonymized_userid>",6,42083,1912,"Geert Wilders (PVV)",0.743975956863785,0.181749049429658,0
"<anonymized_userid>",6,42089,1913,"Geert Wilders (PVV)",0.744082029523557,0.181844106463878,0
"<anonymized_userid>",6,42095,1914,"Geert Wilders (PVV)",0.744188102183329,0.181939163498099,0
"<anonymized_userid>",6,42101,1915,"Geert Wilders (PVV)",0.744294174843101,0.182034220532319,0
"<anonymized_userid>",6,42107,1916,"Geert Wilders (PVV)",0.744400247502873,0.18212927756654,0
"<anonymized_userid>",6,42113,1917,"Geert Wilders (PVV)",0.744506320162645,0.18222433460076,0
"<anonymized_userid>",6,42119,1918,"Geert Wilders (PVV)",0.744612392822417,0.182319391634981,0
"<anonymized_userid>",6,42125,1919,"Geert Wilders (PVV)",0.744718465482189,0.182414448669202,0
"<anonymized_userid>",6,42131,1920,"Geert Wilders (PVV)",0.744824538141961,0.182509505703422,0
"<anonymized_userid>",6,42137,1921,"Geert Wilders (PVV)",0.744930610801733,0.182604562737643,0
"<anonymized_userid>",6,42143,1922,"Geert Wilders (PVV)",0.745036683461504,0.182699619771863,0
"<anonymized_userid>",6,42149,1923,"Geert Wilders (PVV)",0.745142756121276,0.182794676806084,0
"<anonymized_userid>",6,42155,1924,"Geert Wilders (PVV)",0.745248828781048,0.182889733840304,0
"<anonymized_userid>",6,42161,1925,"Geert Wilders (PVV)",0.74535490144082,0.182984790874525,0
"<anonymized_userid>",6,42167,1926,"Geert Wilders (PVV)",0.745460974100592,0.183079847908745,0
"<anonymized_userid>",6,42173,1927,"Geert Wilders (PVV)",0.745567046760364,0.183174904942966,0
"<anonymized_userid>",6,42179,1928,"Geert Wilders (PVV)",0.745673119420136,0.183269961977186,0
"<anonymized_userid>",6,42185,1929,"Geert Wilders (PVV)",0.745779192079908,0.183365019011407,0
"<anonymized_userid>",6,42191,1930,"Geert Wilders (PVV)",0.74588526473968,0.183460076045627,0
"<anonymized_userid>",6,42197,1931,"Geert Wilders (PVV)",0.745991337399452,0.183555133079848,0
"<anonymized_userid>",6,42203,1932,"Geert Wilders (PVV)",0.746097410059224,0.183650190114068,0
"<anonymized_userid>",6,42209,1933,"Geert Wilders (PVV)",0.746203482718996,0.183745247148289,0
"<anonymized_userid>",6,42215,1934,"Geert Wilders (PVV)",0.746309555378768,0.18384030418251,0
"<anonymized_userid>",6,42221,1935,"Geert Wilders (PVV)",0.74641562803854,0.18393536121673,0
"<anonymized_userid>",6,42227,1936,"Geert Wilders (PVV)",0.746521700698312,0.184030418250951,0
"<anonymized_userid>",6,42233,1937,"Geert Wilders (PVV)",0.746627773358084,0.184125475285171,0
"<anonymized_userid>",6,42239,1938,"Geert Wilders (PVV)",0.746733846017856,0.184220532319392,0
"<anonymized_userid>",6,42245,1939,"Geert Wilders (PVV)",0.746839918677628,0.184315589353612,0
"<anonymized_userid>",6,42251,1940,"Geert Wilders (PVV)",0.746945991337399,0.184410646387833,0
"<anonymized_userid>",6,42257,1941,"Geert Wilders (PVV)",0.747052063997171,0.184505703422053,0
"<anonymized_userid>",6,42263,1942,"Geert Wilders (PVV)",0.747158136656943,0.184600760456274,0
"<anonymized_userid>",6,42269,1943,"Geert Wilders (PVV)",0.747264209316715,0.184695817490494,0
"<anonymized_userid>",6,42275,1944,"Geert Wilders (PVV)",0.747370281976487,0.184790874524715,0
"<anonymized_userid>",6,42281,1945,"Geert Wilders (PVV)",0.747476354636259,0.184885931558935,0
"<anonymized_userid>",6,42287,1946,"Geert Wilders (PVV)",0.747582427296031,0.184980988593156,0
"<anonymized_userid>",6,42293,1947,"Geert Wilders (PVV)",0.747688499955803,0.185076045627376,0
"<anonymized_userid>",6,42299,1948,"Geert Wilders (PVV)",0.747794572615575,0.185171102661597,0
"<anonymized_userid>",6,42305,1949,"Geert Wilders (PVV)",0.747900645275347,0.185266159695818,0
"<anonymized_userid>",6,42311,1950,"Geert Wilders (PVV)",0.748006717935119,0.185361216730038,0
"<anonymized_userid>",6,42317,1951,"Geert Wilders (PVV)",0.748112790594891,0.185456273764259,0
"<anonymized_userid>",6,42323,1952,"Geert Wilders (PVV)",0.748218863254663,0.185551330798479,0
"<anonymized_userid>",6,42329,1953,"Geert Wilders (PVV)",0.748324935914435,0.1856463878327,0
"<anonymized_userid>",6,42335,1954,"Geert Wilders (PVV)",0.748431008574207,0.18574144486692,0
"<anonymized_userid>",6,42341,1955,"Geert Wilders (PVV)",0.748537081233979,0.185836501901141,0
"<anonymized_userid>",6,42347,1956,"Geert Wilders (PVV)",0.748643153893751,0.185931558935361,0
"<anonymized_userid>",6,42353,1957,"Geert Wilders (PVV)",0.748749226553522,0.186026615969582,0
"<anonymized_userid>",6,42359,1958,"Geert Wilders (PVV)",0.748855299213294,0.186121673003802,0
"<anonymized_userid>",6,42365,1959,"Geert Wilders (PVV)",0.748961371873066,0.186216730038023,0
"<anonymized_userid>",6,42371,1960,"Geert Wilders (PVV)",0.749067444532838,0.186311787072243,0
"<anonymized_userid>",6,42377,1961,"Geert Wilders (PVV)",0.74917351719261,0.186406844106464,0
"<anonymized_userid>",6,42383,1962,"Geert Wilders (PVV)",0.749279589852382,0.186501901140684,0
"<anonymized_userid>",6,42389,1963,"Geert Wilders (PVV)",0.749385662512154,0.186596958174905,0
"<anonymized_userid>",6,42395,1964,"Geert Wilders (PVV)",0.749491735171926,0.186692015209125,0
"<anonymized_userid>",6,42401,1965,"Geert Wilders (PVV)",0.749597807831698,0.186787072243346,0
"<anonymized_userid>",6,42407,1966,"Geert Wilders (PVV)",0.74970388049147,0.186882129277567,0
"<anonymized_userid>",6,42413,1967,"Geert Wilders (PVV)",0.749809953151242,0.186977186311787,0
"<anonymized_userid>",6,42419,1968,"Geert Wilders (PVV)",0.749916025811014,0.187072243346008,0
"<anonymized_userid>",6,42425,1969,"Geert Wilders (PVV)",0.750022098470786,0.187167300380228,0
"<anonymized_userid>",6,42431,1970,"Geert Wilders (PVV)",0.750128171130558,0.187262357414449,0
"<anonymized_userid>",6,42437,1971,"Geert Wilders (PVV)",0.75023424379033,0.187357414448669,0
"<anonymized_userid>",6,42443,1972,"Geert Wilders (PVV)",0.750340316450102,0.18745247148289,0
"<anonymized_userid>",6,42449,1973,"Geert Wilders (PVV)",0.750446389109874,0.18754752851711,0
"<anonymized_userid>",6,42455,1974,"Geert Wilders (PVV)",0.750552461769646,0.187642585551331,0
"<anonymized_userid>",6,42461,1975,"Geert Wilders (PVV)",0.750658534429417,0.187737642585551,0
"<anonymized_userid>",6,42467,1976,"Geert Wilders (PVV)",0.750764607089189,0.187832699619772,0
"<anonymized_userid>",6,42473,1977,"Geert Wilders (PVV)",0.750870679748961,0.187927756653992,0
"<anonymized_userid>",6,42479,1978,"Geert Wilders (PVV)",0.750976752408733,0.188022813688213,0
"<anonymized_userid>",6,42485,1979,"Geert Wilders (PVV)",0.751082825068505,0.188117870722433,0
"<anonymized_userid>",6,42491,1980,"Geert Wilders (PVV)",0.751188897728277,0.188212927756654,0
"<anonymized_userid>",6,42497,1981,"Geert Wilders (PVV)",0.751294970388049,0.188307984790875,0
"<anonymized_userid>",6,42503,1982,"Geert Wilders (PVV)",0.751401043047821,0.188403041825095,0
"<anonymized_userid>",6,42509,1983,"Geert Wilders (PVV)",0.751507115707593,0.188498098859316,0
"<anonymized_userid>",6,42515,1984,"Geert Wilders (PVV)",0.751613188367365,0.188593155893536,0
"<anonymized_userid>",6,42521,1985,"Geert Wilders (PVV)",0.751719261027137,0.188688212927757,0
"<anonymized_userid>",6,42527,1986,"Geert Wilders (PVV)",0.751825333686909,0.188783269961977,0
"<anonymized_userid>",6,42533,1987,"Geert Wilders (PVV)",0.751931406346681,0.188878326996198,0
"<anonymized_userid>",6,42539,1988,"Geert Wilders (PVV)",0.752037479006453,0.188973384030418,0
"<anonymized_userid>",6,42545,1989,"Geert Wilders (PVV)",0.752143551666225,0.189068441064639,0
"<anonymized_userid>",6,42551,1990,"Geert Wilders (PVV)",0.752249624325997,0.189163498098859,0
"<anonymized_userid>",5,42556,1991,"Geert Wilders (PVV)",0.75233801820914,0.18925855513308,0
"<anonymized_userid>",5,42561,1992,"Geert Wilders (PVV)",0.752426412092283,0.1893536121673,0
"<anonymized_userid>",5,42566,1993,"Geert Wilders (PVV)",0.752514805975427,0.189448669201521,0
"<anonymized_userid>",5,42571,1994,"Geert Wilders (PVV)",0.75260319985857,0.189543726235741,0
"<anonymized_userid>",5,42576,1995,"Geert Wilders (PVV)",0.752691593741713,0.189638783269962,0
"<anonymized_userid>",5,42581,1996,"Geert Wilders (PVV)",0.752779987624856,0.189733840304182,0
"<anonymized_userid>",5,42586,1997,"Geert Wilders (PVV)",0.752868381508,0.189828897338403,0
"<anonymized_userid>",5,42591,1998,"Geert Wilders (PVV)",0.752956775391143,0.189923954372624,0
"<anonymized_userid>",5,42596,1999,"Geert Wilders (PVV)",0.753045169274286,0.190019011406844,0
"<anonymized_userid>",5,42601,2000,"Geert Wilders (PVV)",0.75313356315743,0.190114068441065,0
"<anonymized_userid>",5,42606,2001,"Geert Wilders (PVV)",0.753221957040573,0.190209125475285,0
"<anonymized_userid>",5,42611,2002,"Geert Wilders (PVV)",0.753310350923716,0.190304182509506,0
"<anonymized_userid>",5,42616,2003,"Geert Wilders (PVV)",0.753398744806859,0.190399239543726,0
"<anonymized_userid>",5,42621,2004,"Geert Wilders (PVV)",0.753487138690003,0.190494296577947,0
"<anonymized_userid>",5,42626,2005,"Geert Wilders (PVV)",0.753575532573146,0.190589353612167,0
"<anonymized_userid>",5,42631,2006,"Geert Wilders (PVV)",0.753663926456289,0.190684410646388,0
"<anonymized_userid>",5,42636,2007,"Geert Wilders (PVV)",0.753752320339433,0.190779467680608,0
"<anonymized_userid>",5,42641,2008,"Geert Wilders (PVV)",0.753840714222576,0.190874524714829,0
"<anonymized_userid>",5,42646,2009,"Geert Wilders (PVV)",0.753929108105719,0.190969581749049,0
"<anonymized_userid>",5,42651,2010,"Geert Wilders (PVV)",0.754017501988862,0.19106463878327,0
"<anonymized_userid>",5,42656,2011,"Geert Wilders (PVV)",0.754105895872006,0.19115969581749,0
"<anonymized_userid>",5,42661,2012,"Geert Wilders (PVV)",0.754194289755149,0.191254752851711,0
"<anonymized_userid>",5,42666,2013,"Geert Wilders (PVV)",0.754282683638292,0.191349809885932,0
"<anonymized_userid>",5,42671,2014,"Geert Wilders (PVV)",0.754371077521436,0.191444866920152,0
"<anonymized_userid>",5,42676,2015,"Geert Wilders (PVV)",0.754459471404579,0.191539923954373,0
"<anonymized_userid>",5,42681,2016,"Geert Wilders (PVV)",0.754547865287722,0.191634980988593,0
"<anonymized_userid>",5,42686,2017,"Geert Wilders (PVV)",0.754636259170865,0.191730038022814,0
"<anonymized_userid>",5,42691,2018,"Geert Wilders (PVV)",0.754724653054009,0.191825095057034,0
"<anonymized_userid>",5,42696,2019,"Geert Wilders (PVV)",0.754813046937152,0.191920152091255,0
"<anonymized_userid>",5,42701,2020,"Geert Wilders (PVV)",0.754901440820295,0.192015209125475,0
"<anonymized_userid>",5,42706,2021,"Geert Wilders (PVV)",0.754989834703439,0.192110266159696,0
"<anonymized_userid>",5,42711,2022,"Geert Wilders (PVV)",0.755078228586582,0.192205323193916,0
"<anonymized_userid>",5,42716,2023,"Geert Wilders (PVV)",0.755166622469725,0.192300380228137,0
"<anonymized_userid>",5,42721,2024,"Geert Wilders (PVV)",0.755255016352868,0.192395437262357,0
"<anonymized_userid>",5,42726,2025,"Geert Wilders (PVV)",0.755343410236012,0.192490494296578,0
"<anonymized_userid>",5,42731,2026,"Geert Wilders (PVV)",0.755431804119155,0.192585551330798,0
"<anonymized_userid>",5,42736,2027,"Geert Wilders (PVV)",0.755520198002298,0.192680608365019,0
"<anonymized_userid>",5,42741,2028,"Geert Wilders (PVV)",0.755608591885441,0.19277566539924,0
"<anonymized_userid>",5,42746,2029,"Geert Wilders (PVV)",0.755696985768585,0.19287072243346,0
"<anonymized_userid>",5,42751,2030,"Geert Wilders (PVV)",0.755785379651728,0.192965779467681,0
"<anonymized_userid>",5,42756,2031,"Geert Wilders (PVV)",0.755873773534871,0.193060836501901,0
"<anonymized_userid>",5,42761,2032,"Geert Wilders (PVV)",0.755962167418015,0.193155893536122,0
"<anonymized_userid>",5,42766,2033,"Geert Wilders (PVV)",0.756050561301158,0.193250950570342,0
"<anonymized_userid>",5,42771,2034,"Geert Wilders (PVV)",0.756138955184301,0.193346007604563,0
"<anonymized_userid>",5,42776,2035,"Geert Wilders (PVV)",0.756227349067444,0.193441064638783,0
"<anonymized_userid>",5,42781,2036,"Geert Wilders (PVV)",0.756315742950588,0.193536121673004,0
"<anonymized_userid>",5,42786,2037,"Geert Wilders (PVV)",0.756404136833731,0.193631178707224,0
"<anonymized_userid>",5,42791,2038,"Geert Wilders (PVV)",0.756492530716874,0.193726235741445,0
"<anonymized_userid>",5,42796,2039,"Geert Wilders (PVV)",0.756580924600018,0.193821292775665,0
"<anonymized_userid>",5,42801,2040,"Geert Wilders (PVV)",0.756669318483161,0.193916349809886,0
"<anonymized_userid>",5,42806,2041,"Geert Wilders (PVV)",0.756757712366304,0.194011406844106,0
"<anonymized_userid>",5,42811,2042,"Geert Wilders (PVV)",0.756846106249448,0.194106463878327,0
"<anonymized_userid>",5,42816,2043,"Geert Wilders (PVV)",0.756934500132591,0.194201520912548,0
"<anonymized_userid>",5,42821,2044,"Geert Wilders (PVV)",0.757022894015734,0.194296577946768,0
"<anonymized_userid>",5,42826,2045,"Geert Wilders (PVV)",0.757111287898877,0.194391634980989,0
"<anonymized_userid>",5,42831,2046,"Geert Wilders (PVV)",0.757199681782021,0.194486692015209,0
"<anonymized_userid>",5,42836,2047,"Geert Wilders (PVV)",0.757288075665164,0.19458174904943,0
"<anonymized_userid>",5,42841,2048,"Geert Wilders (PVV)",0.757376469548307,0.19467680608365,0
"<anonymized_userid>",5,42846,2049,"Geert Wilders (PVV)",0.757464863431451,0.194771863117871,0
"<anonymized_userid>",5,42851,2050,"Geert Wilders (PVV)",0.757553257314594,0.194866920152091,0
"<anonymized_userid>",5,42856,2051,"Geert Wilders (PVV)",0.757641651197737,0.194961977186312,0
"<anonymized_userid>",5,42861,2052,"Geert Wilders (PVV)",0.75773004508088,0.195057034220532,0
"<anonymized_userid>",5,42866,2053,"Geert Wilders (PVV)",0.757818438964024,0.195152091254753,0
"<anonymized_userid>",5,42871,2054,"Geert Wilders (PVV)",0.757906832847167,0.195247148288973,0
"<anonymized_userid>",5,42876,2055,"Geert Wilders (PVV)",0.75799522673031,0.195342205323194,0
"<anonymized_userid>",5,42881,2056,"Geert Wilders (PVV)",0.758083620613454,0.195437262357414,0
"<anonymized_userid>",5,42886,2057,"Geert Wilders (PVV)",0.758172014496597,0.195532319391635,0
"<anonymized_userid>",5,42891,2058,"Geert Wilders (PVV)",0.75826040837974,0.195627376425856,0
"<anonymized_userid>",5,42896,2059,"Geert Wilders (PVV)",0.758348802262883,0.195722433460076,0
"<anonymized_userid>",5,42901,2060,"Geert Wilders (PVV)",0.758437196146027,0.195817490494297,0
"<anonymized_userid>",5,42906,2061,"Geert Wilders (PVV)",0.75852559002917,0.195912547528517,0
"<anonymized_userid>",5,42911,2062,"Geert Wilders (PVV)",0.758613983912313,0.196007604562738,0
"<anonymized_userid>",5,42916,2063,"Geert Wilders (PVV)",0.758702377795457,0.196102661596958,0
"<anonymized_userid>",5,42921,2064,"Geert Wilders (PVV)",0.7587907716786,0.196197718631179,0
"<anonymized_userid>",5,42926,2065,"Geert Wilders (PVV)",0.758879165561743,0.196292775665399,0
"<anonymized_userid>",5,42931,2066,"Geert Wilders (PVV)",0.758967559444886,0.19638783269962,0
"<anonymized_userid>",5,42936,2067,"Geert Wilders (PVV)",0.75905595332803,0.19648288973384,0
"<anonymized_userid>",5,42941,2068,"Geert Wilders (PVV)",0.759144347211173,0.196577946768061,0
"<anonymized_userid>",5,42946,2069,"Geert Wilders (PVV)",0.759232741094316,0.196673003802281,0
"<anonymized_userid>",5,42951,2070,"Geert Wilders (PVV)",0.75932113497746,0.196768060836502,0
"<anonymized_userid>",5,42956,2071,"Geert Wilders (PVV)",0.759409528860603,0.196863117870722,0
"<anonymized_userid>",5,42961,2072,"Geert Wilders (PVV)",0.759497922743746,0.196958174904943,0
"<anonymized_userid>",5,42966,2073,"Geert Wilders (PVV)",0.759586316626889,0.197053231939163,0
"<anonymized_userid>",5,42971,2074,"Geert Wilders (PVV)",0.759674710510033,0.197148288973384,0
"<anonymized_userid>",5,42976,2075,"Geert Wilders (PVV)",0.759763104393176,0.197243346007605,0
"<anonymized_userid>",5,42981,2076,"Geert Wilders (PVV)",0.759851498276319,0.197338403041825,0
"<anonymized_userid>",5,42986,2077,"Geert Wilders (PVV)",0.759939892159463,0.197433460076046,0
"<anonymized_userid>",5,42991,2078,"Geert Wilders (PVV)",0.760028286042606,0.197528517110266,0
"<anonymized_userid>",5,42996,2079,"Geert Wilders (PVV)",0.760116679925749,0.197623574144487,0
"<anonymized_userid>",5,43001,2080,"Geert Wilders (PVV)",0.760205073808892,0.197718631178707,0
"<anonymized_userid>",5,43006,2081,"Geert Wilders (PVV)",0.760293467692036,0.197813688212928,0
"<anonymized_userid>",5,43011,2082,"Geert Wilders (PVV)",0.760381861575179,0.197908745247148,0
"<anonymized_userid>",5,43016,2083,"Geert Wilders (PVV)",0.760470255458322,0.198003802281369,0
"<anonymized_userid>",5,43021,2084,"Geert Wilders (PVV)",0.760558649341466,0.198098859315589,0
"<anonymized_userid>",5,43026,2085,"Geert Wilders (PVV)",0.760647043224609,0.19819391634981,0
"<anonymized_userid>",5,43031,2086,"Geert Wilders (PVV)",0.760735437107752,0.19828897338403,0
"<anonymized_userid>",5,43036,2087,"Geert Wilders (PVV)",0.760823830990895,0.198384030418251,0
"<anonymized_userid>",5,43041,2088,"Geert Wilders (PVV)",0.760912224874039,0.198479087452471,0
"<anonymized_userid>",5,43046,2089,"Geert Wilders (PVV)",0.761000618757182,0.198574144486692,0
"<anonymized_userid>",5,43051,2090,"Geert Wilders (PVV)",0.761089012640325,0.198669201520913,0
"<anonymized_userid>",5,43056,2091,"Geert Wilders (PVV)",0.761177406523469,0.198764258555133,0
"<anonymized_userid>",5,43061,2092,"Geert Wilders (PVV)",0.761265800406612,0.198859315589354,0
"<anonymized_userid>",5,43066,2093,"Geert Wilders (PVV)",0.761354194289755,0.198954372623574,0
"<anonymized_userid>",5,43071,2094,"Geert Wilders (PVV)",0.761442588172898,0.199049429657795,0
"<anonymized_userid>",5,43076,2095,"Geert Wilders (PVV)",0.761530982056042,0.199144486692015,0
"<anonymized_userid>",5,43081,2096,"Geert Wilders (PVV)",0.761619375939185,0.199239543726236,0
"<anonymized_userid>",5,43086,2097,"Geert Wilders (PVV)",0.761707769822328,0.199334600760456,0
"<anonymized_userid>",5,43091,2098,"Geert Wilders (PVV)",0.761796163705472,0.199429657794677,0
"<anonymized_userid>",5,43096,2099,"Geert Wilders (PVV)",0.761884557588615,0.199524714828897,0
"<anonymized_userid>",5,43101,2100,"Geert Wilders (PVV)",0.761972951471758,0.199619771863118,0
"<anonymized_userid>",5,43106,2101,"Geert Wilders (PVV)",0.762061345354901,0.199714828897338,0
"<anonymized_userid>",5,43111,2102,"Geert Wilders (PVV)",0.762149739238045,0.199809885931559,0
"<anonymized_userid>",5,43116,2103,"Geert Wilders (PVV)",0.762238133121188,0.199904942965779,0
"<anonymized_userid>",5,43121,2104,"Geert Wilders (PVV)",0.762326527004331,0.2,0
"<anonymized_userid>",5,43126,2105,"Geert Wilders (PVV)",0.762414920887475,0.200095057034221,0
"<anonymized_userid>",5,43131,2106,"Geert Wilders (PVV)",0.762503314770618,0.200190114068441,0
"<anonymized_userid>",5,43136,2107,"Geert Wilders (PVV)",0.762591708653761,0.200285171102662,0
"<anonymized_userid>",5,43141,2108,"Geert Wilders (PVV)",0.762680102536904,0.200380228136882,0
"<anonymized_userid>",5,43146,2109,"Geert Wilders (PVV)",0.762768496420048,0.200475285171103,0
"<anonymized_userid>",5,43151,2110,"Geert Wilders (PVV)",0.762856890303191,0.200570342205323,0
"<anonymized_userid>",5,43156,2111,"Geert Wilders (PVV)",0.762945284186334,0.200665399239544,0
"<anonymized_userid>",5,43161,2112,"Geert Wilders (PVV)",0.763033678069478,0.200760456273764,0
"<anonymized_userid>",5,43166,2113,"Geert Wilders (PVV)",0.763122071952621,0.200855513307985,0
"<anonymized_userid>",5,43171,2114,"Geert Wilders (PVV)",0.763210465835764,0.200950570342205,0
"<anonymized_userid>",5,43176,2115,"Geert Wilders (PVV)",0.763298859718907,0.201045627376426,0
"<anonymized_userid>",5,43181,2116,"Geert Wilders (PVV)",0.763387253602051,0.201140684410646,0
"<anonymized_userid>",5,43186,2117,"Geert Wilders (PVV)",0.763475647485194,0.201235741444867,0
"<anonymized_userid>",5,43191,2118,"Geert Wilders (PVV)",0.763564041368337,0.201330798479087,0
"<anonymized_userid>",5,43196,2119,"Geert Wilders (PVV)",0.763652435251481,0.201425855513308,0
"<anonymized_userid>",5,43201,2120,"Geert Wilders (PVV)",0.763740829134624,0.201520912547529,0
"<anonymized_userid>",5,43206,2121,"Geert Wilders (PVV)",0.763829223017767,0.201615969581749,0
"<anonymized_userid>",5,43211,2122,"Geert Wilders (PVV)",0.76391761690091,0.20171102661597,0
"<anonymized_userid>",5,43216,2123,"Geert Wilders (PVV)",0.764006010784054,0.20180608365019,0
"<anonymized_userid>",5,43221,2124,"Geert Wilders (PVV)",0.764094404667197,0.201901140684411,0
"<anonymized_userid>",5,43226,2125,"Geert Wilders (PVV)",0.76418279855034,0.201996197718631,0
"<anonymized_userid>",5,43231,2126,"Geert Wilders (PVV)",0.764271192433484,0.202091254752852,0
"<anonymized_userid>",5,43236,2127,"Geert Wilders (PVV)",0.764359586316627,0.202186311787072,0
"<anonymized_userid>",5,43241,2128,"Geert Wilders (PVV)",0.76444798019977,0.202281368821293,0
"<anonymized_userid>",5,43246,2129,"Geert Wilders (PVV)",0.764536374082913,0.202376425855513,0
"<anonymized_userid>",5,43251,2130,"Geert Wilders (PVV)",0.764624767966057,0.202471482889734,0
"<anonymized_userid>",5,43256,2131,"Geert Wilders (PVV)",0.7647131618492,0.202566539923954,0
"<anonymized_userid>",5,43261,2132,"Geert Wilders (PVV)",0.764801555732343,0.202661596958175,0
"<anonymized_userid>",5,43266,2133,"Geert Wilders (PVV)",0.764889949615487,0.202756653992395,0
"<anonymized_userid>",5,43271,2134,"Geert Wilders (PVV)",0.76497834349863,0.202851711026616,0
"<anonymized_userid>",5,43276,2135,"Geert Wilders (PVV)",0.765066737381773,0.202946768060837,0
"<anonymized_userid>",5,43281,2136,"Geert Wilders (PVV)",0.765155131264917,0.203041825095057,0
"<anonymized_userid>",5,43286,2137,"Geert Wilders (PVV)",0.76524352514806,0.203136882129278,0
"<anonymized_userid>",5,43291,2138,"Geert Wilders (PVV)",0.765331919031203,0.203231939163498,0
"<anonymized_userid>",5,43296,2139,"Geert Wilders (PVV)",0.765420312914346,0.203326996197719,0
"<anonymized_userid>",5,43301,2140,"Geert Wilders (PVV)",0.76550870679749,0.203422053231939,0
"<anonymized_userid>",5,43306,2141,"Geert Wilders (PVV)",0.765597100680633,0.20351711026616,0
"<anonymized_userid>",5,43311,2142,"Geert Wilders (PVV)",0.765685494563776,0.20361216730038,0
"<anonymized_userid>",5,43316,2143,"Geert Wilders (PVV)",0.76577388844692,0.203707224334601,0
"<anonymized_userid>",5,43321,2144,"Geert Wilders (PVV)",0.765862282330063,0.203802281368821,0
"<anonymized_userid>",5,43326,2145,"Geert Wilders (PVV)",0.765950676213206,0.203897338403042,0
"<anonymized_userid>",5,43331,2146,"Geert Wilders (PVV)",0.766039070096349,0.203992395437262,0
"<anonymized_userid>",5,43336,2147,"Geert Wilders (PVV)",0.766127463979493,0.204087452471483,0
"<anonymized_userid>",5,43341,2148,"Geert Wilders (PVV)",0.766215857862636,0.204182509505703,0
"<anonymized_userid>",5,43346,2149,"Geert Wilders (PVV)",0.766304251745779,0.204277566539924,0
"<anonymized_userid>",5,43351,2150,"Geert Wilders (PVV)",0.766392645628923,0.204372623574144,0
"<anonymized_userid>",5,43356,2151,"Geert Wilders (PVV)",0.766481039512066,0.204467680608365,0
"<anonymized_userid>",5,43361,2152,"Geert Wilders (PVV)",0.766569433395209,0.204562737642586,0
"<anonymized_userid>",5,43366,2153,"Geert Wilders (PVV)",0.766657827278352,0.204657794676806,0
"<anonymized_userid>",5,43371,2154,"Geert Wilders (PVV)",0.766746221161496,0.204752851711027,0
"<anonymized_userid>",5,43376,2155,"Geert Wilders (PVV)",0.766834615044639,0.204847908745247,0
"<anonymized_userid>",5,43381,2156,"Geert Wilders (PVV)",0.766923008927782,0.204942965779468,0
"<anonymized_userid>",5,43386,2157,"Geert Wilders (PVV)",0.767011402810926,0.205038022813688,0
"<anonymized_userid>",5,43391,2158,"Geert Wilders (PVV)",0.767099796694069,0.205133079847909,0
"<anonymized_userid>",5,43396,2159,"Geert Wilders (PVV)",0.767188190577212,0.205228136882129,0
"<anonymized_userid>",5,43401,2160,"Geert Wilders (PVV)",0.767276584460355,0.20532319391635,0
"<anonymized_userid>",5,43406,2161,"Geert Wilders (PVV)",0.767364978343499,0.20541825095057,0
"<anonymized_userid>",5,43411,2162,"Geert Wilders (PVV)",0.767453372226642,0.205513307984791,0
"<anonymized_userid>",5,43416,2163,"Geert Wilders (PVV)",0.767541766109785,0.205608365019011,0
"<anonymized_userid>",5,43421,2164,"Geert Wilders (PVV)",0.767630159992928,0.205703422053232,0
"<anonymized_userid>",5,43426,2165,"Geert Wilders (PVV)",0.767718553876072,0.205798479087452,0
"<anonymized_userid>",5,43431,2166,"Geert Wilders (PVV)",0.767806947759215,0.205893536121673,0
"<anonymized_userid>",5,43436,2167,"Geert Wilders (PVV)",0.767895341642358,0.205988593155894,0
"<anonymized_userid>",5,43441,2168,"Geert Wilders (PVV)",0.767983735525502,0.206083650190114,0
"<anonymized_userid>",5,43446,2169,"Geert Wilders (PVV)",0.768072129408645,0.206178707224335,0
"<anonymized_userid>",5,43451,2170,"Geert Wilders (PVV)",0.768160523291788,0.206273764258555,0
"<anonymized_userid>",5,43456,2171,"Geert Wilders (PVV)",0.768248917174931,0.206368821292776,0
"<anonymized_userid>",5,43461,2172,"Geert Wilders (PVV)",0.768337311058075,0.206463878326996,0
"<anonymized_userid>",5,43466,2173,"Geert Wilders (PVV)",0.768425704941218,0.206558935361217,0
"<anonymized_userid>",5,43471,2174,"Geert Wilders (PVV)",0.768514098824361,0.206653992395437,0
"<anonymized_userid>",5,43476,2175,"Geert Wilders (PVV)",0.768602492707505,0.206749049429658,0
"<anonymized_userid>",5,43481,2176,"Geert Wilders (PVV)",0.768690886590648,0.206844106463878,0
"<anonymized_userid>",5,43486,2177,"Geert Wilders (PVV)",0.768779280473791,0.206939163498099,0
"<anonymized_userid>",5,43491,2178,"Geert Wilders (PVV)",0.768867674356934,0.207034220532319,0
"<anonymized_userid>",5,43496,2179,"Geert Wilders (PVV)",0.768956068240078,0.20712927756654,0
"<anonymized_userid>",5,43501,2180,"Geert Wilders (PVV)",0.769044462123221,0.20722433460076,0
"<anonymized_userid>",5,43506,2181,"Geert Wilders (PVV)",0.769132856006364,0.207319391634981,0
"<anonymized_userid>",5,43511,2182,"Geert Wilders (PVV)",0.769221249889508,0.207414448669202,0
"<anonymized_userid>",5,43516,2183,"Geert Wilders (PVV)",0.769309643772651,0.207509505703422,0
"<anonymized_userid>",5,43521,2184,"Geert Wilders (PVV)",0.769398037655794,0.207604562737643,0
"<anonymized_userid>",5,43526,2185,"Geert Wilders (PVV)",0.769486431538937,0.207699619771863,0
"<anonymized_userid>",5,43531,2186,"Geert Wilders (PVV)",0.769574825422081,0.207794676806084,0
"<anonymized_userid>",5,43536,2187,"Geert Wilders (PVV)",0.769663219305224,0.207889733840304,0
"<anonymized_userid>",5,43541,2188,"Geert Wilders (PVV)",0.769751613188367,0.207984790874525,0
"<anonymized_userid>",5,43546,2189,"Geert Wilders (PVV)",0.769840007071511,0.208079847908745,0
"<anonymized_userid>",5,43551,2190,"Geert Wilders (PVV)",0.769928400954654,0.208174904942966,0
"<anonymized_userid>",5,43556,2191,"Geert Wilders (PVV)",0.770016794837797,0.208269961977186,0
"<anonymized_userid>",5,43561,2192,"Geert Wilders (PVV)",0.77010518872094,0.208365019011407,0
"<anonymized_userid>",5,43566,2193,"Geert Wilders (PVV)",0.770193582604084,0.208460076045627,0
"<anonymized_userid>",5,43571,2194,"Geert Wilders (PVV)",0.770281976487227,0.208555133079848,0
"<anonymized_userid>",5,43576,2195,"Geert Wilders (PVV)",0.77037037037037,0.208650190114068,0
"<anonymized_userid>",5,43581,2196,"Geert Wilders (PVV)",0.770458764253514,0.208745247148289,0
"<anonymized_userid>",5,43586,2197,"Geert Wilders (PVV)",0.770547158136657,0.20884030418251,0
"<anonymized_userid>",5,43591,2198,"Geert Wilders (PVV)",0.7706355520198,0.20893536121673,0
"<anonymized_userid>",5,43596,2199,"Geert Wilders (PVV)",0.770723945902943,0.209030418250951,0
"<anonymized_userid>",5,43601,2200,"Geert Wilders (PVV)",0.770812339786087,0.209125475285171,0
"<anonymized_userid>",5,43606,2201,"Geert Wilders (PVV)",0.77090073366923,0.209220532319392,0
"<anonymized_userid>",5,43611,2202,"Geert Wilders (PVV)",0.770989127552373,0.209315589353612,0
"<anonymized_userid>",5,43616,2203,"Geert Wilders (PVV)",0.771077521435517,0.209410646387833,0
"<anonymized_userid>",5,43621,2204,"Geert Wilders (PVV)",0.77116591531866,0.209505703422053,0
"<anonymized_userid>",5,43626,2205,"Geert Wilders (PVV)",0.771254309201803,0.209600760456274,0
"<anonymized_userid>",5,43631,2206,"Geert Wilders (PVV)",0.771342703084947,0.209695817490494,0
"<anonymized_userid>",5,43636,2207,"Geert Wilders (PVV)",0.77143109696809,0.209790874524715,0
"<anonymized_userid>",5,43641,2208,"Geert Wilders (PVV)",0.771519490851233,0.209885931558935,0
"<anonymized_userid>",5,43646,2209,"Geert Wilders (PVV)",0.771607884734376,0.209980988593156,0
"<anonymized_userid>",5,43651,2210,"Geert Wilders (PVV)",0.77169627861752,0.210076045627376,0
"<anonymized_userid>",5,43656,2211,"Geert Wilders (PVV)",0.771784672500663,0.210171102661597,0
"<anonymized_userid>",5,43661,2212,"Geert Wilders (PVV)",0.771873066383806,0.210266159695817,0
"<anonymized_userid>",5,43666,2213,"Geert Wilders (PVV)",0.77196146026695,0.210361216730038,0
"<anonymized_userid>",5,43671,2214,"Geert Wilders (PVV)",0.772049854150093,0.210456273764259,0
"<anonymized_userid>",5,43676,2215,"Geert Wilders (PVV)",0.772138248033236,0.210551330798479,0
"<anonymized_userid>",5,43681,2216,"Geert Wilders (PVV)",0.772226641916379,0.2106463878327,0
"<anonymized_userid>",5,43686,2217,"Geert Wilders (PVV)",0.772315035799523,0.21074144486692,0
"<anonymized_userid>",5,43691,2218,"Geert Wilders (PVV)",0.772403429682666,0.210836501901141,0
"<anonymized_userid>",5,43696,2219,"Geert Wilders (PVV)",0.772491823565809,0.210931558935361,0
"<anonymized_userid>",5,43701,2220,"Geert Wilders (PVV)",0.772580217448953,0.211026615969582,0
"<anonymized_userid>",5,43706,2221,"Geert Wilders (PVV)",0.772668611332096,0.211121673003802,0
"<anonymized_userid>",5,43711,2222,"Geert Wilders (PVV)",0.772757005215239,0.211216730038023,0
"<anonymized_userid>",5,43716,2223,"Geert Wilders (PVV)",0.772845399098382,0.211311787072243,0
"<anonymized_userid>",5,43721,2224,"Geert Wilders (PVV)",0.772933792981526,0.211406844106464,0
"<anonymized_userid>",5,43726,2225,"Geert Wilders (PVV)",0.773022186864669,0.211501901140684,0
"<anonymized_userid>",5,43731,2226,"Geert Wilders (PVV)",0.773110580747812,0.211596958174905,0
"<anonymized_userid>",5,43736,2227,"Geert Wilders (PVV)",0.773198974630956,0.211692015209125,0
"<anonymized_userid>",5,43741,2228,"Geert Wilders (PVV)",0.773287368514099,0.211787072243346,0
"<anonymized_userid>",5,43746,2229,"Geert Wilders (PVV)",0.773375762397242,0.211882129277567,0
"<anonymized_userid>",5,43751,2230,"Geert Wilders (PVV)",0.773464156280385,0.211977186311787,0
"<anonymized_userid>",5,43756,2231,"Geert Wilders (PVV)",0.773552550163529,0.212072243346008,0
"<anonymized_userid>",5,43761,2232,"Geert Wilders (PVV)",0.773640944046672,0.212167300380228,0
"<anonymized_userid>",5,43766,2233,"Geert Wilders (PVV)",0.773729337929815,0.212262357414449,0
"<anonymized_userid>",5,43771,2234,"Geert Wilders (PVV)",0.773817731812959,0.212357414448669,0
"<anonymized_userid>",5,43776,2235,"Geert Wilders (PVV)",0.773906125696102,0.21245247148289,0
"<anonymized_userid>",5,43781,2236,"Geert Wilders (PVV)",0.773994519579245,0.21254752851711,0
"<anonymized_userid>",5,43786,2237,"Geert Wilders (PVV)",0.774082913462388,0.212642585551331,0
"<anonymized_userid>",5,43791,2238,"Geert Wilders (PVV)",0.774171307345532,0.212737642585551,0
"<anonymized_userid>",5,43796,2239,"Geert Wilders (PVV)",0.774259701228675,0.212832699619772,0
"<anonymized_userid>",5,43801,2240,"Geert Wilders (PVV)",0.774348095111818,0.212927756653992,0
"<anonymized_userid>",5,43806,2241,"Geert Wilders (PVV)",0.774436488994962,0.213022813688213,0
"<anonymized_userid>",5,43811,2242,"Geert Wilders (PVV)",0.774524882878105,0.213117870722433,0
"<anonymized_userid>",5,43816,2243,"Geert Wilders (PVV)",0.774613276761248,0.213212927756654,0
"<anonymized_userid>",5,43821,2244,"Geert Wilders (PVV)",0.774701670644391,0.213307984790875,0
"<anonymized_userid>",5,43826,2245,"Geert Wilders (PVV)",0.774790064527535,0.213403041825095,0
"<anonymized_userid>",5,43831,2246,"Geert Wilders (PVV)",0.774878458410678,0.213498098859316,0
"<anonymized_userid>",5,43836,2247,"Geert Wilders (PVV)",0.774966852293821,0.213593155893536,0
"<anonymized_userid>",5,43841,2248,"Geert Wilders (PVV)",0.775055246176965,0.213688212927757,0
"<anonymized_userid>",5,43846,2249,"Geert Wilders (PVV)",0.775143640060108,0.213783269961977,0
"<anonymized_userid>",5,43851,2250,"Geert Wilders (PVV)",0.775232033943251,0.213878326996198,0
"<anonymized_userid>",5,43856,2251,"Geert Wilders (PVV)",0.775320427826394,0.213973384030418,0
"<anonymized_userid>",5,43861,2252,"Geert Wilders (PVV)",0.775408821709538,0.214068441064639,0
"<anonymized_userid>",5,43866,2253,"Geert Wilders (PVV)",0.775497215592681,0.214163498098859,0
"<anonymized_userid>",5,43871,2254,"Geert Wilders (PVV)",0.775585609475824,0.21425855513308,0
"<anonymized_userid>",5,43876,2255,"Geert Wilders (PVV)",0.775674003358968,0.2143536121673,0
"<anonymized_userid>",5,43881,2256,"Geert Wilders (PVV)",0.775762397242111,0.214448669201521,0
"<anonymized_userid>",5,43886,2257,"Geert Wilders (PVV)",0.775850791125254,0.214543726235741,0
"<anonymized_userid>",5,43891,2258,"Geert Wilders (PVV)",0.775939185008397,0.214638783269962,0
"<anonymized_userid>",5,43896,2259,"Geert Wilders (PVV)",0.776027578891541,0.214733840304183,0
"<anonymized_userid>",5,43901,2260,"Geert Wilders (PVV)",0.776115972774684,0.214828897338403,0
"<anonymized_userid>",5,43906,2261,"Geert Wilders (PVV)",0.776204366657827,0.214923954372624,0
"<anonymized_userid>",5,43911,2262,"Geert Wilders (PVV)",0.776292760540971,0.215019011406844,0
"<anonymized_userid>",5,43916,2263,"Geert Wilders (PVV)",0.776381154424114,0.215114068441065,0
"<anonymized_userid>",5,43921,2264,"Geert Wilders (PVV)",0.776469548307257,0.215209125475285,0
"<anonymized_userid>",5,43926,2265,"Geert Wilders (PVV)",0.7765579421904,0.215304182509506,0
"<anonymized_userid>",5,43931,2266,"Geert Wilders (PVV)",0.776646336073544,0.215399239543726,0
"<anonymized_userid>",5,43936,2267,"Geert Wilders (PVV)",0.776734729956687,0.215494296577947,0
"<anonymized_userid>",5,43941,2268,"Geert Wilders (PVV)",0.77682312383983,0.215589353612167,0
"<anonymized_userid>",5,43946,2269,"Geert Wilders (PVV)",0.776911517722974,0.215684410646388,0
"<anonymized_userid>",5,43951,2270,"Geert Wilders (PVV)",0.776999911606117,0.215779467680608,0
"<anonymized_userid>",5,43956,2271,"Geert Wilders (PVV)",0.77708830548926,0.215874524714829,0
"<anonymized_userid>",5,43961,2272,"Geert Wilders (PVV)",0.777176699372403,0.215969581749049,0
"<anonymized_userid>",5,43966,2273,"Geert Wilders (PVV)",0.777265093255547,0.21606463878327,0
"<anonymized_userid>",5,43971,2274,"Geert Wilders (PVV)",0.77735348713869,0.216159695817491,0
"<anonymized_userid>",5,43976,2275,"Geert Wilders (PVV)",0.777441881021833,0.216254752851711,0
"<anonymized_userid>",5,43981,2276,"Geert Wilders (PVV)",0.777530274904977,0.216349809885932,0
"<anonymized_userid>",5,43986,2277,"Geert Wilders (PVV)",0.77761866878812,0.216444866920152,0
"<anonymized_userid>",5,43991,2278,"Geert Wilders (PVV)",0.777707062671263,0.216539923954373,0
"<anonymized_userid>",5,43996,2279,"Geert Wilders (PVV)",0.777795456554406,0.216634980988593,0
"<anonymized_userid>",5,44001,2280,"Geert Wilders (PVV)",0.77788385043755,0.216730038022814,0
"<anonymized_userid>",5,44006,2281,"Geert Wilders (PVV)",0.777972244320693,0.216825095057034,0
"<anonymized_userid>",5,44011,2282,"Geert Wilders (PVV)",0.778060638203836,0.216920152091255,0
"<anonymized_userid>",5,44016,2283,"Geert Wilders (PVV)",0.77814903208698,0.217015209125475,0
"<anonymized_userid>",5,44021,2284,"Geert Wilders (PVV)",0.778237425970123,0.217110266159696,0
"<anonymized_userid>",5,44026,2285,"Geert Wilders (PVV)",0.778325819853266,0.217205323193916,0
"<anonymized_userid>",5,44031,2286,"Geert Wilders (PVV)",0.778414213736409,0.217300380228137,0
"<anonymized_userid>",5,44036,2287,"Geert Wilders (PVV)",0.778502607619553,0.217395437262357,0
"<anonymized_userid>",5,44041,2288,"Geert Wilders (PVV)",0.778591001502696,0.217490494296578,0
"<anonymized_userid>",5,44046,2289,"Geert Wilders (PVV)",0.778679395385839,0.217585551330798,0
"<anonymized_userid>",5,44051,2290,"Geert Wilders (PVV)",0.778767789268983,0.217680608365019,0
"<anonymized_userid>",5,44056,2291,"Geert Wilders (PVV)",0.778856183152126,0.21777566539924,0
"<anonymized_userid>",5,44061,2292,"Geert Wilders (PVV)",0.778944577035269,0.21787072243346,0
"<anonymized_userid>",5,44066,2293,"Geert Wilders (PVV)",0.779032970918412,0.217965779467681,0
"<anonymized_userid>",5,44071,2294,"Geert Wilders (PVV)",0.779121364801556,0.218060836501901,0
"<anonymized_userid>",5,44076,2295,"Geert Wilders (PVV)",0.779209758684699,0.218155893536122,0
"<anonymized_userid>",5,44081,2296,"Geert Wilders (PVV)",0.779298152567842,0.218250950570342,0
"<anonymized_userid>",5,44086,2297,"Geert Wilders (PVV)",0.779386546450986,0.218346007604563,0
"<anonymized_userid>",5,44091,2298,"Geert Wilders (PVV)",0.779474940334129,0.218441064638783,0
"<anonymized_userid>",5,44096,2299,"Geert Wilders (PVV)",0.779563334217272,0.218536121673004,0
"<anonymized_userid>",5,44101,2300,"Geert Wilders (PVV)",0.779651728100415,0.218631178707224,0
"<anonymized_userid>",5,44106,2301,"Geert Wilders (PVV)",0.779740121983559,0.218726235741445,0
"<anonymized_userid>",5,44111,2302,"Geert Wilders (PVV)",0.779828515866702,0.218821292775665,0
"<anonymized_userid>",5,44116,2303,"Geert Wilders (PVV)",0.779916909749845,0.218916349809886,0
"<anonymized_userid>",5,44121,2304,"Geert Wilders (PVV)",0.780005303632989,0.219011406844106,0
"<anonymized_userid>",5,44126,2305,"Geert Wilders (PVV)",0.780093697516132,0.219106463878327,0
"<anonymized_userid>",5,44131,2306,"Geert Wilders (PVV)",0.780182091399275,0.219201520912548,0
"<anonymized_userid>",5,44136,2307,"Geert Wilders (PVV)",0.780270485282418,0.219296577946768,0
"<anonymized_userid>",5,44141,2308,"Geert Wilders (PVV)",0.780358879165562,0.219391634980989,0
"<anonymized_userid>",5,44146,2309,"Geert Wilders (PVV)",0.780447273048705,0.219486692015209,0
"<anonymized_userid>",5,44151,2310,"Geert Wilders (PVV)",0.780535666931848,0.21958174904943,0
"<anonymized_userid>",5,44156,2311,"Geert Wilders (PVV)",0.780624060814992,0.21967680608365,0
"<anonymized_userid>",5,44161,2312,"Geert Wilders (PVV)",0.780712454698135,0.219771863117871,0
"<anonymized_userid>",5,44166,2313,"Geert Wilders (PVV)",0.780800848581278,0.219866920152091,0
"<anonymized_userid>",5,44171,2314,"Geert Wilders (PVV)",0.780889242464421,0.219961977186312,0
"<anonymized_userid>",5,44176,2315,"Geert Wilders (PVV)",0.780977636347565,0.220057034220532,0
"<anonymized_userid>",5,44181,2316,"Geert Wilders (PVV)",0.781066030230708,0.220152091254753,0
"<anonymized_userid>",5,44186,2317,"Geert Wilders (PVV)",0.781154424113851,0.220247148288973,0
"<anonymized_userid>",4,44190,2318,"Geert Wilders (PVV)",0.781225139220366,0.220342205323194,0
"<anonymized_userid>",4,44194,2319,"Geert Wilders (PVV)",0.781295854326881,0.220437262357414,0
"<anonymized_userid>",4,44198,2320,"Geert Wilders (PVV)",0.781366569433395,0.220532319391635,0
"<anonymized_userid>",4,44202,2321,"Geert Wilders (PVV)",0.78143728453991,0.220627376425856,0
"<anonymized_userid>",4,44206,2322,"Geert Wilders (PVV)",0.781507999646424,0.220722433460076,0
"<anonymized_userid>",4,44210,2323,"Geert Wilders (PVV)",0.781578714752939,0.220817490494297,0
"<anonymized_userid>",4,44214,2324,"Geert Wilders (PVV)",0.781649429859454,0.220912547528517,0
"<anonymized_userid>",4,44218,2325,"Geert Wilders (PVV)",0.781720144965968,0.221007604562738,0
"<anonymized_userid>",4,44222,2326,"Geert Wilders (PVV)",0.781790860072483,0.221102661596958,0
"<anonymized_userid>",4,44226,2327,"Geert Wilders (PVV)",0.781861575178998,0.221197718631179,0
"<anonymized_userid>",4,44230,2328,"Geert Wilders (PVV)",0.781932290285512,0.221292775665399,0
"<anonymized_userid>",4,44234,2329,"Geert Wilders (PVV)",0.782003005392027,0.22138783269962,0
"<anonymized_userid>",4,44238,2330,"Geert Wilders (PVV)",0.782073720498542,0.22148288973384,0
"<anonymized_userid>",4,44242,2331,"Geert Wilders (PVV)",0.782144435605056,0.221577946768061,0
"<anonymized_userid>",4,44246,2332,"Geert Wilders (PVV)",0.782215150711571,0.221673003802281,0
"<anonymized_userid>",4,44250,2333,"Geert Wilders (PVV)",0.782285865818085,0.221768060836502,0
"<anonymized_userid>",4,44254,2334,"Geert Wilders (PVV)",0.7823565809246,0.221863117870722,0
"<anonymized_userid>",4,44258,2335,"Geert Wilders (PVV)",0.782427296031115,0.221958174904943,0
"<anonymized_userid>",4,44262,2336,"Geert Wilders (PVV)",0.782498011137629,0.222053231939163,0
"<anonymized_userid>",4,44266,2337,"Geert Wilders (PVV)",0.782568726244144,0.222148288973384,0
"<anonymized_userid>",4,44270,2338,"Geert Wilders (PVV)",0.782639441350659,0.222243346007605,0
"<anonymized_userid>",4,44274,2339,"Geert Wilders (PVV)",0.782710156457173,0.222338403041825,0
"<anonymized_userid>",4,44278,2340,"Geert Wilders (PVV)",0.782780871563688,0.222433460076046,0
"<anonymized_userid>",4,44282,2341,"Geert Wilders (PVV)",0.782851586670202,0.222528517110266,0
"<anonymized_userid>",4,44286,2342,"Geert Wilders (PVV)",0.782922301776717,0.222623574144487,0
"<anonymized_userid>",4,44290,2343,"Geert Wilders (PVV)",0.782993016883232,0.222718631178707,0
"<anonymized_userid>",4,44294,2344,"Geert Wilders (PVV)",0.783063731989746,0.222813688212928,0
"<anonymized_userid>",4,44298,2345,"Geert Wilders (PVV)",0.783134447096261,0.222908745247148,0
"<anonymized_userid>",4,44302,2346,"Geert Wilders (PVV)",0.783205162202776,0.223003802281369,0
"<anonymized_userid>",4,44306,2347,"Geert Wilders (PVV)",0.78327587730929,0.223098859315589,0
"<anonymized_userid>",4,44310,2348,"Geert Wilders (PVV)",0.783346592415805,0.22319391634981,0
"<anonymized_userid>",4,44314,2349,"Geert Wilders (PVV)",0.783417307522319,0.22328897338403,0
"<anonymized_userid>",4,44318,2350,"Geert Wilders (PVV)",0.783488022628834,0.223384030418251,0
"<anonymized_userid>",4,44322,2351,"Geert Wilders (PVV)",0.783558737735349,0.223479087452471,0
"<anonymized_userid>",4,44326,2352,"Geert Wilders (PVV)",0.783629452841863,0.223574144486692,0
"<anonymized_userid>",4,44330,2353,"Geert Wilders (PVV)",0.783700167948378,0.223669201520913,0
"<anonymized_userid>",4,44334,2354,"Geert Wilders (PVV)",0.783770883054893,0.223764258555133,0
"<anonymized_userid>",4,44338,2355,"Geert Wilders (PVV)",0.783841598161407,0.223859315589354,0
"<anonymized_userid>",4,44342,2356,"Geert Wilders (PVV)",0.783912313267922,0.223954372623574,0
"<anonymized_userid>",4,44346,2357,"Geert Wilders (PVV)",0.783983028374436,0.224049429657795,0
"<anonymized_userid>",4,44350,2358,"Geert Wilders (PVV)",0.784053743480951,0.224144486692015,0
"<anonymized_userid>",4,44354,2359,"Geert Wilders (PVV)",0.784124458587466,0.224239543726236,0
"<anonymized_userid>",4,44358,2360,"Geert Wilders (PVV)",0.78419517369398,0.224334600760456,0
"<anonymized_userid>",4,44362,2361,"Geert Wilders (PVV)",0.784265888800495,0.224429657794677,0
"<anonymized_userid>",4,44366,2362,"Geert Wilders (PVV)",0.78433660390701,0.224524714828897,0
"<anonymized_userid>",4,44370,2363,"Geert Wilders (PVV)",0.784407319013524,0.224619771863118,0
"<anonymized_userid>",4,44374,2364,"Geert Wilders (PVV)",0.784478034120039,0.224714828897338,0
"<anonymized_userid>",4,44378,2365,"Geert Wilders (PVV)",0.784548749226553,0.224809885931559,0
"<anonymized_userid>",4,44382,2366,"Geert Wilders (PVV)",0.784619464333068,0.224904942965779,0
"<anonymized_userid>",4,44386,2367,"Geert Wilders (PVV)",0.784690179439583,0.225,0
"<anonymized_userid>",4,44390,2368,"Geert Wilders (PVV)",0.784760894546097,0.225095057034221,0
"<anonymized_userid>",4,44394,2369,"Geert Wilders (PVV)",0.784831609652612,0.225190114068441,0
"<anonymized_userid>",4,44398,2370,"Geert Wilders (PVV)",0.784902324759127,0.225285171102662,0
"<anonymized_userid>",4,44402,2371,"Geert Wilders (PVV)",0.784973039865641,0.225380228136882,0
"<anonymized_userid>",4,44406,2372,"Geert Wilders (PVV)",0.785043754972156,0.225475285171103,0
"<anonymized_userid>",4,44410,2373,"Geert Wilders (PVV)",0.785114470078671,0.225570342205323,0
"<anonymized_userid>",4,44414,2374,"Geert Wilders (PVV)",0.785185185185185,0.225665399239544,0
"<anonymized_userid>",4,44418,2375,"Geert Wilders (PVV)",0.7852559002917,0.225760456273764,0
"<anonymized_userid>",4,44422,2376,"Geert Wilders (PVV)",0.785326615398214,0.225855513307985,0
"<anonymized_userid>",4,44426,2377,"Geert Wilders (PVV)",0.785397330504729,0.225950570342205,0
"<anonymized_userid>",4,44430,2378,"Geert Wilders (PVV)",0.785468045611244,0.226045627376426,0
"<anonymized_userid>",4,44434,2379,"Geert Wilders (PVV)",0.785538760717758,0.226140684410646,0
"<anonymized_userid>",4,44438,2380,"Geert Wilders (PVV)",0.785609475824273,0.226235741444867,0
"<anonymized_userid>",4,44442,2381,"Geert Wilders (PVV)",0.785680190930788,0.226330798479087,0
"<anonymized_userid>",4,44446,2382,"Geert Wilders (PVV)",0.785750906037302,0.226425855513308,0
"<anonymized_userid>",4,44450,2383,"Geert Wilders (PVV)",0.785821621143817,0.226520912547529,0
"<anonymized_userid>",4,44454,2384,"Geert Wilders (PVV)",0.785892336250332,0.226615969581749,0
"<anonymized_userid>",4,44458,2385,"Geert Wilders (PVV)",0.785963051356846,0.22671102661597,0
"<anonymized_userid>",4,44462,2386,"Geert Wilders (PVV)",0.786033766463361,0.22680608365019,0
"<anonymized_userid>",4,44466,2387,"Geert Wilders (PVV)",0.786104481569875,0.226901140684411,0
"<anonymized_userid>",4,44470,2388,"Geert Wilders (PVV)",0.78617519667639,0.226996197718631,0
"<anonymized_userid>",4,44474,2389,"Geert Wilders (PVV)",0.786245911782905,0.227091254752852,0
"<anonymized_userid>",4,44478,2390,"Geert Wilders (PVV)",0.786316626889419,0.227186311787072,0
"<anonymized_userid>",4,44482,2391,"Geert Wilders (PVV)",0.786387341995934,0.227281368821293,0
"<anonymized_userid>",4,44486,2392,"Geert Wilders (PVV)",0.786458057102449,0.227376425855513,0
"<anonymized_userid>",4,44490,2393,"Geert Wilders (PVV)",0.786528772208963,0.227471482889734,0
"<anonymized_userid>",4,44494,2394,"Geert Wilders (PVV)",0.786599487315478,0.227566539923954,0
"<anonymized_userid>",4,44498,2395,"Geert Wilders (PVV)",0.786670202421992,0.227661596958175,0
"<anonymized_userid>",4,44502,2396,"Geert Wilders (PVV)",0.786740917528507,0.227756653992395,0
"<anonymized_userid>",4,44506,2397,"Geert Wilders (PVV)",0.786811632635022,0.227851711026616,0
"<anonymized_userid>",4,44510,2398,"Geert Wilders (PVV)",0.786882347741536,0.227946768060836,0
"<anonymized_userid>",4,44514,2399,"Geert Wilders (PVV)",0.786953062848051,0.228041825095057,0
"<anonymized_userid>",4,44518,2400,"Geert Wilders (PVV)",0.787023777954566,0.228136882129278,0
"<anonymized_userid>",4,44522,2401,"Geert Wilders (PVV)",0.78709449306108,0.228231939163498,0
"<anonymized_userid>",4,44526,2402,"Geert Wilders (PVV)",0.787165208167595,0.228326996197719,0
"<anonymized_userid>",4,44530,2403,"Geert Wilders (PVV)",0.787235923274109,0.228422053231939,0
"<anonymized_userid>",4,44534,2404,"Geert Wilders (PVV)",0.787306638380624,0.22851711026616,0
"<anonymized_userid>",4,44538,2405,"Geert Wilders (PVV)",0.787377353487139,0.22861216730038,0
"<anonymized_userid>",4,44542,2406,"Geert Wilders (PVV)",0.787448068593653,0.228707224334601,0
"<anonymized_userid>",4,44546,2407,"Geert Wilders (PVV)",0.787518783700168,0.228802281368821,0
"<anonymized_userid>",4,44550,2408,"Geert Wilders (PVV)",0.787589498806683,0.228897338403042,0
"<anonymized_userid>",4,44554,2409,"Geert Wilders (PVV)",0.787660213913197,0.228992395437262,0
"<anonymized_userid>",4,44558,2410,"Geert Wilders (PVV)",0.787730929019712,0.229087452471483,0
"<anonymized_userid>",4,44562,2411,"Geert Wilders (PVV)",0.787801644126226,0.229182509505703,0
"<anonymized_userid>",4,44566,2412,"Geert Wilders (PVV)",0.787872359232741,0.229277566539924,0
"<anonymized_userid>",4,44570,2413,"Geert Wilders (PVV)",0.787943074339256,0.229372623574144,0
"<anonymized_userid>",4,44574,2414,"Geert Wilders (PVV)",0.78801378944577,0.229467680608365,0
"<anonymized_userid>",4,44578,2415,"Geert Wilders (PVV)",0.788084504552285,0.229562737642586,0
"<anonymized_userid>",4,44582,2416,"Geert Wilders (PVV)",0.7881552196588,0.229657794676806,0
"<anonymized_userid>",4,44586,2417,"Geert Wilders (PVV)",0.788225934765314,0.229752851711027,0
"<anonymized_userid>",4,44590,2418,"Geert Wilders (PVV)",0.788296649871829,0.229847908745247,0
"<anonymized_userid>",4,44594,2419,"Geert Wilders (PVV)",0.788367364978343,0.229942965779468,0
"<anonymized_userid>",4,44598,2420,"Geert Wilders (PVV)",0.788438080084858,0.230038022813688,0
"<anonymized_userid>",4,44602,2421,"Geert Wilders (PVV)",0.788508795191373,0.230133079847909,0
"<anonymized_userid>",4,44606,2422,"Geert Wilders (PVV)",0.788579510297887,0.230228136882129,0
"<anonymized_userid>",4,44610,2423,"Geert Wilders (PVV)",0.788650225404402,0.23032319391635,0
"<anonymized_userid>",4,44614,2424,"Geert Wilders (PVV)",0.788720940510917,0.23041825095057,0
"<anonymized_userid>",4,44618,2425,"Geert Wilders (PVV)",0.788791655617431,0.230513307984791,0
"<anonymized_userid>",4,44622,2426,"Geert Wilders (PVV)",0.788862370723946,0.230608365019011,0
"<anonymized_userid>",4,44626,2427,"Geert Wilders (PVV)",0.788933085830461,0.230703422053232,0
"<anonymized_userid>",4,44630,2428,"Geert Wilders (PVV)",0.789003800936975,0.230798479087452,0
"<anonymized_userid>",4,44634,2429,"Geert Wilders (PVV)",0.78907451604349,0.230893536121673,0
"<anonymized_userid>",4,44638,2430,"Geert Wilders (PVV)",0.789145231150004,0.230988593155894,0
"<anonymized_userid>",4,44642,2431,"Geert Wilders (PVV)",0.789215946256519,0.231083650190114,0
"<anonymized_userid>",4,44646,2432,"Geert Wilders (PVV)",0.789286661363034,0.231178707224335,0
"<anonymized_userid>",4,44650,2433,"Geert Wilders (PVV)",0.789357376469548,0.231273764258555,0
"<anonymized_userid>",4,44654,2434,"Geert Wilders (PVV)",0.789428091576063,0.231368821292776,0
"<anonymized_userid>",4,44658,2435,"Geert Wilders (PVV)",0.789498806682578,0.231463878326996,0
"<anonymized_userid>",4,44662,2436,"Geert Wilders (PVV)",0.789569521789092,0.231558935361217,0
"<anonymized_userid>",4,44666,2437,"Geert Wilders (PVV)",0.789640236895607,0.231653992395437,0
"<anonymized_userid>",4,44670,2438,"Geert Wilders (PVV)",0.789710952002121,0.231749049429658,0
"<anonymized_userid>",4,44674,2439,"Geert Wilders (PVV)",0.789781667108636,0.231844106463878,0
"<anonymized_userid>",4,44678,2440,"Geert Wilders (PVV)",0.789852382215151,0.231939163498099,0
"<anonymized_userid>",4,44682,2441,"Geert Wilders (PVV)",0.789923097321665,0.232034220532319,0
"<anonymized_userid>",4,44686,2442,"Geert Wilders (PVV)",0.78999381242818,0.23212927756654,0
"<anonymized_userid>",4,44690,2443,"Geert Wilders (PVV)",0.790064527534695,0.23222433460076,0
"<anonymized_userid>",4,44694,2444,"Geert Wilders (PVV)",0.790135242641209,0.232319391634981,0
"<anonymized_userid>",4,44698,2445,"Geert Wilders (PVV)",0.790205957747724,0.232414448669202,0
"<anonymized_userid>",4,44702,2446,"Geert Wilders (PVV)",0.790276672854239,0.232509505703422,0
"<anonymized_userid>",4,44706,2447,"Geert Wilders (PVV)",0.790347387960753,0.232604562737643,0
"<anonymized_userid>",4,44710,2448,"Geert Wilders (PVV)",0.790418103067268,0.232699619771863,0
"<anonymized_userid>",4,44714,2449,"Geert Wilders (PVV)",0.790488818173782,0.232794676806084,0
"<anonymized_userid>",4,44718,2450,"Geert Wilders (PVV)",0.790559533280297,0.232889733840304,0
"<anonymized_userid>",4,44722,2451,"Geert Wilders (PVV)",0.790630248386812,0.232984790874525,0
"<anonymized_userid>",4,44726,2452,"Geert Wilders (PVV)",0.790700963493326,0.233079847908745,0
"<anonymized_userid>",4,44730,2453,"Geert Wilders (PVV)",0.790771678599841,0.233174904942966,0
"<anonymized_userid>",4,44734,2454,"Geert Wilders (PVV)",0.790842393706356,0.233269961977186,0
"<anonymized_userid>",4,44738,2455,"Geert Wilders (PVV)",0.79091310881287,0.233365019011407,0
"<anonymized_userid>",4,44742,2456,"Geert Wilders (PVV)",0.790983823919385,0.233460076045627,0
"<anonymized_userid>",4,44746,2457,"Geert Wilders (PVV)",0.791054539025899,0.233555133079848,0
"<anonymized_userid>",4,44750,2458,"Geert Wilders (PVV)",0.791125254132414,0.233650190114068,0
"<anonymized_userid>",4,44754,2459,"Geert Wilders (PVV)",0.791195969238929,0.233745247148289,0
"<anonymized_userid>",4,44758,2460,"Geert Wilders (PVV)",0.791266684345443,0.23384030418251,0
"<anonymized_userid>",4,44762,2461,"Geert Wilders (PVV)",0.791337399451958,0.23393536121673,0
"<anonymized_userid>",4,44766,2462,"Geert Wilders (PVV)",0.791408114558473,0.234030418250951,0
"<anonymized_userid>",4,44770,2463,"Geert Wilders (PVV)",0.791478829664987,0.234125475285171,0
"<anonymized_userid>",4,44774,2464,"Geert Wilders (PVV)",0.791549544771502,0.234220532319392,0
"<anonymized_userid>",4,44778,2465,"Geert Wilders (PVV)",0.791620259878016,0.234315589353612,0
"<anonymized_userid>",4,44782,2466,"Geert Wilders (PVV)",0.791690974984531,0.234410646387833,0
"<anonymized_userid>",4,44786,2467,"Geert Wilders (PVV)",0.791761690091046,0.234505703422053,0
"<anonymized_userid>",4,44790,2468,"Geert Wilders (PVV)",0.79183240519756,0.234600760456274,0
"<anonymized_userid>",4,44794,2469,"Geert Wilders (PVV)",0.791903120304075,0.234695817490494,0
"<anonymized_userid>",4,44798,2470,"Geert Wilders (PVV)",0.79197383541059,0.234790874524715,0
"<anonymized_userid>",4,44802,2471,"Geert Wilders (PVV)",0.792044550517104,0.234885931558935,0
"<anonymized_userid>",4,44806,2472,"Geert Wilders (PVV)",0.792115265623619,0.234980988593156,0
"<anonymized_userid>",4,44810,2473,"Geert Wilders (PVV)",0.792185980730133,0.235076045627376,0
"<anonymized_userid>",4,44814,2474,"Geert Wilders (PVV)",0.792256695836648,0.235171102661597,0
"<anonymized_userid>",4,44818,2475,"Geert Wilders (PVV)",0.792327410943163,0.235266159695817,0
"<anonymized_userid>",4,44822,2476,"Geert Wilders (PVV)",0.792398126049677,0.235361216730038,0
"<anonymized_userid>",4,44826,2477,"Geert Wilders (PVV)",0.792468841156192,0.235456273764259,0
"<anonymized_userid>",4,44830,2478,"Geert Wilders (PVV)",0.792539556262707,0.235551330798479,0
"<anonymized_userid>",4,44834,2479,"Geert Wilders (PVV)",0.792610271369221,0.2356463878327,0
"<anonymized_userid>",4,44838,2480,"Geert Wilders (PVV)",0.792680986475736,0.23574144486692,0
"<anonymized_userid>",4,44842,2481,"Geert Wilders (PVV)",0.792751701582251,0.235836501901141,0
"<anonymized_userid>",4,44846,2482,"Geert Wilders (PVV)",0.792822416688765,0.235931558935361,0
"<anonymized_userid>",4,44850,2483,"Geert Wilders (PVV)",0.79289313179528,0.236026615969582,0
"<anonymized_userid>",4,44854,2484,"Geert Wilders (PVV)",0.792963846901794,0.236121673003802,0
"<anonymized_userid>",4,44858,2485,"Geert Wilders (PVV)",0.793034562008309,0.236216730038023,0
"<anonymized_userid>",4,44862,2486,"Geert Wilders (PVV)",0.793105277114824,0.236311787072243,0
"<anonymized_userid>",4,44866,2487,"Geert Wilders (PVV)",0.793175992221338,0.236406844106464,0
"<anonymized_userid>",4,44870,2488,"Geert Wilders (PVV)",0.793246707327853,0.236501901140684,0
"<anonymized_userid>",4,44874,2489,"Geert Wilders (PVV)",0.793317422434368,0.236596958174905,0
"<anonymized_userid>",4,44878,2490,"Geert Wilders (PVV)",0.793388137540882,0.236692015209125,0
"<anonymized_userid>",4,44882,2491,"Geert Wilders (PVV)",0.793458852647397,0.236787072243346,0
"<anonymized_userid>",4,44886,2492,"Geert Wilders (PVV)",0.793529567753911,0.236882129277567,0
"<anonymized_userid>",4,44890,2493,"Geert Wilders (PVV)",0.793600282860426,0.236977186311787,0
"<anonymized_userid>",4,44894,2494,"Geert Wilders (PVV)",0.793670997966941,0.237072243346008,0
"<anonymized_userid>",4,44898,2495,"Geert Wilders (PVV)",0.793741713073455,0.237167300380228,0
"<anonymized_userid>",4,44902,2496,"Geert Wilders (PVV)",0.79381242817997,0.237262357414449,0
"<anonymized_userid>",4,44906,2497,"Geert Wilders (PVV)",0.793883143286485,0.237357414448669,0
"<anonymized_userid>",4,44910,2498,"Geert Wilders (PVV)",0.793953858392999,0.23745247148289,0
"<anonymized_userid>",4,44914,2499,"Geert Wilders (PVV)",0.794024573499514,0.23754752851711,0
"<anonymized_userid>",4,44918,2500,"Geert Wilders (PVV)",0.794095288606029,0.237642585551331,0
"<anonymized_userid>",4,44922,2501,"Geert Wilders (PVV)",0.794166003712543,0.237737642585551,0
"<anonymized_userid>",4,44926,2502,"Geert Wilders (PVV)",0.794236718819058,0.237832699619772,0
"<anonymized_userid>",4,44930,2503,"Geert Wilders (PVV)",0.794307433925572,0.237927756653992,0
"<anonymized_userid>",4,44934,2504,"Geert Wilders (PVV)",0.794378149032087,0.238022813688213,0
"<anonymized_userid>",4,44938,2505,"Geert Wilders (PVV)",0.794448864138602,0.238117870722433,0
"<anonymized_userid>",4,44942,2506,"Geert Wilders (PVV)",0.794519579245116,0.238212927756654,0
"<anonymized_userid>",4,44946,2507,"Geert Wilders (PVV)",0.794590294351631,0.238307984790875,0
"<anonymized_userid>",4,44950,2508,"Geert Wilders (PVV)",0.794661009458146,0.238403041825095,0
"<anonymized_userid>",4,44954,2509,"Geert Wilders (PVV)",0.79473172456466,0.238498098859316,0
"<anonymized_userid>",4,44958,2510,"Geert Wilders (PVV)",0.794802439671175,0.238593155893536,0
"<anonymized_userid>",4,44962,2511,"Geert Wilders (PVV)",0.794873154777689,0.238688212927757,0
"<anonymized_userid>",4,44966,2512,"Geert Wilders (PVV)",0.794943869884204,0.238783269961977,0
"<anonymized_userid>",4,44970,2513,"Geert Wilders (PVV)",0.795014584990719,0.238878326996198,0
"<anonymized_userid>",4,44974,2514,"Geert Wilders (PVV)",0.795085300097233,0.238973384030418,0
"<anonymized_userid>",4,44978,2515,"Geert Wilders (PVV)",0.795156015203748,0.239068441064639,0
"<anonymized_userid>",4,44982,2516,"Geert Wilders (PVV)",0.795226730310262,0.239163498098859,0
"<anonymized_userid>",4,44986,2517,"Geert Wilders (PVV)",0.795297445416777,0.23925855513308,0
"<anonymized_userid>",4,44990,2518,"Geert Wilders (PVV)",0.795368160523292,0.2393536121673,0
"<anonymized_userid>",4,44994,2519,"Geert Wilders (PVV)",0.795438875629806,0.239448669201521,0
"<anonymized_userid>",4,44998,2520,"Geert Wilders (PVV)",0.795509590736321,0.239543726235741,0
"<anonymized_userid>",4,45002,2521,"Geert Wilders (PVV)",0.795580305842836,0.239638783269962,0
"<anonymized_userid>",4,45006,2522,"Geert Wilders (PVV)",0.79565102094935,0.239733840304183,0
"<anonymized_userid>",4,45010,2523,"Geert Wilders (PVV)",0.795721736055865,0.239828897338403,0
"<anonymized_userid>",4,45014,2524,"Geert Wilders (PVV)",0.79579245116238,0.239923954372624,0
"<anonymized_userid>",4,45018,2525,"Geert Wilders (PVV)",0.795863166268894,0.240019011406844,0
"<anonymized_userid>",4,45022,2526,"Geert Wilders (PVV)",0.795933881375409,0.240114068441065,0
"<anonymized_userid>",4,45026,2527,"Geert Wilders (PVV)",0.796004596481923,0.240209125475285,0
"<anonymized_userid>",4,45030,2528,"Geert Wilders (PVV)",0.796075311588438,0.240304182509506,0
"<anonymized_userid>",4,45034,2529,"Geert Wilders (PVV)",0.796146026694953,0.240399239543726,0
"<anonymized_userid>",4,45038,2530,"Geert Wilders (PVV)",0.796216741801467,0.240494296577947,0
"<anonymized_userid>",4,45042,2531,"Geert Wilders (PVV)",0.796287456907982,0.240589353612167,0
"<anonymized_userid>",4,45046,2532,"Geert Wilders (PVV)",0.796358172014497,0.240684410646388,0
"<anonymized_userid>",4,45050,2533,"Geert Wilders (PVV)",0.796428887121011,0.240779467680608,0
"<anonymized_userid>",4,45054,2534,"Geert Wilders (PVV)",0.796499602227526,0.240874524714829,0
"<anonymized_userid>",4,45058,2535,"Geert Wilders (PVV)",0.79657031733404,0.240969581749049,0
"<anonymized_userid>",4,45062,2536,"Geert Wilders (PVV)",0.796641032440555,0.24106463878327,0
"<anonymized_userid>",4,45066,2537,"Geert Wilders (PVV)",0.79671174754707,0.24115969581749,0
"<anonymized_userid>",4,45070,2538,"Geert Wilders (PVV)",0.796782462653584,0.241254752851711,0
"<anonymized_userid>",4,45074,2539,"Geert Wilders (PVV)",0.796853177760099,0.241349809885932,0
"<anonymized_userid>",4,45078,2540,"Geert Wilders (PVV)",0.796923892866614,0.241444866920152,0
"<anonymized_userid>",4,45082,2541,"Geert Wilders (PVV)",0.796994607973128,0.241539923954373,0
"<anonymized_userid>",4,45086,2542,"Geert Wilders (PVV)",0.797065323079643,0.241634980988593,0
"<anonymized_userid>",4,45090,2543,"Geert Wilders (PVV)",0.797136038186158,0.241730038022814,0
"<anonymized_userid>",4,45094,2544,"Geert Wilders (PVV)",0.797206753292672,0.241825095057034,0
"<anonymized_userid>",4,45098,2545,"Geert Wilders (PVV)",0.797277468399187,0.241920152091255,0
"<anonymized_userid>",4,45102,2546,"Geert Wilders (PVV)",0.797348183505701,0.242015209125475,0
"<anonymized_userid>",4,45106,2547,"Geert Wilders (PVV)",0.797418898612216,0.242110266159696,0
"<anonymized_userid>",4,45110,2548,"Geert Wilders (PVV)",0.797489613718731,0.242205323193916,0
"<anonymized_userid>",4,45114,2549,"Geert Wilders (PVV)",0.797560328825245,0.242300380228137,0
"<anonymized_userid>",4,45118,2550,"Geert Wilders (PVV)",0.79763104393176,0.242395437262357,0
"<anonymized_userid>",4,45122,2551,"Geert Wilders (PVV)",0.797701759038275,0.242490494296578,0
"<anonymized_userid>",4,45126,2552,"Geert Wilders (PVV)",0.797772474144789,0.242585551330798,0
"<anonymized_userid>",4,45130,2553,"Geert Wilders (PVV)",0.797843189251304,0.242680608365019,0
"<anonymized_userid>",4,45134,2554,"Geert Wilders (PVV)",0.797913904357818,0.24277566539924,0
"<anonymized_userid>",4,45138,2555,"Geert Wilders (PVV)",0.797984619464333,0.24287072243346,0
"<anonymized_userid>",4,45142,2556,"Geert Wilders (PVV)",0.798055334570848,0.242965779467681,0
"<anonymized_userid>",4,45146,2557,"Geert Wilders (PVV)",0.798126049677362,0.243060836501901,0
"<anonymized_userid>",4,45150,2558,"Geert Wilders (PVV)",0.798196764783877,0.243155893536122,0
"<anonymized_userid>",4,45154,2559,"Geert Wilders (PVV)",0.798267479890392,0.243250950570342,0
"<anonymized_userid>",4,45158,2560,"Geert Wilders (PVV)",0.798338194996906,0.243346007604563,0
"<anonymized_userid>",4,45162,2561,"Geert Wilders (PVV)",0.798408910103421,0.243441064638783,0
"<anonymized_userid>",4,45166,2562,"Geert Wilders (PVV)",0.798479625209935,0.243536121673004,0
"<anonymized_userid>",4,45170,2563,"Geert Wilders (PVV)",0.79855034031645,0.243631178707224,0
"<anonymized_userid>",4,45174,2564,"Geert Wilders (PVV)",0.798621055422965,0.243726235741445,0
"<anonymized_userid>",4,45178,2565,"Geert Wilders (PVV)",0.798691770529479,0.243821292775665,0
"<anonymized_userid>",4,45182,2566,"Geert Wilders (PVV)",0.798762485635994,0.243916349809886,0
"<anonymized_userid>",4,45186,2567,"Geert Wilders (PVV)",0.798833200742509,0.244011406844106,0
"<anonymized_userid>",4,45190,2568,"Geert Wilders (PVV)",0.798903915849023,0.244106463878327,0
"<anonymized_userid>",4,45194,2569,"Geert Wilders (PVV)",0.798974630955538,0.244201520912548,0
"<anonymized_userid>",4,45198,2570,"Geert Wilders (PVV)",0.799045346062052,0.244296577946768,0
"<anonymized_userid>",4,45202,2571,"Geert Wilders (PVV)",0.799116061168567,0.244391634980989,0
"<anonymized_userid>",4,45206,2572,"Geert Wilders (PVV)",0.799186776275082,0.244486692015209,0
"<anonymized_userid>",4,45210,2573,"Geert Wilders (PVV)",0.799257491381596,0.24458174904943,0
"<anonymized_userid>",4,45214,2574,"Geert Wilders (PVV)",0.799328206488111,0.24467680608365,0
"<anonymized_userid>",4,45218,2575,"Geert Wilders (PVV)",0.799398921594626,0.244771863117871,0
"<anonymized_userid>",4,45222,2576,"Geert Wilders (PVV)",0.79946963670114,0.244866920152091,0
"<anonymized_userid>",4,45226,2577,"Geert Wilders (PVV)",0.799540351807655,0.244961977186312,0
"<anonymized_userid>",4,45230,2578,"Geert Wilders (PVV)",0.799611066914169,0.245057034220532,0
"<anonymized_userid>",4,45234,2579,"Geert Wilders (PVV)",0.799681782020684,0.245152091254753,0
"<anonymized_userid>",4,45238,2580,"Geert Wilders (PVV)",0.799752497127199,0.245247148288973,0
"<anonymized_userid>",4,45242,2581,"Geert Wilders (PVV)",0.799823212233713,0.245342205323194,0
"<anonymized_userid>",4,45246,2582,"Geert Wilders (PVV)",0.799893927340228,0.245437262357414,0
"<anonymized_userid>",4,45250,2583,"Geert Wilders (PVV)",0.799964642446743,0.245532319391635,0
"<anonymized_userid>",4,45254,2584,"Geert Wilders (PVV)",0.800035357553257,0.245627376425856,0
"<anonymized_userid>",4,45258,2585,"Geert Wilders (PVV)",0.800106072659772,0.245722433460076,0
"<anonymized_userid>",4,45262,2586,"Geert Wilders (PVV)",0.800176787766287,0.245817490494297,0
"<anonymized_userid>",4,45266,2587,"Geert Wilders (PVV)",0.800247502872801,0.245912547528517,0
"<anonymized_userid>",4,45270,2588,"Geert Wilders (PVV)",0.800318217979316,0.246007604562738,0
"<anonymized_userid>",4,45274,2589,"Geert Wilders (PVV)",0.80038893308583,0.246102661596958,0
"<anonymized_userid>",4,45278,2590,"Geert Wilders (PVV)",0.800459648192345,0.246197718631179,0
"<anonymized_userid>",4,45282,2591,"Geert Wilders (PVV)",0.80053036329886,0.246292775665399,0
"<anonymized_userid>",4,45286,2592,"Geert Wilders (PVV)",0.800601078405374,0.24638783269962,0
"<anonymized_userid>",4,45290,2593,"Geert Wilders (PVV)",0.800671793511889,0.24648288973384,0
"<anonymized_userid>",4,45294,2594,"Geert Wilders (PVV)",0.800742508618404,0.246577946768061,0
"<anonymized_userid>",4,45298,2595,"Geert Wilders (PVV)",0.800813223724918,0.246673003802281,0
"<anonymized_userid>",4,45302,2596,"Geert Wilders (PVV)",0.800883938831433,0.246768060836502,0
"<anonymized_userid>",4,45306,2597,"Geert Wilders (PVV)",0.800954653937948,0.246863117870722,0
"<anonymized_userid>",4,45310,2598,"Geert Wilders (PVV)",0.801025369044462,0.246958174904943,0
"<anonymized_userid>",4,45314,2599,"Geert Wilders (PVV)",0.801096084150977,0.247053231939164,0
"<anonymized_userid>",4,45318,2600,"Geert Wilders (PVV)",0.801166799257491,0.247148288973384,0
"<anonymized_userid>",4,45322,2601,"Geert Wilders (PVV)",0.801237514364006,0.247243346007605,0
"<anonymized_userid>",4,45326,2602,"Geert Wilders (PVV)",0.801308229470521,0.247338403041825,0
"<anonymized_userid>",4,45330,2603,"Geert Wilders (PVV)",0.801378944577035,0.247433460076046,0
"<anonymized_userid>",4,45334,2604,"Geert Wilders (PVV)",0.80144965968355,0.247528517110266,0
"<anonymized_userid>",4,45338,2605,"Geert Wilders (PVV)",0.801520374790065,0.247623574144487,0
"<anonymized_userid>",4,45342,2606,"Geert Wilders (PVV)",0.801591089896579,0.247718631178707,0
"<anonymized_userid>",4,45346,2607,"Geert Wilders (PVV)",0.801661805003094,0.247813688212928,0
"<anonymized_userid>",4,45350,2608,"Geert Wilders (PVV)",0.801732520109608,0.247908745247148,0
"<anonymized_userid>",4,45354,2609,"Geert Wilders (PVV)",0.801803235216123,0.248003802281369,0
"<anonymized_userid>",4,45358,2610,"Geert Wilders (PVV)",0.801873950322638,0.248098859315589,0
"<anonymized_userid>",4,45362,2611,"Geert Wilders (PVV)",0.801944665429152,0.24819391634981,0
"<anonymized_userid>",4,45366,2612,"Geert Wilders (PVV)",0.802015380535667,0.24828897338403,0
"<anonymized_userid>",4,45370,2613,"Geert Wilders (PVV)",0.802086095642182,0.248384030418251,0
"<anonymized_userid>",4,45374,2614,"Geert Wilders (PVV)",0.802156810748696,0.248479087452471,0
"<anonymized_userid>",4,45378,2615,"Geert Wilders (PVV)",0.802227525855211,0.248574144486692,0
"<anonymized_userid>",4,45382,2616,"Geert Wilders (PVV)",0.802298240961725,0.248669201520913,0
"<anonymized_userid>",4,45386,2617,"Geert Wilders (PVV)",0.80236895606824,0.248764258555133,0
"<anonymized_userid>",4,45390,2618,"Geert Wilders (PVV)",0.802439671174755,0.248859315589354,0
"<anonymized_userid>",4,45394,2619,"Geert Wilders (PVV)",0.802510386281269,0.248954372623574,0
"<anonymized_userid>",4,45398,2620,"Geert Wilders (PVV)",0.802581101387784,0.249049429657795,0
"<anonymized_userid>",4,45402,2621,"Geert Wilders (PVV)",0.802651816494299,0.249144486692015,0
"<anonymized_userid>",4,45406,2622,"Geert Wilders (PVV)",0.802722531600813,0.249239543726236,0
"<anonymized_userid>",4,45410,2623,"Geert Wilders (PVV)",0.802793246707328,0.249334600760456,0
"<anonymized_userid>",4,45414,2624,"Geert Wilders (PVV)",0.802863961813842,0.249429657794677,0
"<anonymized_userid>",4,45418,2625,"Geert Wilders (PVV)",0.802934676920357,0.249524714828897,0
"<anonymized_userid>",4,45422,2626,"Geert Wilders (PVV)",0.803005392026872,0.249619771863118,0
"<anonymized_userid>",4,45426,2627,"Geert Wilders (PVV)",0.803076107133386,0.249714828897338,0
"<anonymized_userid>",4,45430,2628,"Geert Wilders (PVV)",0.803146822239901,0.249809885931559,0
"<anonymized_userid>",4,45434,2629,"Geert Wilders (PVV)",0.803217537346416,0.249904942965779,0
"<anonymized_userid>",4,45438,2630,"Geert Wilders (PVV)",0.80328825245293,0.25,0
"<anonymized_userid>",4,45442,2631,"Geert Wilders (PVV)",0.803358967559445,0.250095057034221,1
"<anonymized_userid>",4,45446,2632,"Geert Wilders (PVV)",0.803429682665959,0.250190114068441,0
"<anonymized_userid>",4,45450,2633,"Geert Wilders (PVV)",0.803500397772474,0.250285171102662,0
"<anonymized_userid>",4,45454,2634,"Geert Wilders (PVV)",0.803571112878989,0.250380228136882,0
"<anonymized_userid>",4,45458,2635,"Geert Wilders (PVV)",0.803641827985503,0.250475285171103,0
"<anonymized_userid>",4,45462,2636,"Geert Wilders (PVV)",0.803712543092018,0.250570342205323,0
"<anonymized_userid>",4,45466,2637,"Geert Wilders (PVV)",0.803783258198533,0.250665399239544,0
"<anonymized_userid>",4,45470,2638,"Geert Wilders (PVV)",0.803853973305047,0.250760456273764,0
"<anonymized_userid>",4,45474,2639,"Geert Wilders (PVV)",0.803924688411562,0.250855513307985,0
"<anonymized_userid>",4,45478,2640,"Geert Wilders (PVV)",0.803995403518077,0.250950570342205,0
"<anonymized_userid>",4,45482,2641,"Geert Wilders (PVV)",0.804066118624591,0.251045627376426,0
"<anonymized_userid>",4,45486,2642,"Geert Wilders (PVV)",0.804136833731106,0.251140684410646,0
"<anonymized_userid>",4,45490,2643,"Geert Wilders (PVV)",0.80420754883762,0.251235741444867,0
"<anonymized_userid>",4,45494,2644,"Geert Wilders (PVV)",0.804278263944135,0.251330798479087,0
"<anonymized_userid>",4,45498,2645,"Geert Wilders (PVV)",0.80434897905065,0.251425855513308,0
"<anonymized_userid>",4,45502,2646,"Geert Wilders (PVV)",0.804419694157164,0.251520912547529,0
"<anonymized_userid>",4,45506,2647,"Geert Wilders (PVV)",0.804490409263679,0.251615969581749,0
"<anonymized_userid>",4,45510,2648,"Geert Wilders (PVV)",0.804561124370194,0.25171102661597,0
"<anonymized_userid>",4,45514,2649,"Geert Wilders (PVV)",0.804631839476708,0.25180608365019,0
"<anonymized_userid>",4,45518,2650,"Geert Wilders (PVV)",0.804702554583223,0.251901140684411,0
"<anonymized_userid>",4,45522,2651,"Geert Wilders (PVV)",0.804773269689738,0.251996197718631,0
"<anonymized_userid>",4,45526,2652,"Geert Wilders (PVV)",0.804843984796252,0.252091254752852,0
"<anonymized_userid>",4,45530,2653,"Geert Wilders (PVV)",0.804914699902767,0.252186311787072,0
"<anonymized_userid>",4,45534,2654,"Geert Wilders (PVV)",0.804985415009281,0.252281368821293,0
"<anonymized_userid>",4,45538,2655,"Geert Wilders (PVV)",0.805056130115796,0.252376425855513,0
"<anonymized_userid>",4,45542,2656,"Geert Wilders (PVV)",0.805126845222311,0.252471482889734,0
"<anonymized_userid>",4,45546,2657,"Geert Wilders (PVV)",0.805197560328825,0.252566539923954,0
"<anonymized_userid>",4,45550,2658,"Geert Wilders (PVV)",0.80526827543534,0.252661596958175,0
"<anonymized_userid>",4,45554,2659,"Geert Wilders (PVV)",0.805338990541855,0.252756653992395,0
"<anonymized_userid>",4,45558,2660,"Geert Wilders (PVV)",0.805409705648369,0.252851711026616,0
"<anonymized_userid>",4,45562,2661,"Geert Wilders (PVV)",0.805480420754884,0.252946768060836,0
"<anonymized_userid>",4,45566,2662,"Geert Wilders (PVV)",0.805551135861398,0.253041825095057,0
"<anonymized_userid>",4,45570,2663,"Geert Wilders (PVV)",0.805621850967913,0.253136882129278,0
"<anonymized_userid>",4,45574,2664,"Geert Wilders (PVV)",0.805692566074428,0.253231939163498,0
"<anonymized_userid>",4,45578,2665,"Geert Wilders (PVV)",0.805763281180942,0.253326996197719,0
"<anonymized_userid>",4,45582,2666,"Geert Wilders (PVV)",0.805833996287457,0.253422053231939,0
"<anonymized_userid>",4,45586,2667,"Geert Wilders (PVV)",0.805904711393972,0.25351711026616,0
"<anonymized_userid>",4,45590,2668,"Geert Wilders (PVV)",0.805975426500486,0.25361216730038,0
"<anonymized_userid>",4,45594,2669,"Geert Wilders (PVV)",0.806046141607001,0.253707224334601,0
"<anonymized_userid>",4,45598,2670,"Geert Wilders (PVV)",0.806116856713515,0.253802281368821,0
"<anonymized_userid>",4,45602,2671,"Geert Wilders (PVV)",0.80618757182003,0.253897338403042,0
"<anonymized_userid>",4,45606,2672,"Geert Wilders (PVV)",0.806258286926545,0.253992395437262,0
"<anonymized_userid>",4,45610,2673,"Geert Wilders (PVV)",0.806329002033059,0.254087452471483,0
"<anonymized_userid>",4,45614,2674,"Geert Wilders (PVV)",0.806399717139574,0.254182509505703,0
"<anonymized_userid>",4,45618,2675,"Geert Wilders (PVV)",0.806470432246089,0.254277566539924,0
"<anonymized_userid>",4,45622,2676,"Geert Wilders (PVV)",0.806541147352603,0.254372623574144,0
"<anonymized_userid>",4,45626,2677,"Geert Wilders (PVV)",0.806611862459118,0.254467680608365,0
"<anonymized_userid>",4,45630,2678,"Geert Wilders (PVV)",0.806682577565632,0.254562737642586,0
"<anonymized_userid>",4,45634,2679,"Geert Wilders (PVV)",0.806753292672147,0.254657794676806,0
"<anonymized_userid>",4,45638,2680,"Geert Wilders (PVV)",0.806824007778662,0.254752851711027,0
"<anonymized_userid>",4,45642,2681,"Geert Wilders (PVV)",0.806894722885176,0.254847908745247,0
"<anonymized_userid>",4,45646,2682,"Geert Wilders (PVV)",0.806965437991691,0.254942965779468,0
"<anonymized_userid>",4,45650,2683,"Geert Wilders (PVV)",0.807036153098206,0.255038022813688,0
"<anonymized_userid>",4,45654,2684,"Geert Wilders (PVV)",0.80710686820472,0.255133079847909,0
"<anonymized_userid>",4,45658,2685,"Geert Wilders (PVV)",0.807177583311235,0.255228136882129,0
"<anonymized_userid>",4,45662,2686,"Geert Wilders (PVV)",0.807248298417749,0.25532319391635,0
"<anonymized_userid>",4,45666,2687,"Geert Wilders (PVV)",0.807319013524264,0.25541825095057,0
"<anonymized_userid>",4,45670,2688,"Geert Wilders (PVV)",0.807389728630779,0.255513307984791,0
"<anonymized_userid>",4,45674,2689,"Geert Wilders (PVV)",0.807460443737293,0.255608365019011,0
"<anonymized_userid>",4,45678,2690,"Geert Wilders (PVV)",0.807531158843808,0.255703422053232,0
"<anonymized_userid>",4,45682,2691,"Geert Wilders (PVV)",0.807601873950323,0.255798479087452,0
"<anonymized_userid>",4,45686,2692,"Geert Wilders (PVV)",0.807672589056837,0.255893536121673,0
"<anonymized_userid>",4,45690,2693,"Geert Wilders (PVV)",0.807743304163352,0.255988593155894,0
"<anonymized_userid>",4,45694,2694,"Geert Wilders (PVV)",0.807814019269867,0.256083650190114,0
"<anonymized_userid>",4,45698,2695,"Geert Wilders (PVV)",0.807884734376381,0.256178707224335,0
"<anonymized_userid>",4,45702,2696,"Geert Wilders (PVV)",0.807955449482896,0.256273764258555,0
"<anonymized_userid>",4,45706,2697,"Geert Wilders (PVV)",0.80802616458941,0.256368821292776,0
"<anonymized_userid>",4,45710,2698,"Geert Wilders (PVV)",0.808096879695925,0.256463878326996,0
"<anonymized_userid>",4,45714,2699,"Geert Wilders (PVV)",0.80816759480244,0.256558935361217,0
"<anonymized_userid>",4,45718,2700,"Geert Wilders (PVV)",0.808238309908954,0.256653992395437,0
"<anonymized_userid>",4,45722,2701,"Geert Wilders (PVV)",0.808309025015469,0.256749049429658,0
"<anonymized_userid>",4,45726,2702,"Geert Wilders (PVV)",0.808379740121984,0.256844106463878,0
"<anonymized_userid>",4,45730,2703,"Geert Wilders (PVV)",0.808450455228498,0.256939163498099,0
"<anonymized_userid>",4,45734,2704,"Geert Wilders (PVV)",0.808521170335013,0.257034220532319,0
"<anonymized_userid>",4,45738,2705,"Geert Wilders (PVV)",0.808591885441527,0.25712927756654,0
"<anonymized_userid>",4,45742,2706,"Geert Wilders (PVV)",0.808662600548042,0.25722433460076,0
"<anonymized_userid>",4,45746,2707,"Geert Wilders (PVV)",0.808733315654557,0.257319391634981,0
"<anonymized_userid>",4,45750,2708,"Geert Wilders (PVV)",0.808804030761071,0.257414448669202,0
"<anonymized_userid>",4,45754,2709,"Geert Wilders (PVV)",0.808874745867586,0.257509505703422,0
"<anonymized_userid>",4,45758,2710,"Geert Wilders (PVV)",0.808945460974101,0.257604562737643,0
"<anonymized_userid>",4,45762,2711,"Geert Wilders (PVV)",0.809016176080615,0.257699619771863,0
"<anonymized_userid>",4,45766,2712,"Geert Wilders (PVV)",0.80908689118713,0.257794676806084,0
"<anonymized_userid>",4,45770,2713,"Geert Wilders (PVV)",0.809157606293645,0.257889733840304,0
"<anonymized_userid>",4,45774,2714,"Geert Wilders (PVV)",0.809228321400159,0.257984790874525,0
"<anonymized_userid>",4,45778,2715,"Geert Wilders (PVV)",0.809299036506674,0.258079847908745,0
"<anonymized_userid>",4,45782,2716,"Geert Wilders (PVV)",0.809369751613188,0.258174904942966,0
"<anonymized_userid>",4,45786,2717,"Geert Wilders (PVV)",0.809440466719703,0.258269961977186,0
"<anonymized_userid>",4,45790,2718,"Geert Wilders (PVV)",0.809511181826218,0.258365019011407,0
"<anonymized_userid>",4,45794,2719,"Geert Wilders (PVV)",0.809581896932732,0.258460076045627,0
"<anonymized_userid>",4,45798,2720,"Geert Wilders (PVV)",0.809652612039247,0.258555133079848,0
"<anonymized_userid>",4,45802,2721,"Geert Wilders (PVV)",0.809723327145762,0.258650190114068,0
"<anonymized_userid>",4,45806,2722,"Geert Wilders (PVV)",0.809794042252276,0.258745247148289,0
"<anonymized_userid>",4,45810,2723,"Geert Wilders (PVV)",0.809864757358791,0.25884030418251,0
"<anonymized_userid>",4,45814,2724,"Geert Wilders (PVV)",0.809935472465305,0.25893536121673,0
"<anonymized_userid>",4,45818,2725,"Geert Wilders (PVV)",0.81000618757182,0.259030418250951,0
"<anonymized_userid>",4,45822,2726,"Geert Wilders (PVV)",0.810076902678335,0.259125475285171,0
"<anonymized_userid>",4,45826,2727,"Geert Wilders (PVV)",0.810147617784849,0.259220532319392,0
"<anonymized_userid>",4,45830,2728,"Geert Wilders (PVV)",0.810218332891364,0.259315589353612,0
"<anonymized_userid>",4,45834,2729,"Geert Wilders (PVV)",0.810289047997879,0.259410646387833,0
"<anonymized_userid>",4,45838,2730,"Geert Wilders (PVV)",0.810359763104393,0.259505703422053,0
"<anonymized_userid>",4,45842,2731,"Geert Wilders (PVV)",0.810430478210908,0.259600760456274,0
"<anonymized_userid>",4,45846,2732,"Geert Wilders (PVV)",0.810501193317422,0.259695817490494,0
"<anonymized_userid>",4,45850,2733,"Geert Wilders (PVV)",0.810571908423937,0.259790874524715,0
"<anonymized_userid>",4,45854,2734,"Geert Wilders (PVV)",0.810642623530452,0.259885931558935,0
"<anonymized_userid>",4,45858,2735,"Geert Wilders (PVV)",0.810713338636966,0.259980988593156,0
"<anonymized_userid>",4,45862,2736,"Geert Wilders (PVV)",0.810784053743481,0.260076045627376,0
"<anonymized_userid>",4,45866,2737,"Geert Wilders (PVV)",0.810854768849996,0.260171102661597,0
"<anonymized_userid>",4,45870,2738,"Geert Wilders (PVV)",0.81092548395651,0.260266159695818,0
"<anonymized_userid>",4,45874,2739,"Geert Wilders (PVV)",0.810996199063025,0.260361216730038,0
"<anonymized_userid>",4,45878,2740,"Geert Wilders (PVV)",0.811066914169539,0.260456273764259,0
"<anonymized_userid>",4,45882,2741,"Geert Wilders (PVV)",0.811137629276054,0.260551330798479,0
"<anonymized_userid>",4,45886,2742,"Geert Wilders (PVV)",0.811208344382569,0.2606463878327,0
"<anonymized_userid>",4,45890,2743,"Geert Wilders (PVV)",0.811279059489083,0.26074144486692,0
"<anonymized_userid>",4,45894,2744,"Geert Wilders (PVV)",0.811349774595598,0.260836501901141,0
"<anonymized_userid>",4,45898,2745,"Geert Wilders (PVV)",0.811420489702113,0.260931558935361,0
"<anonymized_userid>",4,45902,2746,"Geert Wilders (PVV)",0.811491204808627,0.261026615969582,0
"<anonymized_userid>",4,45906,2747,"Geert Wilders (PVV)",0.811561919915142,0.261121673003802,0
"<anonymized_userid>",4,45910,2748,"Geert Wilders (PVV)",0.811632635021657,0.261216730038023,0
"<anonymized_userid>",4,45914,2749,"Geert Wilders (PVV)",0.811703350128171,0.261311787072243,0
"<anonymized_userid>",4,45918,2750,"Geert Wilders (PVV)",0.811774065234686,0.261406844106464,0
"<anonymized_userid>",4,45922,2751,"Geert Wilders (PVV)",0.8118447803412,0.261501901140684,0
"<anonymized_userid>",4,45926,2752,"Geert Wilders (PVV)",0.811915495447715,0.261596958174905,0
"<anonymized_userid>",4,45930,2753,"Geert Wilders (PVV)",0.81198621055423,0.261692015209125,0
"<anonymized_userid>",4,45934,2754,"Geert Wilders (PVV)",0.812056925660744,0.261787072243346,0
"<anonymized_userid>",4,45938,2755,"Geert Wilders (PVV)",0.812127640767259,0.261882129277567,0
"<anonymized_userid>",4,45942,2756,"Geert Wilders (PVV)",0.812198355873774,0.261977186311787,0
"<anonymized_userid>",4,45946,2757,"Geert Wilders (PVV)",0.812269070980288,0.262072243346008,0
"<anonymized_userid>",4,45950,2758,"Geert Wilders (PVV)",0.812339786086803,0.262167300380228,0
"<anonymized_userid>",4,45954,2759,"Geert Wilders (PVV)",0.812410501193317,0.262262357414449,0
"<anonymized_userid>",4,45958,2760,"Geert Wilders (PVV)",0.812481216299832,0.262357414448669,0
"<anonymized_userid>",4,45962,2761,"Geert Wilders (PVV)",0.812551931406347,0.26245247148289,0
"<anonymized_userid>",4,45966,2762,"Geert Wilders (PVV)",0.812622646512861,0.26254752851711,0
"<anonymized_userid>",4,45970,2763,"Geert Wilders (PVV)",0.812693361619376,0.262642585551331,0
"<anonymized_userid>",4,45974,2764,"Geert Wilders (PVV)",0.812764076725891,0.262737642585551,0
"<anonymized_userid>",4,45978,2765,"Geert Wilders (PVV)",0.812834791832405,0.262832699619772,0
"<anonymized_userid>",4,45982,2766,"Geert Wilders (PVV)",0.81290550693892,0.262927756653992,0
"<anonymized_userid>",4,45986,2767,"Geert Wilders (PVV)",0.812976222045434,0.263022813688213,0
"<anonymized_userid>",4,45990,2768,"Geert Wilders (PVV)",0.813046937151949,0.263117870722433,0
"<anonymized_userid>",3,45993,2769,"Geert Wilders (PVV)",0.813099973481835,0.263212927756654,0
"<anonymized_userid>",3,45996,2770,"Geert Wilders (PVV)",0.813153009811721,0.263307984790875,0
"<anonymized_userid>",3,45999,2771,"Geert Wilders (PVV)",0.813206046141607,0.263403041825095,0
"<anonymized_userid>",3,46002,2772,"Geert Wilders (PVV)",0.813259082471493,0.263498098859316,0
"<anonymized_userid>",3,46005,2773,"Geert Wilders (PVV)",0.813312118801379,0.263593155893536,0
"<anonymized_userid>",3,46008,2774,"Geert Wilders (PVV)",0.813365155131265,0.263688212927757,0
"<anonymized_userid>",3,46011,2775,"Geert Wilders (PVV)",0.813418191461151,0.263783269961977,0
"<anonymized_userid>",3,46014,2776,"Geert Wilders (PVV)",0.813471227791037,0.263878326996198,0
"<anonymized_userid>",3,46017,2777,"Geert Wilders (PVV)",0.813524264120923,0.263973384030418,0
"<anonymized_userid>",3,46020,2778,"Geert Wilders (PVV)",0.813577300450809,0.264068441064639,0
"<anonymized_userid>",3,46023,2779,"Geert Wilders (PVV)",0.813630336780695,0.264163498098859,0
"<anonymized_userid>",3,46026,2780,"Geert Wilders (PVV)",0.813683373110581,0.26425855513308,0
"<anonymized_userid>",3,46029,2781,"Geert Wilders (PVV)",0.813736409440467,0.2643536121673,0
"<anonymized_userid>",3,46032,2782,"Geert Wilders (PVV)",0.813789445770353,0.264448669201521,0
"<anonymized_userid>",3,46035,2783,"Geert Wilders (PVV)",0.813842482100239,0.264543726235741,0
"<anonymized_userid>",3,46038,2784,"Geert Wilders (PVV)",0.813895518430125,0.264638783269962,0
"<anonymized_userid>",3,46041,2785,"Geert Wilders (PVV)",0.813948554760011,0.264733840304183,0
"<anonymized_userid>",3,46044,2786,"Geert Wilders (PVV)",0.814001591089897,0.264828897338403,0
"<anonymized_userid>",3,46047,2787,"Geert Wilders (PVV)",0.814054627419783,0.264923954372624,0
"<anonymized_userid>",3,46050,2788,"Geert Wilders (PVV)",0.814107663749668,0.265019011406844,0
"<anonymized_userid>",3,46053,2789,"Geert Wilders (PVV)",0.814160700079555,0.265114068441065,0
"<anonymized_userid>",3,46056,2790,"Geert Wilders (PVV)",0.814213736409441,0.265209125475285,0
"<anonymized_userid>",3,46059,2791,"Geert Wilders (PVV)",0.814266772739326,0.265304182509506,0
"<anonymized_userid>",3,46062,2792,"Geert Wilders (PVV)",0.814319809069212,0.265399239543726,0
"<anonymized_userid>",3,46065,2793,"Geert Wilders (PVV)",0.814372845399098,0.265494296577947,0
"<anonymized_userid>",3,46068,2794,"Geert Wilders (PVV)",0.814425881728984,0.265589353612167,0
"<anonymized_userid>",3,46071,2795,"Geert Wilders (PVV)",0.81447891805887,0.265684410646388,0
"<anonymized_userid>",3,46074,2796,"Geert Wilders (PVV)",0.814531954388756,0.265779467680608,0
"<anonymized_userid>",3,46077,2797,"Geert Wilders (PVV)",0.814584990718642,0.265874524714829,0
"<anonymized_userid>",3,46080,2798,"Geert Wilders (PVV)",0.814638027048528,0.265969581749049,0
"<anonymized_userid>",3,46083,2799,"Geert Wilders (PVV)",0.814691063378414,0.26606463878327,0
"<anonymized_userid>",3,46086,2800,"Geert Wilders (PVV)",0.8147440997083,0.26615969581749,0
"<anonymized_userid>",3,46089,2801,"Geert Wilders (PVV)",0.814797136038186,0.266254752851711,0
"<anonymized_userid>",3,46092,2802,"Geert Wilders (PVV)",0.814850172368072,0.266349809885932,0
"<anonymized_userid>",3,46095,2803,"Geert Wilders (PVV)",0.814903208697958,0.266444866920152,0
"<anonymized_userid>",3,46098,2804,"Geert Wilders (PVV)",0.814956245027844,0.266539923954373,0
"<anonymized_userid>",3,46101,2805,"Geert Wilders (PVV)",0.81500928135773,0.266634980988593,0
"<anonymized_userid>",3,46104,2806,"Geert Wilders (PVV)",0.815062317687616,0.266730038022814,0
"<anonymized_userid>",3,46107,2807,"Geert Wilders (PVV)",0.815115354017502,0.266825095057034,0
"<anonymized_userid>",3,46110,2808,"Geert Wilders (PVV)",0.815168390347388,0.266920152091255,0
"<anonymized_userid>",3,46113,2809,"Geert Wilders (PVV)",0.815221426677274,0.267015209125475,0
"<anonymized_userid>",3,46116,2810,"Geert Wilders (PVV)",0.81527446300716,0.267110266159696,0
"<anonymized_userid>",3,46119,2811,"Geert Wilders (PVV)",0.815327499337046,0.267205323193916,0
"<anonymized_userid>",3,46122,2812,"Geert Wilders (PVV)",0.815380535666932,0.267300380228137,0
"<anonymized_userid>",3,46125,2813,"Geert Wilders (PVV)",0.815433571996818,0.267395437262357,0
"<anonymized_userid>",3,46128,2814,"Geert Wilders (PVV)",0.815486608326704,0.267490494296578,0
"<anonymized_userid>",3,46131,2815,"Geert Wilders (PVV)",0.81553964465659,0.267585551330798,0
"<anonymized_userid>",3,46134,2816,"Geert Wilders (PVV)",0.815592680986476,0.267680608365019,0
"<anonymized_userid>",3,46137,2817,"Geert Wilders (PVV)",0.815645717316362,0.26777566539924,0
"<anonymized_userid>",3,46140,2818,"Geert Wilders (PVV)",0.815698753646248,0.26787072243346,0
"<anonymized_userid>",3,46143,2819,"Geert Wilders (PVV)",0.815751789976134,0.267965779467681,0
"<anonymized_userid>",3,46146,2820,"Geert Wilders (PVV)",0.81580482630602,0.268060836501901,0
"<anonymized_userid>",3,46149,2821,"Geert Wilders (PVV)",0.815857862635906,0.268155893536122,0
"<anonymized_userid>",3,46152,2822,"Geert Wilders (PVV)",0.815910898965792,0.268250950570342,0
"<anonymized_userid>",3,46155,2823,"Geert Wilders (PVV)",0.815963935295678,0.268346007604563,0
"<anonymized_userid>",3,46158,2824,"Geert Wilders (PVV)",0.816016971625564,0.268441064638783,0
"<anonymized_userid>",3,46161,2825,"Geert Wilders (PVV)",0.816070007955449,0.268536121673004,0
"<anonymized_userid>",3,46164,2826,"Geert Wilders (PVV)",0.816123044285335,0.268631178707224,0
"<anonymized_userid>",3,46167,2827,"Geert Wilders (PVV)",0.816176080615221,0.268726235741445,0
"<anonymized_userid>",3,46170,2828,"Geert Wilders (PVV)",0.816229116945107,0.268821292775665,0
"<anonymized_userid>",3,46173,2829,"Geert Wilders (PVV)",0.816282153274993,0.268916349809886,0
"<anonymized_userid>",3,46176,2830,"Geert Wilders (PVV)",0.816335189604879,0.269011406844106,0
"<anonymized_userid>",3,46179,2831,"Geert Wilders (PVV)",0.816388225934765,0.269106463878327,0
"<anonymized_userid>",3,46182,2832,"Geert Wilders (PVV)",0.816441262264651,0.269201520912548,0
"<anonymized_userid>",3,46185,2833,"Geert Wilders (PVV)",0.816494298594537,0.269296577946768,0
"<anonymized_userid>",3,46188,2834,"Geert Wilders (PVV)",0.816547334924423,0.269391634980989,0
"<anonymized_userid>",3,46191,2835,"Geert Wilders (PVV)",0.816600371254309,0.269486692015209,0
"<anonymized_userid>",3,46194,2836,"Geert Wilders (PVV)",0.816653407584195,0.26958174904943,0
"<anonymized_userid>",3,46197,2837,"Geert Wilders (PVV)",0.816706443914081,0.26967680608365,0
"<anonymized_userid>",3,46200,2838,"Geert Wilders (PVV)",0.816759480243967,0.269771863117871,0
"<anonymized_userid>",3,46203,2839,"Geert Wilders (PVV)",0.816812516573853,0.269866920152091,0
"<anonymized_userid>",3,46206,2840,"Geert Wilders (PVV)",0.816865552903739,0.269961977186312,0
"<anonymized_userid>",3,46209,2841,"Geert Wilders (PVV)",0.816918589233625,0.270057034220532,0
"<anonymized_userid>",3,46212,2842,"Geert Wilders (PVV)",0.816971625563511,0.270152091254753,0
"<anonymized_userid>",3,46215,2843,"Geert Wilders (PVV)",0.817024661893397,0.270247148288973,0
"<anonymized_userid>",3,46218,2844,"Geert Wilders (PVV)",0.817077698223283,0.270342205323194,0
"<anonymized_userid>",3,46221,2845,"Geert Wilders (PVV)",0.817130734553169,0.270437262357414,0
"<anonymized_userid>",3,46224,2846,"Geert Wilders (PVV)",0.817183770883055,0.270532319391635,0
"<anonymized_userid>",3,46227,2847,"Geert Wilders (PVV)",0.817236807212941,0.270627376425855,0
"<anonymized_userid>",3,46230,2848,"Geert Wilders (PVV)",0.817289843542827,0.270722433460076,0
"<anonymized_userid>",3,46233,2849,"Geert Wilders (PVV)",0.817342879872713,0.270817490494297,0
"<anonymized_userid>",3,46236,2850,"Geert Wilders (PVV)",0.817395916202599,0.270912547528517,0
"<anonymized_userid>",3,46239,2851,"Geert Wilders (PVV)",0.817448952532485,0.271007604562738,0
"<anonymized_userid>",3,46242,2852,"Geert Wilders (PVV)",0.817501988862371,0.271102661596958,0
"<anonymized_userid>",3,46245,2853,"Geert Wilders (PVV)",0.817555025192257,0.271197718631179,0
"<anonymized_userid>",3,46248,2854,"Geert Wilders (PVV)",0.817608061522143,0.271292775665399,0
"<anonymized_userid>",3,46251,2855,"Geert Wilders (PVV)",0.817661097852029,0.27138783269962,0
"<anonymized_userid>",3,46254,2856,"Geert Wilders (PVV)",0.817714134181915,0.27148288973384,0
"<anonymized_userid>",3,46257,2857,"Geert Wilders (PVV)",0.817767170511801,0.271577946768061,0
"<anonymized_userid>",3,46260,2858,"Geert Wilders (PVV)",0.817820206841687,0.271673003802281,0
"<anonymized_userid>",3,46263,2859,"Geert Wilders (PVV)",0.817873243171573,0.271768060836502,0
"<anonymized_userid>",3,46266,2860,"Geert Wilders (PVV)",0.817926279501458,0.271863117870722,0
"<anonymized_userid>",3,46269,2861,"Geert Wilders (PVV)",0.817979315831344,0.271958174904943,0
"<anonymized_userid>",3,46272,2862,"Geert Wilders (PVV)",0.81803235216123,0.272053231939163,0
"<anonymized_userid>",3,46275,2863,"Geert Wilders (PVV)",0.818085388491116,0.272148288973384,0
"<anonymized_userid>",3,46278,2864,"Geert Wilders (PVV)",0.818138424821002,0.272243346007605,0
"<anonymized_userid>",3,46281,2865,"Geert Wilders (PVV)",0.818191461150888,0.272338403041825,0
"<anonymized_userid>",3,46284,2866,"Geert Wilders (PVV)",0.818244497480774,0.272433460076046,0
"<anonymized_userid>",3,46287,2867,"Geert Wilders (PVV)",0.81829753381066,0.272528517110266,0
"<anonymized_userid>",3,46290,2868,"Geert Wilders (PVV)",0.818350570140546,0.272623574144487,0
"<anonymized_userid>",3,46293,2869,"Geert Wilders (PVV)",0.818403606470432,0.272718631178707,0
"<anonymized_userid>",3,46296,2870,"Geert Wilders (PVV)",0.818456642800318,0.272813688212928,0
"<anonymized_userid>",3,46299,2871,"Geert Wilders (PVV)",0.818509679130204,0.272908745247148,0
"<anonymized_userid>",3,46302,2872,"Geert Wilders (PVV)",0.81856271546009,0.273003802281369,0
"<anonymized_userid>",3,46305,2873,"Geert Wilders (PVV)",0.818615751789976,0.273098859315589,0
"<anonymized_userid>",3,46308,2874,"Geert Wilders (PVV)",0.818668788119862,0.27319391634981,0
"<anonymized_userid>",3,46311,2875,"Geert Wilders (PVV)",0.818721824449748,0.27328897338403,0
"<anonymized_userid>",3,46314,2876,"Geert Wilders (PVV)",0.818774860779634,0.273384030418251,0
"<anonymized_userid>",3,46317,2877,"Geert Wilders (PVV)",0.81882789710952,0.273479087452471,0
"<anonymized_userid>",3,46320,2878,"Geert Wilders (PVV)",0.818880933439406,0.273574144486692,0
"<anonymized_userid>",3,46323,2879,"Geert Wilders (PVV)",0.818933969769292,0.273669201520913,0
"<anonymized_userid>",3,46326,2880,"Geert Wilders (PVV)",0.818987006099178,0.273764258555133,0
"<anonymized_userid>",3,46329,2881,"Geert Wilders (PVV)",0.819040042429064,0.273859315589354,0
"<anonymized_userid>",3,46332,2882,"Geert Wilders (PVV)",0.81909307875895,0.273954372623574,0
"<anonymized_userid>",3,46335,2883,"Geert Wilders (PVV)",0.819146115088836,0.274049429657795,0
"<anonymized_userid>",3,46338,2884,"Geert Wilders (PVV)",0.819199151418722,0.274144486692015,0
"<anonymized_userid>",3,46341,2885,"Geert Wilders (PVV)",0.819252187748608,0.274239543726236,0
"<anonymized_userid>",3,46344,2886,"Geert Wilders (PVV)",0.819305224078494,0.274334600760456,0
"<anonymized_userid>",3,46347,2887,"Geert Wilders (PVV)",0.81935826040838,0.274429657794677,0
"<anonymized_userid>",3,46350,2888,"Geert Wilders (PVV)",0.819411296738266,0.274524714828897,0
"<anonymized_userid>",3,46353,2889,"Geert Wilders (PVV)",0.819464333068152,0.274619771863118,0
"<anonymized_userid>",3,46356,2890,"Geert Wilders (PVV)",0.819517369398038,0.274714828897338,0
"<anonymized_userid>",3,46359,2891,"Geert Wilders (PVV)",0.819570405727924,0.274809885931559,0
"<anonymized_userid>",3,46362,2892,"Geert Wilders (PVV)",0.81962344205781,0.274904942965779,0
"<anonymized_userid>",3,46365,2893,"Geert Wilders (PVV)",0.819676478387696,0.275,0
"<anonymized_userid>",3,46368,2894,"Geert Wilders (PVV)",0.819729514717582,0.275095057034221,0
"<anonymized_userid>",3,46371,2895,"Geert Wilders (PVV)",0.819782551047468,0.275190114068441,0
"<anonymized_userid>",3,46374,2896,"Geert Wilders (PVV)",0.819835587377354,0.275285171102662,0
"<anonymized_userid>",3,46377,2897,"Geert Wilders (PVV)",0.819888623707239,0.275380228136882,0
"<anonymized_userid>",3,46380,2898,"Geert Wilders (PVV)",0.819941660037125,0.275475285171103,0
"<anonymized_userid>",3,46383,2899,"Geert Wilders (PVV)",0.819994696367011,0.275570342205323,0
"<anonymized_userid>",3,46386,2900,"Geert Wilders (PVV)",0.820047732696897,0.275665399239544,0
"<anonymized_userid>",3,46389,2901,"Geert Wilders (PVV)",0.820100769026783,0.275760456273764,0
"<anonymized_userid>",3,46392,2902,"Geert Wilders (PVV)",0.820153805356669,0.275855513307985,0
"<anonymized_userid>",3,46395,2903,"Geert Wilders (PVV)",0.820206841686555,0.275950570342205,0
"<anonymized_userid>",3,46398,2904,"Geert Wilders (PVV)",0.820259878016441,0.276045627376426,0
"<anonymized_userid>",3,46401,2905,"Geert Wilders (PVV)",0.820312914346327,0.276140684410646,0
"<anonymized_userid>",3,46404,2906,"Geert Wilders (PVV)",0.820365950676213,0.276235741444867,0
"<anonymized_userid>",3,46407,2907,"Geert Wilders (PVV)",0.820418987006099,0.276330798479087,0
"<anonymized_userid>",3,46410,2908,"Geert Wilders (PVV)",0.820472023335985,0.276425855513308,0
"<anonymized_userid>",3,46413,2909,"Geert Wilders (PVV)",0.820525059665871,0.276520912547529,0
"<anonymized_userid>",3,46416,2910,"Geert Wilders (PVV)",0.820578095995757,0.276615969581749,0
"<anonymized_userid>",3,46419,2911,"Geert Wilders (PVV)",0.820631132325643,0.27671102661597,0
"<anonymized_userid>",3,46422,2912,"Geert Wilders (PVV)",0.820684168655529,0.27680608365019,0
"<anonymized_userid>",3,46425,2913,"Geert Wilders (PVV)",0.820737204985415,0.276901140684411,0
"<anonymized_userid>",3,46428,2914,"Geert Wilders (PVV)",0.820790241315301,0.276996197718631,0
"<anonymized_userid>",3,46431,2915,"Geert Wilders (PVV)",0.820843277645187,0.277091254752852,0
"<anonymized_userid>",3,46434,2916,"Geert Wilders (PVV)",0.820896313975073,0.277186311787072,0
"<anonymized_userid>",3,46437,2917,"Geert Wilders (PVV)",0.820949350304959,0.277281368821293,0
"<anonymized_userid>",3,46440,2918,"Geert Wilders (PVV)",0.821002386634845,0.277376425855513,0
"<anonymized_userid>",3,46443,2919,"Geert Wilders (PVV)",0.821055422964731,0.277471482889734,0
"<anonymized_userid>",3,46446,2920,"Geert Wilders (PVV)",0.821108459294617,0.277566539923954,0
"<anonymized_userid>",3,46449,2921,"Geert Wilders (PVV)",0.821161495624503,0.277661596958175,0
"<anonymized_userid>",3,46452,2922,"Geert Wilders (PVV)",0.821214531954389,0.277756653992395,0
"<anonymized_userid>",3,46455,2923,"Geert Wilders (PVV)",0.821267568284275,0.277851711026616,0
"<anonymized_userid>",3,46458,2924,"Geert Wilders (PVV)",0.821320604614161,0.277946768060837,0
"<anonymized_userid>",3,46461,2925,"Geert Wilders (PVV)",0.821373640944047,0.278041825095057,0
"<anonymized_userid>",3,46464,2926,"Geert Wilders (PVV)",0.821426677273933,0.278136882129278,0
"<anonymized_userid>",3,46467,2927,"Geert Wilders (PVV)",0.821479713603819,0.278231939163498,0
"<anonymized_userid>",3,46470,2928,"Geert Wilders (PVV)",0.821532749933705,0.278326996197719,0
"<anonymized_userid>",3,46473,2929,"Geert Wilders (PVV)",0.821585786263591,0.278422053231939,0
"<anonymized_userid>",3,46476,2930,"Geert Wilders (PVV)",0.821638822593477,0.27851711026616,0
"<anonymized_userid>",3,46479,2931,"Geert Wilders (PVV)",0.821691858923362,0.27861216730038,0
"<anonymized_userid>",3,46482,2932,"Geert Wilders (PVV)",0.821744895253248,0.278707224334601,0
"<anonymized_userid>",3,46485,2933,"Geert Wilders (PVV)",0.821797931583134,0.278802281368821,0
"<anonymized_userid>",3,46488,2934,"Geert Wilders (PVV)",0.82185096791302,0.278897338403042,0
"<anonymized_userid>",3,46491,2935,"Geert Wilders (PVV)",0.821904004242906,0.278992395437262,0
"<anonymized_userid>",3,46494,2936,"Geert Wilders (PVV)",0.821957040572792,0.279087452471483,0
"<anonymized_userid>",3,46497,2937,"Geert Wilders (PVV)",0.822010076902678,0.279182509505703,0
"<anonymized_userid>",3,46500,2938,"Geert Wilders (PVV)",0.822063113232564,0.279277566539924,0
"<anonymized_userid>",3,46503,2939,"Geert Wilders (PVV)",0.82211614956245,0.279372623574144,0
"<anonymized_userid>",3,46506,2940,"Geert Wilders (PVV)",0.822169185892336,0.279467680608365,0
"<anonymized_userid>",3,46509,2941,"Geert Wilders (PVV)",0.822222222222222,0.279562737642586,0
"<anonymized_userid>",3,46512,2942,"Geert Wilders (PVV)",0.822275258552108,0.279657794676806,0
"<anonymized_userid>",3,46515,2943,"Geert Wilders (PVV)",0.822328294881994,0.279752851711027,0
"<anonymized_userid>",3,46518,2944,"Geert Wilders (PVV)",0.82238133121188,0.279847908745247,0
"<anonymized_userid>",3,46521,2945,"Geert Wilders (PVV)",0.822434367541766,0.279942965779468,0
"<anonymized_userid>",3,46524,2946,"Geert Wilders (PVV)",0.822487403871652,0.280038022813688,0
"<anonymized_userid>",3,46527,2947,"Geert Wilders (PVV)",0.822540440201538,0.280133079847909,0
"<anonymized_userid>",3,46530,2948,"Geert Wilders (PVV)",0.822593476531424,0.280228136882129,0
"<anonymized_userid>",3,46533,2949,"Geert Wilders (PVV)",0.82264651286131,0.28032319391635,0
"<anonymized_userid>",3,46536,2950,"Geert Wilders (PVV)",0.822699549191196,0.28041825095057,0
"<anonymized_userid>",3,46539,2951,"Geert Wilders (PVV)",0.822752585521082,0.280513307984791,0
"<anonymized_userid>",3,46542,2952,"Geert Wilders (PVV)",0.822805621850968,0.280608365019011,0
"<anonymized_userid>",3,46545,2953,"Geert Wilders (PVV)",0.822858658180854,0.280703422053232,0
"<anonymized_userid>",3,46548,2954,"Geert Wilders (PVV)",0.82291169451074,0.280798479087452,0
"<anonymized_userid>",3,46551,2955,"Geert Wilders (PVV)",0.822964730840626,0.280893536121673,0
"<anonymized_userid>",3,46554,2956,"Geert Wilders (PVV)",0.823017767170512,0.280988593155894,0
"<anonymized_userid>",3,46557,2957,"Geert Wilders (PVV)",0.823070803500398,0.281083650190114,0
"<anonymized_userid>",3,46560,2958,"Geert Wilders (PVV)",0.823123839830284,0.281178707224335,0
"<anonymized_userid>",3,46563,2959,"Geert Wilders (PVV)",0.82317687616017,0.281273764258555,0
"<anonymized_userid>",3,46566,2960,"Geert Wilders (PVV)",0.823229912490056,0.281368821292776,0
"<anonymized_userid>",3,46569,2961,"Geert Wilders (PVV)",0.823282948819942,0.281463878326996,0
"<anonymized_userid>",3,46572,2962,"Geert Wilders (PVV)",0.823335985149828,0.281558935361217,0
"<anonymized_userid>",3,46575,2963,"Geert Wilders (PVV)",0.823389021479714,0.281653992395437,0
"<anonymized_userid>",3,46578,2964,"Geert Wilders (PVV)",0.8234420578096,0.281749049429658,0
"<anonymized_userid>",3,46581,2965,"Geert Wilders (PVV)",0.823495094139486,0.281844106463878,0
"<anonymized_userid>",3,46584,2966,"Geert Wilders (PVV)",0.823548130469371,0.281939163498099,0
"<anonymized_userid>",3,46587,2967,"Geert Wilders (PVV)",0.823601166799258,0.282034220532319,0
"<anonymized_userid>",3,46590,2968,"Geert Wilders (PVV)",0.823654203129144,0.28212927756654,0
"<anonymized_userid>",3,46593,2969,"Geert Wilders (PVV)",0.823707239459029,0.28222433460076,0
"<anonymized_userid>",3,46596,2970,"Geert Wilders (PVV)",0.823760275788915,0.282319391634981,0
"<anonymized_userid>",3,46599,2971,"Geert Wilders (PVV)",0.823813312118801,0.282414448669202,0
"<anonymized_userid>",3,46602,2972,"Geert Wilders (PVV)",0.823866348448687,0.282509505703422,0
"<anonymized_userid>",3,46605,2973,"Geert Wilders (PVV)",0.823919384778573,0.282604562737643,0
"<anonymized_userid>",3,46608,2974,"Geert Wilders (PVV)",0.823972421108459,0.282699619771863,0
"<anonymized_userid>",3,46611,2975,"Geert Wilders (PVV)",0.824025457438345,0.282794676806084,0
"<anonymized_userid>",3,46614,2976,"Geert Wilders (PVV)",0.824078493768231,0.282889733840304,0
"<anonymized_userid>",3,46617,2977,"Geert Wilders (PVV)",0.824131530098117,0.282984790874525,0
"<anonymized_userid>",3,46620,2978,"Geert Wilders (PVV)",0.824184566428003,0.283079847908745,0
"<anonymized_userid>",3,46623,2979,"Geert Wilders (PVV)",0.824237602757889,0.283174904942966,0
"<anonymized_userid>",3,46626,2980,"Geert Wilders (PVV)",0.824290639087775,0.283269961977186,0
"<anonymized_userid>",3,46629,2981,"Geert Wilders (PVV)",0.824343675417661,0.283365019011407,0
"<anonymized_userid>",3,46632,2982,"Geert Wilders (PVV)",0.824396711747547,0.283460076045627,0
"<anonymized_userid>",3,46635,2983,"Geert Wilders (PVV)",0.824449748077433,0.283555133079848,0
"<anonymized_userid>",3,46638,2984,"Geert Wilders (PVV)",0.824502784407319,0.283650190114068,0
"<anonymized_userid>",3,46641,2985,"Geert Wilders (PVV)",0.824555820737205,0.283745247148289,0
"<anonymized_userid>",3,46644,2986,"Geert Wilders (PVV)",0.824608857067091,0.283840304182509,0
"<anonymized_userid>",3,46647,2987,"Geert Wilders (PVV)",0.824661893396977,0.28393536121673,0
"<anonymized_userid>",3,46650,2988,"Geert Wilders (PVV)",0.824714929726863,0.284030418250951,0
"<anonymized_userid>",3,46653,2989,"Geert Wilders (PVV)",0.824767966056749,0.284125475285171,0
"<anonymized_userid>",3,46656,2990,"Geert Wilders (PVV)",0.824821002386635,0.284220532319392,0
"<anonymized_userid>",3,46659,2991,"Geert Wilders (PVV)",0.824874038716521,0.284315589353612,0
"<anonymized_userid>",3,46662,2992,"Geert Wilders (PVV)",0.824927075046407,0.284410646387833,0
"<anonymized_userid>",3,46665,2993,"Geert Wilders (PVV)",0.824980111376293,0.284505703422053,0
"<anonymized_userid>",3,46668,2994,"Geert Wilders (PVV)",0.825033147706179,0.284600760456274,0
"<anonymized_userid>",3,46671,2995,"Geert Wilders (PVV)",0.825086184036065,0.284695817490494,0
"<anonymized_userid>",3,46674,2996,"Geert Wilders (PVV)",0.825139220365951,0.284790874524715,0
"<anonymized_userid>",3,46677,2997,"Geert Wilders (PVV)",0.825192256695837,0.284885931558935,0
"<anonymized_userid>",3,46680,2998,"Geert Wilders (PVV)",0.825245293025723,0.284980988593156,0
"<anonymized_userid>",3,46683,2999,"Geert Wilders (PVV)",0.825298329355609,0.285076045627376,0
"<anonymized_userid>",3,46686,3000,"Geert Wilders (PVV)",0.825351365685495,0.285171102661597,0
"<anonymized_userid>",3,46689,3001,"Geert Wilders (PVV)",0.825404402015381,0.285266159695817,0
"<anonymized_userid>",3,46692,3002,"Geert Wilders (PVV)",0.825457438345267,0.285361216730038,0
"<anonymized_userid>",3,46695,3003,"Geert Wilders (PVV)",0.825510474675152,0.285456273764259,0
"<anonymized_userid>",3,46698,3004,"Geert Wilders (PVV)",0.825563511005038,0.285551330798479,0
"<anonymized_userid>",3,46701,3005,"Geert Wilders (PVV)",0.825616547334924,0.2856463878327,0
"<anonymized_userid>",3,46704,3006,"Geert Wilders (PVV)",0.82566958366481,0.28574144486692,0
"<anonymized_userid>",3,46707,3007,"Geert Wilders (PVV)",0.825722619994696,0.285836501901141,0
"<anonymized_userid>",3,46710,3008,"Geert Wilders (PVV)",0.825775656324582,0.285931558935361,0
"<anonymized_userid>",3,46713,3009,"Geert Wilders (PVV)",0.825828692654468,0.286026615969582,0
"<anonymized_userid>",3,46716,3010,"Geert Wilders (PVV)",0.825881728984354,0.286121673003802,0
"<anonymized_userid>",3,46719,3011,"Geert Wilders (PVV)",0.82593476531424,0.286216730038023,0
"<anonymized_userid>",3,46722,3012,"Geert Wilders (PVV)",0.825987801644126,0.286311787072243,0
"<anonymized_userid>",3,46725,3013,"Geert Wilders (PVV)",0.826040837974012,0.286406844106464,0
"<anonymized_userid>",3,46728,3014,"Geert Wilders (PVV)",0.826093874303898,0.286501901140684,0
"<anonymized_userid>",3,46731,3015,"Geert Wilders (PVV)",0.826146910633784,0.286596958174905,0
"<anonymized_userid>",3,46734,3016,"Geert Wilders (PVV)",0.82619994696367,0.286692015209125,0
"<anonymized_userid>",3,46737,3017,"Geert Wilders (PVV)",0.826252983293556,0.286787072243346,0
"<anonymized_userid>",3,46740,3018,"Geert Wilders (PVV)",0.826306019623442,0.286882129277567,0
"<anonymized_userid>",3,46743,3019,"Geert Wilders (PVV)",0.826359055953328,0.286977186311787,0
"<anonymized_userid>",3,46746,3020,"Geert Wilders (PVV)",0.826412092283214,0.287072243346008,0
"<anonymized_userid>",3,46749,3021,"Geert Wilders (PVV)",0.8264651286131,0.287167300380228,0
"<anonymized_userid>",3,46752,3022,"Geert Wilders (PVV)",0.826518164942986,0.287262357414449,0
"<anonymized_userid>",3,46755,3023,"Geert Wilders (PVV)",0.826571201272872,0.287357414448669,0
"<anonymized_userid>",3,46758,3024,"Geert Wilders (PVV)",0.826624237602758,0.28745247148289,0
"<anonymized_userid>",3,46761,3025,"Geert Wilders (PVV)",0.826677273932644,0.28754752851711,0
"<anonymized_userid>",3,46764,3026,"Geert Wilders (PVV)",0.82673031026253,0.287642585551331,0
"<anonymized_userid>",3,46767,3027,"Geert Wilders (PVV)",0.826783346592416,0.287737642585551,0
"<anonymized_userid>",3,46770,3028,"Geert Wilders (PVV)",0.826836382922302,0.287832699619772,0
"<anonymized_userid>",3,46773,3029,"Geert Wilders (PVV)",0.826889419252188,0.287927756653992,0
"<anonymized_userid>",3,46776,3030,"Geert Wilders (PVV)",0.826942455582074,0.288022813688213,0
"<anonymized_userid>",3,46779,3031,"Geert Wilders (PVV)",0.82699549191196,0.288117870722433,0
"<anonymized_userid>",3,46782,3032,"Geert Wilders (PVV)",0.827048528241846,0.288212927756654,0
"<anonymized_userid>",3,46785,3033,"Geert Wilders (PVV)",0.827101564571732,0.288307984790875,0
"<anonymized_userid>",3,46788,3034,"Geert Wilders (PVV)",0.827154600901618,0.288403041825095,0
"<anonymized_userid>",3,46791,3035,"Geert Wilders (PVV)",0.827207637231504,0.288498098859316,0
"<anonymized_userid>",3,46794,3036,"Geert Wilders (PVV)",0.82726067356139,0.288593155893536,0
"<anonymized_userid>",3,46797,3037,"Geert Wilders (PVV)",0.827313709891276,0.288688212927757,0
"<anonymized_userid>",3,46800,3038,"Geert Wilders (PVV)",0.827366746221161,0.288783269961977,0
"<anonymized_userid>",3,46803,3039,"Geert Wilders (PVV)",0.827419782551047,0.288878326996198,0
"<anonymized_userid>",3,46806,3040,"Geert Wilders (PVV)",0.827472818880933,0.288973384030418,0
"<anonymized_userid>",3,46809,3041,"Geert Wilders (PVV)",0.827525855210819,0.289068441064639,0
"<anonymized_userid>",3,46812,3042,"Geert Wilders (PVV)",0.827578891540705,0.289163498098859,0
"<anonymized_userid>",3,46815,3043,"Geert Wilders (PVV)",0.827631927870591,0.28925855513308,0
"<anonymized_userid>",3,46818,3044,"Geert Wilders (PVV)",0.827684964200477,0.2893536121673,0
"<anonymized_userid>",3,46821,3045,"Geert Wilders (PVV)",0.827738000530363,0.289448669201521,0
"<anonymized_userid>",3,46824,3046,"Geert Wilders (PVV)",0.827791036860249,0.289543726235741,0
"<anonymized_userid>",3,46827,3047,"Geert Wilders (PVV)",0.827844073190135,0.289638783269962,0
"<anonymized_userid>",3,46830,3048,"Geert Wilders (PVV)",0.827897109520021,0.289733840304183,0
"<anonymized_userid>",3,46833,3049,"Geert Wilders (PVV)",0.827950145849907,0.289828897338403,0
"<anonymized_userid>",3,46836,3050,"Geert Wilders (PVV)",0.828003182179793,0.289923954372624,0
"<anonymized_userid>",3,46839,3051,"Geert Wilders (PVV)",0.828056218509679,0.290019011406844,0
"<anonymized_userid>",3,46842,3052,"Geert Wilders (PVV)",0.828109254839565,0.290114068441065,0
"<anonymized_userid>",3,46845,3053,"Geert Wilders (PVV)",0.828162291169451,0.290209125475285,0
"<anonymized_userid>",3,46848,3054,"Geert Wilders (PVV)",0.828215327499337,0.290304182509506,0
"<anonymized_userid>",3,46851,3055,"Geert Wilders (PVV)",0.828268363829223,0.290399239543726,0
"<anonymized_userid>",3,46854,3056,"Geert Wilders (PVV)",0.828321400159109,0.290494296577947,0
"<anonymized_userid>",3,46857,3057,"Geert Wilders (PVV)",0.828374436488995,0.290589353612167,0
"<anonymized_userid>",3,46860,3058,"Geert Wilders (PVV)",0.828427472818881,0.290684410646388,0
"<anonymized_userid>",3,46863,3059,"Geert Wilders (PVV)",0.828480509148767,0.290779467680608,0
"<anonymized_userid>",3,46866,3060,"Geert Wilders (PVV)",0.828533545478653,0.290874524714829,0
"<anonymized_userid>",3,46869,3061,"Geert Wilders (PVV)",0.828586581808539,0.290969581749049,0
"<anonymized_userid>",3,46872,3062,"Geert Wilders (PVV)",0.828639618138425,0.29106463878327,0
"<anonymized_userid>",3,46875,3063,"Geert Wilders (PVV)",0.828692654468311,0.291159695817491,0
"<anonymized_userid>",3,46878,3064,"Geert Wilders (PVV)",0.828745690798197,0.291254752851711,0
"<anonymized_userid>",3,46881,3065,"Geert Wilders (PVV)",0.828798727128083,0.291349809885932,0
"<anonymized_userid>",3,46884,3066,"Geert Wilders (PVV)",0.828851763457969,0.291444866920152,0
"<anonymized_userid>",3,46887,3067,"Geert Wilders (PVV)",0.828904799787855,0.291539923954373,0
"<anonymized_userid>",3,46890,3068,"Geert Wilders (PVV)",0.828957836117741,0.291634980988593,0
"<anonymized_userid>",3,46893,3069,"Geert Wilders (PVV)",0.829010872447627,0.291730038022814,0
"<anonymized_userid>",3,46896,3070,"Geert Wilders (PVV)",0.829063908777513,0.291825095057034,0
"<anonymized_userid>",3,46899,3071,"Geert Wilders (PVV)",0.829116945107399,0.291920152091255,0
"<anonymized_userid>",3,46902,3072,"Geert Wilders (PVV)",0.829169981437284,0.292015209125475,0
"<anonymized_userid>",3,46905,3073,"Geert Wilders (PVV)",0.829223017767171,0.292110266159696,0
"<anonymized_userid>",3,46908,3074,"Geert Wilders (PVV)",0.829276054097057,0.292205323193916,0
"<anonymized_userid>",3,46911,3075,"Geert Wilders (PVV)",0.829329090426942,0.292300380228137,0
"<anonymized_userid>",3,46914,3076,"Geert Wilders (PVV)",0.829382126756828,0.292395437262357,0
"<anonymized_userid>",3,46917,3077,"Geert Wilders (PVV)",0.829435163086714,0.292490494296578,0
"<anonymized_userid>",3,46920,3078,"Geert Wilders (PVV)",0.8294881994166,0.292585551330798,0
"<anonymized_userid>",3,46923,3079,"Geert Wilders (PVV)",0.829541235746486,0.292680608365019,0
"<anonymized_userid>",3,46926,3080,"Geert Wilders (PVV)",0.829594272076372,0.29277566539924,0
"<anonymized_userid>",3,46929,3081,"Geert Wilders (PVV)",0.829647308406258,0.29287072243346,0
"<anonymized_userid>",3,46932,3082,"Geert Wilders (PVV)",0.829700344736144,0.292965779467681,0
"<anonymized_userid>",3,46935,3083,"Geert Wilders (PVV)",0.82975338106603,0.293060836501901,0
"<anonymized_userid>",3,46938,3084,"Geert Wilders (PVV)",0.829806417395916,0.293155893536122,0
"<anonymized_userid>",3,46941,3085,"Geert Wilders (PVV)",0.829859453725802,0.293250950570342,0
"<anonymized_userid>",3,46944,3086,"Geert Wilders (PVV)",0.829912490055688,0.293346007604563,0
"<anonymized_userid>",3,46947,3087,"Geert Wilders (PVV)",0.829965526385574,0.293441064638783,0
"<anonymized_userid>",3,46950,3088,"Geert Wilders (PVV)",0.83001856271546,0.293536121673004,0
"<anonymized_userid>",3,46953,3089,"Geert Wilders (PVV)",0.830071599045346,0.293631178707224,0
"<anonymized_userid>",3,46956,3090,"Geert Wilders (PVV)",0.830124635375232,0.293726235741445,0
"<anonymized_userid>",3,46959,3091,"Geert Wilders (PVV)",0.830177671705118,0.293821292775665,0
"<anonymized_userid>",3,46962,3092,"Geert Wilders (PVV)",0.830230708035004,0.293916349809886,0
"<anonymized_userid>",3,46965,3093,"Geert Wilders (PVV)",0.83028374436489,0.294011406844106,0
"<anonymized_userid>",3,46968,3094,"Geert Wilders (PVV)",0.830336780694776,0.294106463878327,0
"<anonymized_userid>",3,46971,3095,"Geert Wilders (PVV)",0.830389817024662,0.294201520912548,0
"<anonymized_userid>",3,46974,3096,"Geert Wilders (PVV)",0.830442853354548,0.294296577946768,0
"<anonymized_userid>",3,46977,3097,"Geert Wilders (PVV)",0.830495889684434,0.294391634980989,0
"<anonymized_userid>",3,46980,3098,"Geert Wilders (PVV)",0.83054892601432,0.294486692015209,0
"<anonymized_userid>",3,46983,3099,"Geert Wilders (PVV)",0.830601962344206,0.29458174904943,0
"<anonymized_userid>",3,46986,3100,"Geert Wilders (PVV)",0.830654998674092,0.29467680608365,0
"<anonymized_userid>",3,46989,3101,"Geert Wilders (PVV)",0.830708035003978,0.294771863117871,0
"<anonymized_userid>",3,46992,3102,"Geert Wilders (PVV)",0.830761071333864,0.294866920152091,0
"<anonymized_userid>",3,46995,3103,"Geert Wilders (PVV)",0.83081410766375,0.294961977186312,0
"<anonymized_userid>",3,46998,3104,"Geert Wilders (PVV)",0.830867143993636,0.295057034220532,0
"<anonymized_userid>",3,47001,3105,"Geert Wilders (PVV)",0.830920180323522,0.295152091254753,0
"<anonymized_userid>",3,47004,3106,"Geert Wilders (PVV)",0.830973216653408,0.295247148288973,0
"<anonymized_userid>",3,47007,3107,"Geert Wilders (PVV)",0.831026252983294,0.295342205323194,0
"<anonymized_userid>",3,47010,3108,"Geert Wilders (PVV)",0.83107928931318,0.295437262357414,0
"<anonymized_userid>",3,47013,3109,"Geert Wilders (PVV)",0.831132325643065,0.295532319391635,0
"<anonymized_userid>",3,47016,3110,"Geert Wilders (PVV)",0.831185361972951,0.295627376425856,0
"<anonymized_userid>",3,47019,3111,"Geert Wilders (PVV)",0.831238398302837,0.295722433460076,0
"<anonymized_userid>",3,47022,3112,"Geert Wilders (PVV)",0.831291434632723,0.295817490494297,0
"<anonymized_userid>",3,47025,3113,"Geert Wilders (PVV)",0.831344470962609,0.295912547528517,0
"<anonymized_userid>",3,47028,3114,"Geert Wilders (PVV)",0.831397507292495,0.296007604562738,0
"<anonymized_userid>",3,47031,3115,"Geert Wilders (PVV)",0.831450543622381,0.296102661596958,0
"<anonymized_userid>",3,47034,3116,"Geert Wilders (PVV)",0.831503579952267,0.296197718631179,0
"<anonymized_userid>",3,47037,3117,"Geert Wilders (PVV)",0.831556616282153,0.296292775665399,0
"<anonymized_userid>",3,47040,3118,"Geert Wilders (PVV)",0.831609652612039,0.29638783269962,0
"<anonymized_userid>",3,47043,3119,"Geert Wilders (PVV)",0.831662688941925,0.29648288973384,0
"<anonymized_userid>",3,47046,3120,"Geert Wilders (PVV)",0.831715725271811,0.296577946768061,0
"<anonymized_userid>",3,47049,3121,"Geert Wilders (PVV)",0.831768761601697,0.296673003802281,0
"<anonymized_userid>",3,47052,3122,"Geert Wilders (PVV)",0.831821797931583,0.296768060836502,0
"<anonymized_userid>",3,47055,3123,"Geert Wilders (PVV)",0.831874834261469,0.296863117870722,0
"<anonymized_userid>",3,47058,3124,"Geert Wilders (PVV)",0.831927870591355,0.296958174904943,0
"<anonymized_userid>",3,47061,3125,"Geert Wilders (PVV)",0.831980906921241,0.297053231939163,0
"<anonymized_userid>",3,47064,3126,"Geert Wilders (PVV)",0.832033943251127,0.297148288973384,0
"<anonymized_userid>",3,47067,3127,"Geert Wilders (PVV)",0.832086979581013,0.297243346007605,0
"<anonymized_userid>",3,47070,3128,"Geert Wilders (PVV)",0.832140015910899,0.297338403041825,0
"<anonymized_userid>",3,47073,3129,"Geert Wilders (PVV)",0.832193052240785,0.297433460076046,0
"<anonymized_userid>",3,47076,3130,"Geert Wilders (PVV)",0.832246088570671,0.297528517110266,0
"<anonymized_userid>",3,47079,3131,"Geert Wilders (PVV)",0.832299124900557,0.297623574144487,0
"<anonymized_userid>",3,47082,3132,"Geert Wilders (PVV)",0.832352161230443,0.297718631178707,0
"<anonymized_userid>",3,47085,3133,"Geert Wilders (PVV)",0.832405197560329,0.297813688212928,0
"<anonymized_userid>",3,47088,3134,"Geert Wilders (PVV)",0.832458233890215,0.297908745247148,0
"<anonymized_userid>",3,47091,3135,"Geert Wilders (PVV)",0.832511270220101,0.298003802281369,0
"<anonymized_userid>",3,47094,3136,"Geert Wilders (PVV)",0.832564306549987,0.298098859315589,0
"<anonymized_userid>",3,47097,3137,"Geert Wilders (PVV)",0.832617342879873,0.29819391634981,0
"<anonymized_userid>",3,47100,3138,"Geert Wilders (PVV)",0.832670379209759,0.29828897338403,0
"<anonymized_userid>",3,47103,3139,"Geert Wilders (PVV)",0.832723415539645,0.298384030418251,0
"<anonymized_userid>",3,47106,3140,"Geert Wilders (PVV)",0.832776451869531,0.298479087452471,0
"<anonymized_userid>",3,47109,3141,"Geert Wilders (PVV)",0.832829488199417,0.298574144486692,0
"<anonymized_userid>",3,47112,3142,"Geert Wilders (PVV)",0.832882524529303,0.298669201520913,0
"<anonymized_userid>",3,47115,3143,"Geert Wilders (PVV)",0.832935560859189,0.298764258555133,0
"<anonymized_userid>",3,47118,3144,"Geert Wilders (PVV)",0.832988597189074,0.298859315589354,0
"<anonymized_userid>",3,47121,3145,"Geert Wilders (PVV)",0.83304163351896,0.298954372623574,0
"<anonymized_userid>",3,47124,3146,"Geert Wilders (PVV)",0.833094669848847,0.299049429657795,0
"<anonymized_userid>",3,47127,3147,"Geert Wilders (PVV)",0.833147706178732,0.299144486692015,0
"<anonymized_userid>",3,47130,3148,"Geert Wilders (PVV)",0.833200742508618,0.299239543726236,0
"<anonymized_userid>",3,47133,3149,"Geert Wilders (PVV)",0.833253778838504,0.299334600760456,0
"<anonymized_userid>",3,47136,3150,"Geert Wilders (PVV)",0.83330681516839,0.299429657794677,0
"<anonymized_userid>",3,47139,3151,"Geert Wilders (PVV)",0.833359851498276,0.299524714828897,0
"<anonymized_userid>",3,47142,3152,"Geert Wilders (PVV)",0.833412887828162,0.299619771863118,0
"<anonymized_userid>",3,47145,3153,"Geert Wilders (PVV)",0.833465924158048,0.299714828897338,0
"<anonymized_userid>",3,47148,3154,"Geert Wilders (PVV)",0.833518960487934,0.299809885931559,0
"<anonymized_userid>",3,47151,3155,"Geert Wilders (PVV)",0.83357199681782,0.299904942965779,0
"<anonymized_userid>",3,47154,3156,"Geert Wilders (PVV)",0.833625033147706,0.3,0
"<anonymized_userid>",3,47157,3157,"Geert Wilders (PVV)",0.833678069477592,0.300095057034221,0
"<anonymized_userid>",3,47160,3158,"Geert Wilders (PVV)",0.833731105807478,0.300190114068441,0
"<anonymized_userid>",3,47163,3159,"Geert Wilders (PVV)",0.833784142137364,0.300285171102662,0
"<anonymized_userid>",3,47166,3160,"Geert Wilders (PVV)",0.83383717846725,0.300380228136882,0
"<anonymized_userid>",3,47169,3161,"Geert Wilders (PVV)",0.833890214797136,0.300475285171103,0
"<anonymized_userid>",3,47172,3162,"Geert Wilders (PVV)",0.833943251127022,0.300570342205323,0
"<anonymized_userid>",3,47175,3163,"Geert Wilders (PVV)",0.833996287456908,0.300665399239544,0
"<anonymized_userid>",3,47178,3164,"Geert Wilders (PVV)",0.834049323786794,0.300760456273764,0
"<anonymized_userid>",3,47181,3165,"Geert Wilders (PVV)",0.83410236011668,0.300855513307985,0
"<anonymized_userid>",3,47184,3166,"Geert Wilders (PVV)",0.834155396446566,0.300950570342205,0
"<anonymized_userid>",3,47187,3167,"Geert Wilders (PVV)",0.834208432776452,0.301045627376426,0
"<anonymized_userid>",3,47190,3168,"Geert Wilders (PVV)",0.834261469106338,0.301140684410646,0
"<anonymized_userid>",3,47193,3169,"Geert Wilders (PVV)",0.834314505436224,0.301235741444867,0
"<anonymized_userid>",3,47196,3170,"Geert Wilders (PVV)",0.83436754176611,0.301330798479087,0
"<anonymized_userid>",3,47199,3171,"Geert Wilders (PVV)",0.834420578095996,0.301425855513308,0
"<anonymized_userid>",3,47202,3172,"Geert Wilders (PVV)",0.834473614425882,0.301520912547528,0
"<anonymized_userid>",3,47205,3173,"Geert Wilders (PVV)",0.834526650755768,0.301615969581749,0
"<anonymized_userid>",3,47208,3174,"Geert Wilders (PVV)",0.834579687085654,0.30171102661597,0
"<anonymized_userid>",3,47211,3175,"Geert Wilders (PVV)",0.83463272341554,0.30180608365019,0
"<anonymized_userid>",3,47214,3176,"Geert Wilders (PVV)",0.834685759745426,0.301901140684411,0
"<anonymized_userid>",3,47217,3177,"Geert Wilders (PVV)",0.834738796075312,0.301996197718631,0
"<anonymized_userid>",3,47220,3178,"Geert Wilders (PVV)",0.834791832405198,0.302091254752852,0
"<anonymized_userid>",3,47223,3179,"Geert Wilders (PVV)",0.834844868735084,0.302186311787072,0
"<anonymized_userid>",3,47226,3180,"Geert Wilders (PVV)",0.83489790506497,0.302281368821293,0
"<anonymized_userid>",3,47229,3181,"Geert Wilders (PVV)",0.834950941394855,0.302376425855513,0
"<anonymized_userid>",3,47232,3182,"Geert Wilders (PVV)",0.835003977724741,0.302471482889734,0
"<anonymized_userid>",3,47235,3183,"Geert Wilders (PVV)",0.835057014054627,0.302566539923954,0
"<anonymized_userid>",3,47238,3184,"Geert Wilders (PVV)",0.835110050384513,0.302661596958175,0
"<anonymized_userid>",3,47241,3185,"Geert Wilders (PVV)",0.835163086714399,0.302756653992395,0
"<anonymized_userid>",3,47244,3186,"Geert Wilders (PVV)",0.835216123044285,0.302851711026616,0
"<anonymized_userid>",3,47247,3187,"Geert Wilders (PVV)",0.835269159374171,0.302946768060836,0
"<anonymized_userid>",3,47250,3188,"Geert Wilders (PVV)",0.835322195704057,0.303041825095057,0
"<anonymized_userid>",3,47253,3189,"Geert Wilders (PVV)",0.835375232033943,0.303136882129278,0
"<anonymized_userid>",3,47256,3190,"Geert Wilders (PVV)",0.835428268363829,0.303231939163498,0
"<anonymized_userid>",3,47259,3191,"Geert Wilders (PVV)",0.835481304693715,0.303326996197719,0
"<anonymized_userid>",3,47262,3192,"Geert Wilders (PVV)",0.835534341023601,0.303422053231939,0
"<anonymized_userid>",3,47265,3193,"Geert Wilders (PVV)",0.835587377353487,0.30351711026616,0
"<anonymized_userid>",3,47268,3194,"Geert Wilders (PVV)",0.835640413683373,0.30361216730038,0
"<anonymized_userid>",3,47271,3195,"Geert Wilders (PVV)",0.835693450013259,0.303707224334601,0
"<anonymized_userid>",3,47274,3196,"Geert Wilders (PVV)",0.835746486343145,0.303802281368821,0
"<anonymized_userid>",3,47277,3197,"Geert Wilders (PVV)",0.835799522673031,0.303897338403042,0
"<anonymized_userid>",3,47280,3198,"Geert Wilders (PVV)",0.835852559002917,0.303992395437262,0
"<anonymized_userid>",3,47283,3199,"Geert Wilders (PVV)",0.835905595332803,0.304087452471483,0
"<anonymized_userid>",3,47286,3200,"Geert Wilders (PVV)",0.835958631662689,0.304182509505703,0
"<anonymized_userid>",3,47289,3201,"Geert Wilders (PVV)",0.836011667992575,0.304277566539924,0
"<anonymized_userid>",3,47292,3202,"Geert Wilders (PVV)",0.836064704322461,0.304372623574144,0
"<anonymized_userid>",3,47295,3203,"Geert Wilders (PVV)",0.836117740652347,0.304467680608365,0
"<anonymized_userid>",3,47298,3204,"Geert Wilders (PVV)",0.836170776982233,0.304562737642586,0
"<anonymized_userid>",3,47301,3205,"Geert Wilders (PVV)",0.836223813312119,0.304657794676806,0
"<anonymized_userid>",3,47304,3206,"Geert Wilders (PVV)",0.836276849642005,0.304752851711027,0
"<anonymized_userid>",3,47307,3207,"Geert Wilders (PVV)",0.836329885971891,0.304847908745247,0
"<anonymized_userid>",3,47310,3208,"Geert Wilders (PVV)",0.836382922301777,0.304942965779468,0
"<anonymized_userid>",3,47313,3209,"Geert Wilders (PVV)",0.836435958631663,0.305038022813688,0
"<anonymized_userid>",3,47316,3210,"Geert Wilders (PVV)",0.836488994961549,0.305133079847909,0
"<anonymized_userid>",3,47319,3211,"Geert Wilders (PVV)",0.836542031291435,0.305228136882129,0
"<anonymized_userid>",3,47322,3212,"Geert Wilders (PVV)",0.836595067621321,0.30532319391635,0
"<anonymized_userid>",3,47325,3213,"Geert Wilders (PVV)",0.836648103951207,0.30541825095057,0
"<anonymized_userid>",3,47328,3214,"Geert Wilders (PVV)",0.836701140281093,0.305513307984791,0
"<anonymized_userid>",3,47331,3215,"Geert Wilders (PVV)",0.836754176610979,0.305608365019011,0
"<anonymized_userid>",3,47334,3216,"Geert Wilders (PVV)",0.836807212940864,0.305703422053232,0
"<anonymized_userid>",3,47337,3217,"Geert Wilders (PVV)",0.83686024927075,0.305798479087452,0
"<anonymized_userid>",3,47340,3218,"Geert Wilders (PVV)",0.836913285600636,0.305893536121673,0
"<anonymized_userid>",3,47343,3219,"Geert Wilders (PVV)",0.836966321930522,0.305988593155894,0
"<anonymized_userid>",3,47346,3220,"Geert Wilders (PVV)",0.837019358260408,0.306083650190114,0
"<anonymized_userid>",3,47349,3221,"Geert Wilders (PVV)",0.837072394590294,0.306178707224335,0
"<anonymized_userid>",3,47352,3222,"Geert Wilders (PVV)",0.83712543092018,0.306273764258555,0
"<anonymized_userid>",3,47355,3223,"Geert Wilders (PVV)",0.837178467250066,0.306368821292776,0
"<anonymized_userid>",3,47358,3224,"Geert Wilders (PVV)",0.837231503579952,0.306463878326996,0
"<anonymized_userid>",3,47361,3225,"Geert Wilders (PVV)",0.837284539909838,0.306558935361217,0
"<anonymized_userid>",3,47364,3226,"Geert Wilders (PVV)",0.837337576239724,0.306653992395437,0
"<anonymized_userid>",3,47367,3227,"Geert Wilders (PVV)",0.83739061256961,0.306749049429658,0
"<anonymized_userid>",3,47370,3228,"Geert Wilders (PVV)",0.837443648899496,0.306844106463878,0
"<anonymized_userid>",3,47373,3229,"Geert Wilders (PVV)",0.837496685229382,0.306939163498099,0
"<anonymized_userid>",3,47376,3230,"Geert Wilders (PVV)",0.837549721559268,0.307034220532319,0
"<anonymized_userid>",3,47379,3231,"Geert Wilders (PVV)",0.837602757889154,0.30712927756654,0
"<anonymized_userid>",3,47382,3232,"Geert Wilders (PVV)",0.83765579421904,0.30722433460076,0
"<anonymized_userid>",3,47385,3233,"Geert Wilders (PVV)",0.837708830548926,0.307319391634981,0
"<anonymized_userid>",3,47388,3234,"Geert Wilders (PVV)",0.837761866878812,0.307414448669202,0
"<anonymized_userid>",3,47391,3235,"Geert Wilders (PVV)",0.837814903208698,0.307509505703422,0
"<anonymized_userid>",3,47394,3236,"Geert Wilders (PVV)",0.837867939538584,0.307604562737643,0
"<anonymized_userid>",3,47397,3237,"Geert Wilders (PVV)",0.83792097586847,0.307699619771863,0
"<anonymized_userid>",3,47400,3238,"Geert Wilders (PVV)",0.837974012198356,0.307794676806084,0
"<anonymized_userid>",3,47403,3239,"Geert Wilders (PVV)",0.838027048528242,0.307889733840304,0
"<anonymized_userid>",3,47406,3240,"Geert Wilders (PVV)",0.838080084858128,0.307984790874525,0
"<anonymized_userid>",3,47409,3241,"Geert Wilders (PVV)",0.838133121188014,0.308079847908745,0
"<anonymized_userid>",3,47412,3242,"Geert Wilders (PVV)",0.8381861575179,0.308174904942966,0
"<anonymized_userid>",3,47415,3243,"Geert Wilders (PVV)",0.838239193847786,0.308269961977186,0
"<anonymized_userid>",3,47418,3244,"Geert Wilders (PVV)",0.838292230177672,0.308365019011407,0
"<anonymized_userid>",3,47421,3245,"Geert Wilders (PVV)",0.838345266507558,0.308460076045627,0
"<anonymized_userid>",3,47424,3246,"Geert Wilders (PVV)",0.838398302837444,0.308555133079848,0
"<anonymized_userid>",3,47427,3247,"Geert Wilders (PVV)",0.83845133916733,0.308650190114068,0
"<anonymized_userid>",3,47430,3248,"Geert Wilders (PVV)",0.838504375497216,0.308745247148289,0
"<anonymized_userid>",3,47433,3249,"Geert Wilders (PVV)",0.838557411827102,0.30884030418251,0
"<anonymized_userid>",3,47436,3250,"Geert Wilders (PVV)",0.838610448156987,0.30893536121673,0
"<anonymized_userid>",3,47439,3251,"Geert Wilders (PVV)",0.838663484486874,0.309030418250951,0
"<anonymized_userid>",3,47442,3252,"Geert Wilders (PVV)",0.83871652081676,0.309125475285171,0
"<anonymized_userid>",3,47445,3253,"Geert Wilders (PVV)",0.838769557146645,0.309220532319392,0
"<anonymized_userid>",3,47448,3254,"Geert Wilders (PVV)",0.838822593476531,0.309315589353612,0
"<anonymized_userid>",3,47451,3255,"Geert Wilders (PVV)",0.838875629806417,0.309410646387833,0
"<anonymized_userid>",3,47454,3256,"Geert Wilders (PVV)",0.838928666136303,0.309505703422053,0
"<anonymized_userid>",3,47457,3257,"Geert Wilders (PVV)",0.838981702466189,0.309600760456274,0
"<anonymized_userid>",3,47460,3258,"Geert Wilders (PVV)",0.839034738796075,0.309695817490494,0
"<anonymized_userid>",3,47463,3259,"Geert Wilders (PVV)",0.839087775125961,0.309790874524715,0
"<anonymized_userid>",3,47466,3260,"Geert Wilders (PVV)",0.839140811455847,0.309885931558935,0
"<anonymized_userid>",3,47469,3261,"Geert Wilders (PVV)",0.839193847785733,0.309980988593156,0
"<anonymized_userid>",3,47472,3262,"Geert Wilders (PVV)",0.839246884115619,0.310076045627376,0
"<anonymized_userid>",3,47475,3263,"Geert Wilders (PVV)",0.839299920445505,0.310171102661597,0
"<anonymized_userid>",3,47478,3264,"Geert Wilders (PVV)",0.839352956775391,0.310266159695818,0
"<anonymized_userid>",3,47481,3265,"Geert Wilders (PVV)",0.839405993105277,0.310361216730038,0
"<anonymized_userid>",3,47484,3266,"Geert Wilders (PVV)",0.839459029435163,0.310456273764259,0
"<anonymized_userid>",3,47487,3267,"Geert Wilders (PVV)",0.839512065765049,0.310551330798479,0
"<anonymized_userid>",3,47490,3268,"Geert Wilders (PVV)",0.839565102094935,0.3106463878327,0
"<anonymized_userid>",3,47493,3269,"Geert Wilders (PVV)",0.839618138424821,0.31074144486692,0
"<anonymized_userid>",3,47496,3270,"Geert Wilders (PVV)",0.839671174754707,0.310836501901141,0
"<anonymized_userid>",3,47499,3271,"Geert Wilders (PVV)",0.839724211084593,0.310931558935361,0
"<anonymized_userid>",3,47502,3272,"Geert Wilders (PVV)",0.839777247414479,0.311026615969582,0
"<anonymized_userid>",3,47505,3273,"Geert Wilders (PVV)",0.839830283744365,0.311121673003802,0
"<anonymized_userid>",3,47508,3274,"Geert Wilders (PVV)",0.839883320074251,0.311216730038023,0
"<anonymized_userid>",3,47511,3275,"Geert Wilders (PVV)",0.839936356404137,0.311311787072243,0
"<anonymized_userid>",3,47514,3276,"Geert Wilders (PVV)",0.839989392734023,0.311406844106464,0
"<anonymized_userid>",3,47517,3277,"Geert Wilders (PVV)",0.840042429063909,0.311501901140684,0
"<anonymized_userid>",3,47520,3278,"Geert Wilders (PVV)",0.840095465393795,0.311596958174905,0
"<anonymized_userid>",3,47523,3279,"Geert Wilders (PVV)",0.840148501723681,0.311692015209125,0
"<anonymized_userid>",3,47526,3280,"Geert Wilders (PVV)",0.840201538053567,0.311787072243346,0
"<anonymized_userid>",3,47529,3281,"Geert Wilders (PVV)",0.840254574383453,0.311882129277567,0
"<anonymized_userid>",3,47532,3282,"Geert Wilders (PVV)",0.840307610713339,0.311977186311787,0
"<anonymized_userid>",3,47535,3283,"Geert Wilders (PVV)",0.840360647043225,0.312072243346008,0
"<anonymized_userid>",3,47538,3284,"Geert Wilders (PVV)",0.840413683373111,0.312167300380228,0
"<anonymized_userid>",3,47541,3285,"Geert Wilders (PVV)",0.840466719702997,0.312262357414449,0
"<anonymized_userid>",3,47544,3286,"Geert Wilders (PVV)",0.840519756032883,0.312357414448669,0
"<anonymized_userid>",3,47547,3287,"Geert Wilders (PVV)",0.840572792362768,0.31245247148289,0
"<anonymized_userid>",3,47550,3288,"Geert Wilders (PVV)",0.840625828692654,0.31254752851711,0
"<anonymized_userid>",3,47553,3289,"Geert Wilders (PVV)",0.84067886502254,0.312642585551331,0
"<anonymized_userid>",3,47556,3290,"Geert Wilders (PVV)",0.840731901352426,0.312737642585551,0
"<anonymized_userid>",3,47559,3291,"Geert Wilders (PVV)",0.840784937682312,0.312832699619772,0
"<anonymized_userid>",3,47562,3292,"Geert Wilders (PVV)",0.840837974012198,0.312927756653992,0
"<anonymized_userid>",3,47565,3293,"Geert Wilders (PVV)",0.840891010342084,0.313022813688213,0
"<anonymized_userid>",3,47568,3294,"Geert Wilders (PVV)",0.84094404667197,0.313117870722433,0
"<anonymized_userid>",3,47571,3295,"Geert Wilders (PVV)",0.840997083001856,0.313212927756654,0
"<anonymized_userid>",3,47574,3296,"Geert Wilders (PVV)",0.841050119331742,0.313307984790875,0
"<anonymized_userid>",3,47577,3297,"Geert Wilders (PVV)",0.841103155661628,0.313403041825095,0
"<anonymized_userid>",3,47580,3298,"Geert Wilders (PVV)",0.841156191991514,0.313498098859316,0
"<anonymized_userid>",3,47583,3299,"Geert Wilders (PVV)",0.8412092283214,0.313593155893536,0
"<anonymized_userid>",3,47586,3300,"Geert Wilders (PVV)",0.841262264651286,0.313688212927757,0
"<anonymized_userid>",3,47589,3301,"Geert Wilders (PVV)",0.841315300981172,0.313783269961977,0
"<anonymized_userid>",3,47592,3302,"Geert Wilders (PVV)",0.841368337311058,0.313878326996198,0
"<anonymized_userid>",3,47595,3303,"Geert Wilders (PVV)",0.841421373640944,0.313973384030418,0
"<anonymized_userid>",3,47598,3304,"Geert Wilders (PVV)",0.84147440997083,0.314068441064639,0
"<anonymized_userid>",3,47601,3305,"Geert Wilders (PVV)",0.841527446300716,0.314163498098859,0
"<anonymized_userid>",3,47604,3306,"Geert Wilders (PVV)",0.841580482630602,0.31425855513308,0
"<anonymized_userid>",3,47607,3307,"Geert Wilders (PVV)",0.841633518960488,0.3143536121673,0
"<anonymized_userid>",3,47610,3308,"Geert Wilders (PVV)",0.841686555290374,0.314448669201521,0
"<anonymized_userid>",3,47613,3309,"Geert Wilders (PVV)",0.84173959162026,0.314543726235741,0
"<anonymized_userid>",3,47616,3310,"Geert Wilders (PVV)",0.841792627950146,0.314638783269962,0
"<anonymized_userid>",3,47619,3311,"Geert Wilders (PVV)",0.841845664280032,0.314733840304182,0
"<anonymized_userid>",3,47622,3312,"Geert Wilders (PVV)",0.841898700609918,0.314828897338403,0
"<anonymized_userid>",3,47625,3313,"Geert Wilders (PVV)",0.841951736939804,0.314923954372624,0
"<anonymized_userid>",3,47628,3314,"Geert Wilders (PVV)",0.84200477326969,0.315019011406844,0
"<anonymized_userid>",3,47631,3315,"Geert Wilders (PVV)",0.842057809599576,0.315114068441065,0
"<anonymized_userid>",3,47634,3316,"Geert Wilders (PVV)",0.842110845929462,0.315209125475285,0
"<anonymized_userid>",3,47637,3317,"Geert Wilders (PVV)",0.842163882259348,0.315304182509506,0
"<anonymized_userid>",3,47640,3318,"Geert Wilders (PVV)",0.842216918589234,0.315399239543726,0
"<anonymized_userid>",3,47643,3319,"Geert Wilders (PVV)",0.84226995491912,0.315494296577947,0
"<anonymized_userid>",3,47646,3320,"Geert Wilders (PVV)",0.842322991249006,0.315589353612167,0
"<anonymized_userid>",3,47649,3321,"Geert Wilders (PVV)",0.842376027578892,0.315684410646388,0
"<anonymized_userid>",3,47652,3322,"Geert Wilders (PVV)",0.842429063908777,0.315779467680608,0
"<anonymized_userid>",3,47655,3323,"Geert Wilders (PVV)",0.842482100238663,0.315874524714829,0
"<anonymized_userid>",3,47658,3324,"Geert Wilders (PVV)",0.84253513656855,0.315969581749049,0
"<anonymized_userid>",3,47661,3325,"Geert Wilders (PVV)",0.842588172898435,0.31606463878327,0
"<anonymized_userid>",3,47664,3326,"Geert Wilders (PVV)",0.842641209228321,0.31615969581749,0
"<anonymized_userid>",3,47667,3327,"Geert Wilders (PVV)",0.842694245558207,0.316254752851711,0
"<anonymized_userid>",3,47670,3328,"Geert Wilders (PVV)",0.842747281888093,0.316349809885932,0
"<anonymized_userid>",3,47673,3329,"Geert Wilders (PVV)",0.842800318217979,0.316444866920152,0
"<anonymized_userid>",3,47676,3330,"Geert Wilders (PVV)",0.842853354547865,0.316539923954373,0
"<anonymized_userid>",3,47679,3331,"Geert Wilders (PVV)",0.842906390877751,0.316634980988593,0
"<anonymized_userid>",3,47682,3332,"Geert Wilders (PVV)",0.842959427207637,0.316730038022814,0
"<anonymized_userid>",3,47685,3333,"Geert Wilders (PVV)",0.843012463537523,0.316825095057034,0
"<anonymized_userid>",3,47688,3334,"Geert Wilders (PVV)",0.843065499867409,0.316920152091255,0
"<anonymized_userid>",3,47691,3335,"Geert Wilders (PVV)",0.843118536197295,0.317015209125475,0
"<anonymized_userid>",3,47694,3336,"Geert Wilders (PVV)",0.843171572527181,0.317110266159696,0
"<anonymized_userid>",3,47697,3337,"Geert Wilders (PVV)",0.843224608857067,0.317205323193916,0
"<anonymized_userid>",3,47700,3338,"Geert Wilders (PVV)",0.843277645186953,0.317300380228137,0
"<anonymized_userid>",3,47703,3339,"Geert Wilders (PVV)",0.843330681516839,0.317395437262357,0
"<anonymized_userid>",3,47706,3340,"Geert Wilders (PVV)",0.843383717846725,0.317490494296578,0
"<anonymized_userid>",3,47709,3341,"Geert Wilders (PVV)",0.843436754176611,0.317585551330798,0
"<anonymized_userid>",3,47712,3342,"Geert Wilders (PVV)",0.843489790506497,0.317680608365019,0
"<anonymized_userid>",3,47715,3343,"Geert Wilders (PVV)",0.843542826836383,0.31777566539924,0
"<anonymized_userid>",3,47718,3344,"Geert Wilders (PVV)",0.843595863166269,0.31787072243346,0
"<anonymized_userid>",3,47721,3345,"Geert Wilders (PVV)",0.843648899496155,0.317965779467681,0
"<anonymized_userid>",3,47724,3346,"Geert Wilders (PVV)",0.843701935826041,0.318060836501901,0
"<anonymized_userid>",3,47727,3347,"Geert Wilders (PVV)",0.843754972155927,0.318155893536122,0
"<anonymized_userid>",3,47730,3348,"Geert Wilders (PVV)",0.843808008485813,0.318250950570342,0
"<anonymized_userid>",3,47733,3349,"Geert Wilders (PVV)",0.843861044815699,0.318346007604563,0
"<anonymized_userid>",3,47736,3350,"Geert Wilders (PVV)",0.843914081145585,0.318441064638783,0
"<anonymized_userid>",3,47739,3351,"Geert Wilders (PVV)",0.843967117475471,0.318536121673004,0
"<anonymized_userid>",3,47742,3352,"Geert Wilders (PVV)",0.844020153805357,0.318631178707224,0
"<anonymized_userid>",3,47745,3353,"Geert Wilders (PVV)",0.844073190135243,0.318726235741445,0
"<anonymized_userid>",3,47748,3354,"Geert Wilders (PVV)",0.844126226465129,0.318821292775665,0
"<anonymized_userid>",3,47751,3355,"Geert Wilders (PVV)",0.844179262795015,0.318916349809886,0
"<anonymized_userid>",3,47754,3356,"Geert Wilders (PVV)",0.844232299124901,0.319011406844106,0
"<anonymized_userid>",3,47757,3357,"Geert Wilders (PVV)",0.844285335454787,0.319106463878327,0
"<anonymized_userid>",3,47760,3358,"Geert Wilders (PVV)",0.844338371784673,0.319201520912548,0
"<anonymized_userid>",3,47763,3359,"Geert Wilders (PVV)",0.844391408114558,0.319296577946768,0
"<anonymized_userid>",3,47766,3360,"Geert Wilders (PVV)",0.844444444444444,0.319391634980989,0
"<anonymized_userid>",3,47769,3361,"Geert Wilders (PVV)",0.84449748077433,0.319486692015209,0
"<anonymized_userid>",3,47772,3362,"Geert Wilders (PVV)",0.844550517104216,0.31958174904943,0
"<anonymized_userid>",3,47775,3363,"Geert Wilders (PVV)",0.844603553434102,0.31967680608365,0
"<anonymized_userid>",3,47778,3364,"Geert Wilders (PVV)",0.844656589763988,0.319771863117871,0
"<anonymized_userid>",3,47781,3365,"Geert Wilders (PVV)",0.844709626093874,0.319866920152091,0
"<anonymized_userid>",3,47784,3366,"Geert Wilders (PVV)",0.84476266242376,0.319961977186312,0
"<anonymized_userid>",3,47787,3367,"Geert Wilders (PVV)",0.844815698753646,0.320057034220532,0
"<anonymized_userid>",3,47790,3368,"Geert Wilders (PVV)",0.844868735083532,0.320152091254753,0
"<anonymized_userid>",3,47793,3369,"Geert Wilders (PVV)",0.844921771413418,0.320247148288973,0
"<anonymized_userid>",3,47796,3370,"Geert Wilders (PVV)",0.844974807743304,0.320342205323194,0
"<anonymized_userid>",3,47799,3371,"Geert Wilders (PVV)",0.84502784407319,0.320437262357414,0
"<anonymized_userid>",3,47802,3372,"Geert Wilders (PVV)",0.845080880403076,0.320532319391635,0
"<anonymized_userid>",3,47805,3373,"Geert Wilders (PVV)",0.845133916732962,0.320627376425856,0
"<anonymized_userid>",3,47808,3374,"Geert Wilders (PVV)",0.845186953062848,0.320722433460076,0
"<anonymized_userid>",3,47811,3375,"Geert Wilders (PVV)",0.845239989392734,0.320817490494297,0
"<anonymized_userid>",3,47814,3376,"Geert Wilders (PVV)",0.84529302572262,0.320912547528517,0
"<anonymized_userid>",3,47817,3377,"Geert Wilders (PVV)",0.845346062052506,0.321007604562738,0
"<anonymized_userid>",3,47820,3378,"Geert Wilders (PVV)",0.845399098382392,0.321102661596958,0
"<anonymized_userid>",3,47823,3379,"Geert Wilders (PVV)",0.845452134712278,0.321197718631179,0
"<anonymized_userid>",3,47826,3380,"Geert Wilders (PVV)",0.845505171042164,0.321292775665399,0
"<anonymized_userid>",3,47829,3381,"Geert Wilders (PVV)",0.84555820737205,0.32138783269962,0
"<anonymized_userid>",3,47832,3382,"Geert Wilders (PVV)",0.845611243701936,0.32148288973384,0
"<anonymized_userid>",3,47835,3383,"Geert Wilders (PVV)",0.845664280031822,0.321577946768061,0
"<anonymized_userid>",3,47838,3384,"Geert Wilders (PVV)",0.845717316361708,0.321673003802281,0
"<anonymized_userid>",3,47841,3385,"Geert Wilders (PVV)",0.845770352691594,0.321768060836502,0
"<anonymized_userid>",3,47844,3386,"Geert Wilders (PVV)",0.84582338902148,0.321863117870722,0
"<anonymized_userid>",3,47847,3387,"Geert Wilders (PVV)",0.845876425351366,0.321958174904943,0
"<anonymized_userid>",3,47850,3388,"Geert Wilders (PVV)",0.845929461681252,0.322053231939164,0
"<anonymized_userid>",3,47853,3389,"Geert Wilders (PVV)",0.845982498011138,0.322148288973384,0
"<anonymized_userid>",3,47856,3390,"Geert Wilders (PVV)",0.846035534341024,0.322243346007605,0
"<anonymized_userid>",3,47859,3391,"Geert Wilders (PVV)",0.84608857067091,0.322338403041825,0
"<anonymized_userid>",3,47862,3392,"Geert Wilders (PVV)",0.846141607000796,0.322433460076046,0
"<anonymized_userid>",3,47865,3393,"Geert Wilders (PVV)",0.846194643330682,0.322528517110266,0
"<anonymized_userid>",3,47868,3394,"Geert Wilders (PVV)",0.846247679660567,0.322623574144487,0
"<anonymized_userid>",3,47871,3395,"Geert Wilders (PVV)",0.846300715990453,0.322718631178707,0
"<anonymized_userid>",3,47874,3396,"Geert Wilders (PVV)",0.846353752320339,0.322813688212928,0
"<anonymized_userid>",3,47877,3397,"Geert Wilders (PVV)",0.846406788650225,0.322908745247148,0
"<anonymized_userid>",3,47880,3398,"Geert Wilders (PVV)",0.846459824980111,0.323003802281369,0
"<anonymized_userid>",3,47883,3399,"Geert Wilders (PVV)",0.846512861309997,0.323098859315589,0
"<anonymized_userid>",3,47886,3400,"Geert Wilders (PVV)",0.846565897639883,0.32319391634981,0
"<anonymized_userid>",3,47889,3401,"Geert Wilders (PVV)",0.846618933969769,0.32328897338403,0
"<anonymized_userid>",3,47892,3402,"Geert Wilders (PVV)",0.846671970299655,0.323384030418251,0
"<anonymized_userid>",3,47895,3403,"Geert Wilders (PVV)",0.846725006629541,0.323479087452472,0
"<anonymized_userid>",3,47898,3404,"Geert Wilders (PVV)",0.846778042959427,0.323574144486692,0
"<anonymized_userid>",3,47901,3405,"Geert Wilders (PVV)",0.846831079289313,0.323669201520913,0
"<anonymized_userid>",3,47904,3406,"Geert Wilders (PVV)",0.846884115619199,0.323764258555133,0
"<anonymized_userid>",3,47907,3407,"Geert Wilders (PVV)",0.846937151949085,0.323859315589354,0
"<anonymized_userid>",3,47910,3408,"Geert Wilders (PVV)",0.846990188278971,0.323954372623574,0
"<anonymized_userid>",3,47913,3409,"Geert Wilders (PVV)",0.847043224608857,0.324049429657795,0
"<anonymized_userid>",3,47916,3410,"Geert Wilders (PVV)",0.847096260938743,0.324144486692015,0
"<anonymized_userid>",3,47919,3411,"Geert Wilders (PVV)",0.847149297268629,0.324239543726236,0
"<anonymized_userid>",3,47922,3412,"Geert Wilders (PVV)",0.847202333598515,0.324334600760456,0
"<anonymized_userid>",3,47925,3413,"Geert Wilders (PVV)",0.847255369928401,0.324429657794677,0
"<anonymized_userid>",3,47928,3414,"Geert Wilders (PVV)",0.847308406258287,0.324524714828897,0
"<anonymized_userid>",3,47931,3415,"Geert Wilders (PVV)",0.847361442588173,0.324619771863118,0
"<anonymized_userid>",3,47934,3416,"Geert Wilders (PVV)",0.847414478918059,0.324714828897338,0
"<anonymized_userid>",3,47937,3417,"Geert Wilders (PVV)",0.847467515247945,0.324809885931559,0
"<anonymized_userid>",3,47940,3418,"Geert Wilders (PVV)",0.847520551577831,0.324904942965779,0
"<anonymized_userid>",3,47943,3419,"Geert Wilders (PVV)",0.847573587907717,0.325,0
"<anonymized_userid>",3,47946,3420,"Geert Wilders (PVV)",0.847626624237603,0.325095057034221,0
"<anonymized_userid>",3,47949,3421,"Geert Wilders (PVV)",0.847679660567489,0.325190114068441,0
"<anonymized_userid>",3,47952,3422,"Geert Wilders (PVV)",0.847732696897375,0.325285171102662,0
"<anonymized_userid>",3,47955,3423,"Geert Wilders (PVV)",0.847785733227261,0.325380228136882,0
"<anonymized_userid>",3,47958,3424,"Geert Wilders (PVV)",0.847838769557147,0.325475285171103,0
"<anonymized_userid>",3,47961,3425,"Geert Wilders (PVV)",0.847891805887033,0.325570342205323,0
"<anonymized_userid>",3,47964,3426,"Geert Wilders (PVV)",0.847944842216919,0.325665399239544,0
"<anonymized_userid>",3,47967,3427,"Geert Wilders (PVV)",0.847997878546805,0.325760456273764,0
"<anonymized_userid>",3,47970,3428,"Geert Wilders (PVV)",0.84805091487669,0.325855513307985,0
"<anonymized_userid>",3,47973,3429,"Geert Wilders (PVV)",0.848103951206577,0.325950570342205,0
"<anonymized_userid>",3,47976,3430,"Geert Wilders (PVV)",0.848156987536463,0.326045627376426,0
"<anonymized_userid>",3,47979,3431,"Geert Wilders (PVV)",0.848210023866348,0.326140684410646,0
"<anonymized_userid>",3,47982,3432,"Geert Wilders (PVV)",0.848263060196234,0.326235741444867,0
"<anonymized_userid>",3,47985,3433,"Geert Wilders (PVV)",0.84831609652612,0.326330798479087,0
"<anonymized_userid>",3,47988,3434,"Geert Wilders (PVV)",0.848369132856006,0.326425855513308,0
"<anonymized_userid>",3,47991,3435,"Geert Wilders (PVV)",0.848422169185892,0.326520912547529,0
"<anonymized_userid>",3,47994,3436,"Geert Wilders (PVV)",0.848475205515778,0.326615969581749,0
"<anonymized_userid>",3,47997,3437,"Geert Wilders (PVV)",0.848528241845664,0.32671102661597,0
"<anonymized_userid>",3,48000,3438,"Geert Wilders (PVV)",0.84858127817555,0.32680608365019,0
"<anonymized_userid>",3,48003,3439,"Geert Wilders (PVV)",0.848634314505436,0.326901140684411,0
"<anonymized_userid>",3,48006,3440,"Geert Wilders (PVV)",0.848687350835322,0.326996197718631,0
"<anonymized_userid>",3,48009,3441,"Geert Wilders (PVV)",0.848740387165208,0.327091254752852,0
"<anonymized_userid>",3,48012,3442,"Geert Wilders (PVV)",0.848793423495094,0.327186311787072,0
"<anonymized_userid>",3,48015,3443,"Geert Wilders (PVV)",0.84884645982498,0.327281368821293,0
"<anonymized_userid>",3,48018,3444,"Geert Wilders (PVV)",0.848899496154866,0.327376425855513,0
"<anonymized_userid>",3,48021,3445,"Geert Wilders (PVV)",0.848952532484752,0.327471482889734,0
"<anonymized_userid>",3,48024,3446,"Geert Wilders (PVV)",0.849005568814638,0.327566539923954,0
"<anonymized_userid>",3,48027,3447,"Geert Wilders (PVV)",0.849058605144524,0.327661596958175,0
"<anonymized_userid>",3,48030,3448,"Geert Wilders (PVV)",0.84911164147441,0.327756653992395,0
"<anonymized_userid>",3,48033,3449,"Geert Wilders (PVV)",0.849164677804296,0.327851711026616,0
"<anonymized_userid>",3,48036,3450,"Geert Wilders (PVV)",0.849217714134182,0.327946768060837,0
"<anonymized_userid>",3,48039,3451,"Geert Wilders (PVV)",0.849270750464068,0.328041825095057,0
"<anonymized_userid>",3,48042,3452,"Geert Wilders (PVV)",0.849323786793954,0.328136882129278,0
"<anonymized_userid>",3,48045,3453,"Geert Wilders (PVV)",0.84937682312384,0.328231939163498,0
"<anonymized_userid>",3,48048,3454,"Geert Wilders (PVV)",0.849429859453726,0.328326996197719,0
"<anonymized_userid>",3,48051,3455,"Geert Wilders (PVV)",0.849482895783612,0.328422053231939,0
"<anonymized_userid>",3,48054,3456,"Geert Wilders (PVV)",0.849535932113498,0.32851711026616,0
"<anonymized_userid>",3,48057,3457,"Geert Wilders (PVV)",0.849588968443384,0.32861216730038,0
"<anonymized_userid>",3,48060,3458,"Geert Wilders (PVV)",0.84964200477327,0.328707224334601,0
"<anonymized_userid>",3,48063,3459,"Geert Wilders (PVV)",0.849695041103156,0.328802281368821,0
"<anonymized_userid>",3,48066,3460,"Geert Wilders (PVV)",0.849748077433042,0.328897338403042,0
"<anonymized_userid>",3,48069,3461,"Geert Wilders (PVV)",0.849801113762928,0.328992395437262,0
"<anonymized_userid>",3,48072,3462,"Geert Wilders (PVV)",0.849854150092814,0.329087452471483,0
"<anonymized_userid>",3,48075,3463,"Geert Wilders (PVV)",0.8499071864227,0.329182509505703,0
"<anonymized_userid>",3,48078,3464,"Geert Wilders (PVV)",0.849960222752586,0.329277566539924,0
"<anonymized_userid>",3,48081,3465,"Geert Wilders (PVV)",0.850013259082471,0.329372623574144,0
"<anonymized_userid>",3,48084,3466,"Geert Wilders (PVV)",0.850066295412357,0.329467680608365,0
"<anonymized_userid>",3,48087,3467,"Geert Wilders (PVV)",0.850119331742243,0.329562737642586,0
"<anonymized_userid>",3,48090,3468,"Geert Wilders (PVV)",0.850172368072129,0.329657794676806,0
"<anonymized_userid>",3,48093,3469,"Geert Wilders (PVV)",0.850225404402015,0.329752851711027,0
"<anonymized_userid>",3,48096,3470,"Geert Wilders (PVV)",0.850278440731901,0.329847908745247,0
"<anonymized_userid>",3,48099,3471,"Geert Wilders (PVV)",0.850331477061787,0.329942965779468,0
"<anonymized_userid>",3,48102,3472,"Geert Wilders (PVV)",0.850384513391673,0.330038022813688,0
"<anonymized_userid>",3,48105,3473,"Geert Wilders (PVV)",0.850437549721559,0.330133079847909,0
"<anonymized_userid>",3,48108,3474,"Geert Wilders (PVV)",0.850490586051445,0.330228136882129,0
"<anonymized_userid>",3,48111,3475,"Geert Wilders (PVV)",0.850543622381331,0.33032319391635,0
"<anonymized_userid>",3,48114,3476,"Geert Wilders (PVV)",0.850596658711217,0.33041825095057,0
"<anonymized_userid>",2,48116,3477,"Geert Wilders (PVV)",0.850632016264474,0.330513307984791,0
"<anonymized_userid>",2,48118,3478,"Geert Wilders (PVV)",0.850667373817732,0.330608365019011,0
"<anonymized_userid>",2,48120,3479,"Geert Wilders (PVV)",0.850702731370989,0.330703422053232,0
"<anonymized_userid>",2,48122,3480,"Geert Wilders (PVV)",0.850738088924246,0.330798479087452,0
"<anonymized_userid>",2,48124,3481,"Geert Wilders (PVV)",0.850773446477504,0.330893536121673,0
"<anonymized_userid>",2,48126,3482,"Geert Wilders (PVV)",0.850808804030761,0.330988593155894,0
"<anonymized_userid>",2,48128,3483,"Geert Wilders (PVV)",0.850844161584018,0.331083650190114,0
"<anonymized_userid>",2,48130,3484,"Geert Wilders (PVV)",0.850879519137276,0.331178707224335,0
"<anonymized_userid>",2,48132,3485,"Geert Wilders (PVV)",0.850914876690533,0.331273764258555,0
"<anonymized_userid>",2,48134,3486,"Geert Wilders (PVV)",0.85095023424379,0.331368821292776,0
"<anonymized_userid>",2,48136,3487,"Geert Wilders (PVV)",0.850985591797048,0.331463878326996,0
"<anonymized_userid>",2,48138,3488,"Geert Wilders (PVV)",0.851020949350305,0.331558935361217,0
"<anonymized_userid>",2,48140,3489,"Geert Wilders (PVV)",0.851056306903562,0.331653992395437,0
"<anonymized_userid>",2,48142,3490,"Geert Wilders (PVV)",0.85109166445682,0.331749049429658,0
"<anonymized_userid>",2,48144,3491,"Geert Wilders (PVV)",0.851127022010077,0.331844106463878,0
"<anonymized_userid>",2,48146,3492,"Geert Wilders (PVV)",0.851162379563334,0.331939163498099,0
"<anonymized_userid>",2,48148,3493,"Geert Wilders (PVV)",0.851197737116592,0.332034220532319,0
"<anonymized_userid>",2,48150,3494,"Geert Wilders (PVV)",0.851233094669849,0.33212927756654,0
"<anonymized_userid>",2,48152,3495,"Geert Wilders (PVV)",0.851268452223106,0.33222433460076,0
"<anonymized_userid>",2,48154,3496,"Geert Wilders (PVV)",0.851303809776363,0.332319391634981,0
"<anonymized_userid>",2,48156,3497,"Geert Wilders (PVV)",0.851339167329621,0.332414448669202,0
"<anonymized_userid>",2,48158,3498,"Geert Wilders (PVV)",0.851374524882878,0.332509505703422,0
"<anonymized_userid>",2,48160,3499,"Geert Wilders (PVV)",0.851409882436135,0.332604562737643,0
"<anonymized_userid>",2,48162,3500,"Geert Wilders (PVV)",0.851445239989393,0.332699619771863,0
"<anonymized_userid>",2,48164,3501,"Geert Wilders (PVV)",0.85148059754265,0.332794676806084,0
"<anonymized_userid>",2,48166,3502,"Geert Wilders (PVV)",0.851515955095907,0.332889733840304,0
"<anonymized_userid>",2,48168,3503,"Geert Wilders (PVV)",0.851551312649165,0.332984790874525,0
"<anonymized_userid>",2,48170,3504,"Geert Wilders (PVV)",0.851586670202422,0.333079847908745,0
"<anonymized_userid>",2,48172,3505,"Geert Wilders (PVV)",0.851622027755679,0.333174904942966,0
"<anonymized_userid>",2,48174,3506,"Geert Wilders (PVV)",0.851657385308937,0.333269961977186,0
"<anonymized_userid>",2,48176,3507,"Geert Wilders (PVV)",0.851692742862194,0.333365019011407,0
"<anonymized_userid>",2,48178,3508,"Geert Wilders (PVV)",0.851728100415451,0.333460076045627,0
"<anonymized_userid>",2,48180,3509,"Geert Wilders (PVV)",0.851763457968709,0.333555133079848,0
"<anonymized_userid>",2,48182,3510,"Geert Wilders (PVV)",0.851798815521966,0.333650190114068,0
"<anonymized_userid>",2,48184,3511,"Geert Wilders (PVV)",0.851834173075223,0.333745247148289,0
"<anonymized_userid>",2,48186,3512,"Geert Wilders (PVV)",0.85186953062848,0.333840304182509,0
"<anonymized_userid>",2,48188,3513,"Geert Wilders (PVV)",0.851904888181738,0.33393536121673,0
"<anonymized_userid>",2,48190,3514,"Geert Wilders (PVV)",0.851940245734995,0.334030418250951,0
"<anonymized_userid>",2,48192,3515,"Geert Wilders (PVV)",0.851975603288253,0.334125475285171,0
"<anonymized_userid>",2,48194,3516,"Geert Wilders (PVV)",0.85201096084151,0.334220532319392,0
"<anonymized_userid>",2,48196,3517,"Geert Wilders (PVV)",0.852046318394767,0.334315589353612,0
"<anonymized_userid>",2,48198,3518,"Geert Wilders (PVV)",0.852081675948024,0.334410646387833,0
"<anonymized_userid>",2,48200,3519,"Geert Wilders (PVV)",0.852117033501282,0.334505703422053,0
"<anonymized_userid>",2,48202,3520,"Geert Wilders (PVV)",0.852152391054539,0.334600760456274,0
"<anonymized_userid>",2,48204,3521,"Geert Wilders (PVV)",0.852187748607796,0.334695817490494,0
"<anonymized_userid>",2,48206,3522,"Geert Wilders (PVV)",0.852223106161054,0.334790874524715,0
"<anonymized_userid>",2,48208,3523,"Geert Wilders (PVV)",0.852258463714311,0.334885931558935,0
"<anonymized_userid>",2,48210,3524,"Geert Wilders (PVV)",0.852293821267568,0.334980988593156,0
"<anonymized_userid>",2,48212,3525,"Geert Wilders (PVV)",0.852329178820826,0.335076045627376,0
"<anonymized_userid>",2,48214,3526,"Geert Wilders (PVV)",0.852364536374083,0.335171102661597,0
"<anonymized_userid>",2,48216,3527,"Geert Wilders (PVV)",0.85239989392734,0.335266159695817,0
"<anonymized_userid>",2,48218,3528,"Geert Wilders (PVV)",0.852435251480598,0.335361216730038,0
"<anonymized_userid>",2,48220,3529,"Geert Wilders (PVV)",0.852470609033855,0.335456273764259,0
"<anonymized_userid>",2,48222,3530,"Geert Wilders (PVV)",0.852505966587112,0.335551330798479,0
"<anonymized_userid>",2,48224,3531,"Geert Wilders (PVV)",0.85254132414037,0.3356463878327,0
"<anonymized_userid>",2,48226,3532,"Geert Wilders (PVV)",0.852576681693627,0.33574144486692,0
"<anonymized_userid>",2,48228,3533,"Geert Wilders (PVV)",0.852612039246884,0.335836501901141,0
"<anonymized_userid>",2,48230,3534,"Geert Wilders (PVV)",0.852647396800141,0.335931558935361,0
"<anonymized_userid>",2,48232,3535,"Geert Wilders (PVV)",0.852682754353399,0.336026615969582,0
"<anonymized_userid>",2,48234,3536,"Geert Wilders (PVV)",0.852718111906656,0.336121673003802,0
"<anonymized_userid>",2,48236,3537,"Geert Wilders (PVV)",0.852753469459913,0.336216730038023,0
"<anonymized_userid>",2,48238,3538,"Geert Wilders (PVV)",0.852788827013171,0.336311787072243,0
"<anonymized_userid>",2,48240,3539,"Geert Wilders (PVV)",0.852824184566428,0.336406844106464,0
"<anonymized_userid>",2,48242,3540,"Geert Wilders (PVV)",0.852859542119685,0.336501901140684,0
"<anonymized_userid>",2,48244,3541,"Geert Wilders (PVV)",0.852894899672943,0.336596958174905,0
"<anonymized_userid>",2,48246,3542,"Geert Wilders (PVV)",0.8529302572262,0.336692015209125,0
"<anonymized_userid>",2,48248,3543,"Geert Wilders (PVV)",0.852965614779457,0.336787072243346,0
"<anonymized_userid>",2,48250,3544,"Geert Wilders (PVV)",0.853000972332715,0.336882129277567,0
"<anonymized_userid>",2,48252,3545,"Geert Wilders (PVV)",0.853036329885972,0.336977186311787,0
"<anonymized_userid>",2,48254,3546,"Geert Wilders (PVV)",0.853071687439229,0.337072243346008,0
"<anonymized_userid>",2,48256,3547,"Geert Wilders (PVV)",0.853107044992487,0.337167300380228,0
"<anonymized_userid>",2,48258,3548,"Geert Wilders (PVV)",0.853142402545744,0.337262357414449,0
"<anonymized_userid>",2,48260,3549,"Geert Wilders (PVV)",0.853177760099001,0.337357414448669,0
"<anonymized_userid>",2,48262,3550,"Geert Wilders (PVV)",0.853213117652258,0.33745247148289,0
"<anonymized_userid>",2,48264,3551,"Geert Wilders (PVV)",0.853248475205516,0.33754752851711,0
"<anonymized_userid>",2,48266,3552,"Geert Wilders (PVV)",0.853283832758773,0.337642585551331,0
"<anonymized_userid>",2,48268,3553,"Geert Wilders (PVV)",0.85331919031203,0.337737642585551,0
"<anonymized_userid>",2,48270,3554,"Geert Wilders (PVV)",0.853354547865288,0.337832699619772,0
"<anonymized_userid>",2,48272,3555,"Geert Wilders (PVV)",0.853389905418545,0.337927756653992,0
"<anonymized_userid>",2,48274,3556,"Geert Wilders (PVV)",0.853425262971802,0.338022813688213,0
"<anonymized_userid>",2,48276,3557,"Geert Wilders (PVV)",0.85346062052506,0.338117870722433,0
"<anonymized_userid>",2,48278,3558,"Geert Wilders (PVV)",0.853495978078317,0.338212927756654,0
"<anonymized_userid>",2,48280,3559,"Geert Wilders (PVV)",0.853531335631574,0.338307984790875,0
"<anonymized_userid>",2,48282,3560,"Geert Wilders (PVV)",0.853566693184832,0.338403041825095,0
"<anonymized_userid>",2,48284,3561,"Geert Wilders (PVV)",0.853602050738089,0.338498098859316,0
"<anonymized_userid>",2,48286,3562,"Geert Wilders (PVV)",0.853637408291346,0.338593155893536,0
"<anonymized_userid>",2,48288,3563,"Geert Wilders (PVV)",0.853672765844603,0.338688212927757,0
"<anonymized_userid>",2,48290,3564,"Geert Wilders (PVV)",0.853708123397861,0.338783269961977,0
"<anonymized_userid>",2,48292,3565,"Geert Wilders (PVV)",0.853743480951118,0.338878326996198,0
"<anonymized_userid>",2,48294,3566,"Geert Wilders (PVV)",0.853778838504376,0.338973384030418,0
"<anonymized_userid>",2,48296,3567,"Geert Wilders (PVV)",0.853814196057633,0.339068441064639,0
"<anonymized_userid>",2,48298,3568,"Geert Wilders (PVV)",0.85384955361089,0.339163498098859,0
"<anonymized_userid>",2,48300,3569,"Geert Wilders (PVV)",0.853884911164147,0.33925855513308,0
"<anonymized_userid>",2,48302,3570,"Geert Wilders (PVV)",0.853920268717405,0.3393536121673,0
"<anonymized_userid>",2,48304,3571,"Geert Wilders (PVV)",0.853955626270662,0.339448669201521,0
"<anonymized_userid>",2,48306,3572,"Geert Wilders (PVV)",0.853990983823919,0.339543726235741,0
"<anonymized_userid>",2,48308,3573,"Geert Wilders (PVV)",0.854026341377177,0.339638783269962,0
"<anonymized_userid>",2,48310,3574,"Geert Wilders (PVV)",0.854061698930434,0.339733840304183,0
"<anonymized_userid>",2,48312,3575,"Geert Wilders (PVV)",0.854097056483691,0.339828897338403,0
"<anonymized_userid>",2,48314,3576,"Geert Wilders (PVV)",0.854132414036949,0.339923954372624,0
"<anonymized_userid>",2,48316,3577,"Geert Wilders (PVV)",0.854167771590206,0.340019011406844,0
"<anonymized_userid>",2,48318,3578,"Geert Wilders (PVV)",0.854203129143463,0.340114068441065,0
"<anonymized_userid>",2,48320,3579,"Geert Wilders (PVV)",0.854238486696721,0.340209125475285,0
"<anonymized_userid>",2,48322,3580,"Geert Wilders (PVV)",0.854273844249978,0.340304182509506,0
"<anonymized_userid>",2,48324,3581,"Geert Wilders (PVV)",0.854309201803235,0.340399239543726,0
"<anonymized_userid>",2,48326,3582,"Geert Wilders (PVV)",0.854344559356493,0.340494296577947,0
"<anonymized_userid>",2,48328,3583,"Geert Wilders (PVV)",0.85437991690975,0.340589353612167,0
"<anonymized_userid>",2,48330,3584,"Geert Wilders (PVV)",0.854415274463007,0.340684410646388,0
"<anonymized_userid>",2,48332,3585,"Geert Wilders (PVV)",0.854450632016264,0.340779467680608,0
"<anonymized_userid>",2,48334,3586,"Geert Wilders (PVV)",0.854485989569522,0.340874524714829,0
"<anonymized_userid>",2,48336,3587,"Geert Wilders (PVV)",0.854521347122779,0.340969581749049,0
"<anonymized_userid>",2,48338,3588,"Geert Wilders (PVV)",0.854556704676036,0.34106463878327,0
"<anonymized_userid>",2,48340,3589,"Geert Wilders (PVV)",0.854592062229294,0.341159695817491,0
"<anonymized_userid>",2,48342,3590,"Geert Wilders (PVV)",0.854627419782551,0.341254752851711,0
"<anonymized_userid>",2,48344,3591,"Geert Wilders (PVV)",0.854662777335808,0.341349809885932,0
"<anonymized_userid>",2,48346,3592,"Geert Wilders (PVV)",0.854698134889066,0.341444866920152,0
"<anonymized_userid>",2,48348,3593,"Geert Wilders (PVV)",0.854733492442323,0.341539923954373,0
"<anonymized_userid>",2,48350,3594,"Geert Wilders (PVV)",0.85476884999558,0.341634980988593,0
"<anonymized_userid>",2,48352,3595,"Geert Wilders (PVV)",0.854804207548838,0.341730038022814,0
"<anonymized_userid>",2,48354,3596,"Geert Wilders (PVV)",0.854839565102095,0.341825095057034,0
"<anonymized_userid>",2,48356,3597,"Geert Wilders (PVV)",0.854874922655352,0.341920152091255,0
"<anonymized_userid>",2,48358,3598,"Geert Wilders (PVV)",0.85491028020861,0.342015209125475,0
"<anonymized_userid>",2,48360,3599,"Geert Wilders (PVV)",0.854945637761867,0.342110266159696,0
"<anonymized_userid>",2,48362,3600,"Geert Wilders (PVV)",0.854980995315124,0.342205323193916,0
"<anonymized_userid>",2,48364,3601,"Geert Wilders (PVV)",0.855016352868382,0.342300380228137,0
"<anonymized_userid>",2,48366,3602,"Geert Wilders (PVV)",0.855051710421639,0.342395437262357,0
"<anonymized_userid>",2,48368,3603,"Geert Wilders (PVV)",0.855087067974896,0.342490494296578,0
"<anonymized_userid>",2,48370,3604,"Geert Wilders (PVV)",0.855122425528153,0.342585551330798,0
"<anonymized_userid>",2,48372,3605,"Geert Wilders (PVV)",0.855157783081411,0.342680608365019,0
"<anonymized_userid>",2,48374,3606,"Geert Wilders (PVV)",0.855193140634668,0.34277566539924,0
"<anonymized_userid>",2,48376,3607,"Geert Wilders (PVV)",0.855228498187925,0.34287072243346,0
"<anonymized_userid>",2,48378,3608,"Geert Wilders (PVV)",0.855263855741183,0.342965779467681,0
"<anonymized_userid>",2,48380,3609,"Geert Wilders (PVV)",0.85529921329444,0.343060836501901,0
"<anonymized_userid>",2,48382,3610,"Geert Wilders (PVV)",0.855334570847697,0.343155893536122,0
"<anonymized_userid>",2,48384,3611,"Geert Wilders (PVV)",0.855369928400955,0.343250950570342,0
"<anonymized_userid>",2,48386,3612,"Geert Wilders (PVV)",0.855405285954212,0.343346007604563,0
"<anonymized_userid>",2,48388,3613,"Geert Wilders (PVV)",0.855440643507469,0.343441064638783,0
"<anonymized_userid>",2,48390,3614,"Geert Wilders (PVV)",0.855476001060727,0.343536121673004,0
"<anonymized_userid>",2,48392,3615,"Geert Wilders (PVV)",0.855511358613984,0.343631178707224,0
"<anonymized_userid>",2,48394,3616,"Geert Wilders (PVV)",0.855546716167241,0.343726235741445,0
"<anonymized_userid>",2,48396,3617,"Geert Wilders (PVV)",0.855582073720499,0.343821292775665,0
"<anonymized_userid>",2,48398,3618,"Geert Wilders (PVV)",0.855617431273756,0.343916349809886,0
"<anonymized_userid>",2,48400,3619,"Geert Wilders (PVV)",0.855652788827013,0.344011406844106,0
"<anonymized_userid>",2,48402,3620,"Geert Wilders (PVV)",0.85568814638027,0.344106463878327,0
"<anonymized_userid>",2,48404,3621,"Geert Wilders (PVV)",0.855723503933528,0.344201520912548,0
"<anonymized_userid>",2,48406,3622,"Geert Wilders (PVV)",0.855758861486785,0.344296577946768,0
"<anonymized_userid>",2,48408,3623,"Geert Wilders (PVV)",0.855794219040042,0.344391634980989,0
"<anonymized_userid>",2,48410,3624,"Geert Wilders (PVV)",0.8558295765933,0.344486692015209,0
"<anonymized_userid>",2,48412,3625,"Geert Wilders (PVV)",0.855864934146557,0.34458174904943,0
"<anonymized_userid>",2,48414,3626,"Geert Wilders (PVV)",0.855900291699814,0.34467680608365,0
"<anonymized_userid>",2,48416,3627,"Geert Wilders (PVV)",0.855935649253072,0.344771863117871,0
"<anonymized_userid>",2,48418,3628,"Geert Wilders (PVV)",0.855971006806329,0.344866920152091,0
"<anonymized_userid>",2,48420,3629,"Geert Wilders (PVV)",0.856006364359586,0.344961977186312,0
"<anonymized_userid>",2,48422,3630,"Geert Wilders (PVV)",0.856041721912844,0.345057034220532,0
"<anonymized_userid>",2,48424,3631,"Geert Wilders (PVV)",0.856077079466101,0.345152091254753,0
"<anonymized_userid>",2,48426,3632,"Geert Wilders (PVV)",0.856112437019358,0.345247148288973,0
"<anonymized_userid>",2,48428,3633,"Geert Wilders (PVV)",0.856147794572616,0.345342205323194,0
"<anonymized_userid>",2,48430,3634,"Geert Wilders (PVV)",0.856183152125873,0.345437262357414,0
"<anonymized_userid>",2,48432,3635,"Geert Wilders (PVV)",0.85621850967913,0.345532319391635,0
"<anonymized_userid>",2,48434,3636,"Geert Wilders (PVV)",0.856253867232387,0.345627376425856,0
"<anonymized_userid>",2,48436,3637,"Geert Wilders (PVV)",0.856289224785645,0.345722433460076,0
"<anonymized_userid>",2,48438,3638,"Geert Wilders (PVV)",0.856324582338902,0.345817490494297,0
"<anonymized_userid>",2,48440,3639,"Geert Wilders (PVV)",0.856359939892159,0.345912547528517,0
"<anonymized_userid>",2,48442,3640,"Geert Wilders (PVV)",0.856395297445417,0.346007604562738,0
"<anonymized_userid>",2,48444,3641,"Geert Wilders (PVV)",0.856430654998674,0.346102661596958,0
"<anonymized_userid>",2,48446,3642,"Geert Wilders (PVV)",0.856466012551931,0.346197718631179,0
"<anonymized_userid>",2,48448,3643,"Geert Wilders (PVV)",0.856501370105189,0.346292775665399,0
"<anonymized_userid>",2,48450,3644,"Geert Wilders (PVV)",0.856536727658446,0.34638783269962,0
"<anonymized_userid>",2,48452,3645,"Geert Wilders (PVV)",0.856572085211703,0.34648288973384,0
"<anonymized_userid>",2,48454,3646,"Geert Wilders (PVV)",0.856607442764961,0.346577946768061,0
"<anonymized_userid>",2,48456,3647,"Geert Wilders (PVV)",0.856642800318218,0.346673003802281,0
"<anonymized_userid>",2,48458,3648,"Geert Wilders (PVV)",0.856678157871475,0.346768060836502,0
"<anonymized_userid>",2,48460,3649,"Geert Wilders (PVV)",0.856713515424733,0.346863117870722,0
"<anonymized_userid>",2,48462,3650,"Geert Wilders (PVV)",0.85674887297799,0.346958174904943,0
"<anonymized_userid>",2,48464,3651,"Geert Wilders (PVV)",0.856784230531247,0.347053231939163,0
"<anonymized_userid>",2,48466,3652,"Geert Wilders (PVV)",0.856819588084505,0.347148288973384,0
"<anonymized_userid>",2,48468,3653,"Geert Wilders (PVV)",0.856854945637762,0.347243346007605,0
"<anonymized_userid>",2,48470,3654,"Geert Wilders (PVV)",0.856890303191019,0.347338403041825,0
"<anonymized_userid>",2,48472,3655,"Geert Wilders (PVV)",0.856925660744276,0.347433460076046,0
"<anonymized_userid>",2,48474,3656,"Geert Wilders (PVV)",0.856961018297534,0.347528517110266,0
"<anonymized_userid>",2,48476,3657,"Geert Wilders (PVV)",0.856996375850791,0.347623574144487,0
"<anonymized_userid>",2,48478,3658,"Geert Wilders (PVV)",0.857031733404048,0.347718631178707,0
"<anonymized_userid>",2,48480,3659,"Geert Wilders (PVV)",0.857067090957306,0.347813688212928,0
"<anonymized_userid>",2,48482,3660,"Geert Wilders (PVV)",0.857102448510563,0.347908745247148,0
"<anonymized_userid>",2,48484,3661,"Geert Wilders (PVV)",0.85713780606382,0.348003802281369,0
"<anonymized_userid>",2,48486,3662,"Geert Wilders (PVV)",0.857173163617078,0.348098859315589,0
"<anonymized_userid>",2,48488,3663,"Geert Wilders (PVV)",0.857208521170335,0.34819391634981,0
"<anonymized_userid>",2,48490,3664,"Geert Wilders (PVV)",0.857243878723592,0.34828897338403,0
"<anonymized_userid>",2,48492,3665,"Geert Wilders (PVV)",0.85727923627685,0.348384030418251,0
"<anonymized_userid>",2,48494,3666,"Geert Wilders (PVV)",0.857314593830107,0.348479087452471,0
"<anonymized_userid>",2,48496,3667,"Geert Wilders (PVV)",0.857349951383364,0.348574144486692,0
"<anonymized_userid>",2,48498,3668,"Geert Wilders (PVV)",0.857385308936622,0.348669201520913,0
"<anonymized_userid>",2,48500,3669,"Geert Wilders (PVV)",0.857420666489879,0.348764258555133,0
"<anonymized_userid>",2,48502,3670,"Geert Wilders (PVV)",0.857456024043136,0.348859315589354,0
"<anonymized_userid>",2,48504,3671,"Geert Wilders (PVV)",0.857491381596393,0.348954372623574,0
"<anonymized_userid>",2,48506,3672,"Geert Wilders (PVV)",0.857526739149651,0.349049429657795,0
"<anonymized_userid>",2,48508,3673,"Geert Wilders (PVV)",0.857562096702908,0.349144486692015,0
"<anonymized_userid>",2,48510,3674,"Geert Wilders (PVV)",0.857597454256166,0.349239543726236,0
"<anonymized_userid>",2,48512,3675,"Geert Wilders (PVV)",0.857632811809423,0.349334600760456,0
"<anonymized_userid>",2,48514,3676,"Geert Wilders (PVV)",0.85766816936268,0.349429657794677,0
"<anonymized_userid>",2,48516,3677,"Geert Wilders (PVV)",0.857703526915937,0.349524714828897,0
"<anonymized_userid>",2,48518,3678,"Geert Wilders (PVV)",0.857738884469195,0.349619771863118,0
"<anonymized_userid>",2,48520,3679,"Geert Wilders (PVV)",0.857774242022452,0.349714828897338,0
"<anonymized_userid>",2,48522,3680,"Geert Wilders (PVV)",0.857809599575709,0.349809885931559,0
"<anonymized_userid>",2,48524,3681,"Geert Wilders (PVV)",0.857844957128967,0.349904942965779,0
"<anonymized_userid>",2,48526,3682,"Geert Wilders (PVV)",0.857880314682224,0.35,0
"<anonymized_userid>",2,48528,3683,"Geert Wilders (PVV)",0.857915672235481,0.350095057034221,0
"<anonymized_userid>",2,48530,3684,"Geert Wilders (PVV)",0.857951029788739,0.350190114068441,0
"<anonymized_userid>",2,48532,3685,"Geert Wilders (PVV)",0.857986387341996,0.350285171102662,0
"<anonymized_userid>",2,48534,3686,"Geert Wilders (PVV)",0.858021744895253,0.350380228136882,0
"<anonymized_userid>",2,48536,3687,"Geert Wilders (PVV)",0.858057102448511,0.350475285171103,0
"<anonymized_userid>",2,48538,3688,"Geert Wilders (PVV)",0.858092460001768,0.350570342205323,0
"<anonymized_userid>",2,48540,3689,"Geert Wilders (PVV)",0.858127817555025,0.350665399239544,0
"<anonymized_userid>",2,48542,3690,"Geert Wilders (PVV)",0.858163175108283,0.350760456273764,0
"<anonymized_userid>",2,48544,3691,"Geert Wilders (PVV)",0.85819853266154,0.350855513307985,0
"<anonymized_userid>",2,48546,3692,"Geert Wilders (PVV)",0.858233890214797,0.350950570342205,0
"<anonymized_userid>",2,48548,3693,"Geert Wilders (PVV)",0.858269247768054,0.351045627376426,0
"<anonymized_userid>",2,48550,3694,"Geert Wilders (PVV)",0.858304605321312,0.351140684410646,0
"<anonymized_userid>",2,48552,3695,"Geert Wilders (PVV)",0.858339962874569,0.351235741444867,0
"<anonymized_userid>",2,48554,3696,"Geert Wilders (PVV)",0.858375320427826,0.351330798479087,0
"<anonymized_userid>",2,48556,3697,"Geert Wilders (PVV)",0.858410677981084,0.351425855513308,0
"<anonymized_userid>",2,48558,3698,"Geert Wilders (PVV)",0.858446035534341,0.351520912547529,0
"<anonymized_userid>",2,48560,3699,"Geert Wilders (PVV)",0.858481393087598,0.351615969581749,0
"<anonymized_userid>",2,48562,3700,"Geert Wilders (PVV)",0.858516750640856,0.35171102661597,0
"<anonymized_userid>",2,48564,3701,"Geert Wilders (PVV)",0.858552108194113,0.35180608365019,0
"<anonymized_userid>",2,48566,3702,"Geert Wilders (PVV)",0.85858746574737,0.351901140684411,0
"<anonymized_userid>",2,48568,3703,"Geert Wilders (PVV)",0.858622823300628,0.351996197718631,0
"<anonymized_userid>",2,48570,3704,"Geert Wilders (PVV)",0.858658180853885,0.352091254752852,0
"<anonymized_userid>",2,48572,3705,"Geert Wilders (PVV)",0.858693538407142,0.352186311787072,0
"<anonymized_userid>",2,48574,3706,"Geert Wilders (PVV)",0.8587288959604,0.352281368821293,0
"<anonymized_userid>",2,48576,3707,"Geert Wilders (PVV)",0.858764253513657,0.352376425855513,0
"<anonymized_userid>",2,48578,3708,"Geert Wilders (PVV)",0.858799611066914,0.352471482889734,0
"<anonymized_userid>",2,48580,3709,"Geert Wilders (PVV)",0.858834968620172,0.352566539923954,0
"<anonymized_userid>",2,48582,3710,"Geert Wilders (PVV)",0.858870326173429,0.352661596958175,0
"<anonymized_userid>",2,48584,3711,"Geert Wilders (PVV)",0.858905683726686,0.352756653992395,0
"<anonymized_userid>",2,48586,3712,"Geert Wilders (PVV)",0.858941041279943,0.352851711026616,0
"<anonymized_userid>",2,48588,3713,"Geert Wilders (PVV)",0.858976398833201,0.352946768060837,0
"<anonymized_userid>",2,48590,3714,"Geert Wilders (PVV)",0.859011756386458,0.353041825095057,0
"<anonymized_userid>",2,48592,3715,"Geert Wilders (PVV)",0.859047113939715,0.353136882129278,0
"<anonymized_userid>",2,48594,3716,"Geert Wilders (PVV)",0.859082471492973,0.353231939163498,0
"<anonymized_userid>",2,48596,3717,"Geert Wilders (PVV)",0.85911782904623,0.353326996197719,0
"<anonymized_userid>",2,48598,3718,"Geert Wilders (PVV)",0.859153186599487,0.353422053231939,0
"<anonymized_userid>",2,48600,3719,"Geert Wilders (PVV)",0.859188544152745,0.35351711026616,0
"<anonymized_userid>",2,48602,3720,"Geert Wilders (PVV)",0.859223901706002,0.35361216730038,0
"<anonymized_userid>",2,48604,3721,"Geert Wilders (PVV)",0.859259259259259,0.353707224334601,0
"<anonymized_userid>",2,48606,3722,"Geert Wilders (PVV)",0.859294616812517,0.353802281368821,0
"<anonymized_userid>",2,48608,3723,"Geert Wilders (PVV)",0.859329974365774,0.353897338403042,0
"<anonymized_userid>",2,48610,3724,"Geert Wilders (PVV)",0.859365331919031,0.353992395437262,0
"<anonymized_userid>",2,48612,3725,"Geert Wilders (PVV)",0.859400689472289,0.354087452471483,0
"<anonymized_userid>",2,48614,3726,"Geert Wilders (PVV)",0.859436047025546,0.354182509505703,0
"<anonymized_userid>",2,48616,3727,"Geert Wilders (PVV)",0.859471404578803,0.354277566539924,0
"<anonymized_userid>",2,48618,3728,"Geert Wilders (PVV)",0.85950676213206,0.354372623574145,0
"<anonymized_userid>",2,48620,3729,"Geert Wilders (PVV)",0.859542119685318,0.354467680608365,0
"<anonymized_userid>",2,48622,3730,"Geert Wilders (PVV)",0.859577477238575,0.354562737642586,0
"<anonymized_userid>",2,48624,3731,"Geert Wilders (PVV)",0.859612834791832,0.354657794676806,0
"<anonymized_userid>",2,48626,3732,"Geert Wilders (PVV)",0.85964819234509,0.354752851711027,0
"<anonymized_userid>",2,48628,3733,"Geert Wilders (PVV)",0.859683549898347,0.354847908745247,0
"<anonymized_userid>",2,48630,3734,"Geert Wilders (PVV)",0.859718907451604,0.354942965779468,0
"<anonymized_userid>",2,48632,3735,"Geert Wilders (PVV)",0.859754265004862,0.355038022813688,0
"<anonymized_userid>",2,48634,3736,"Geert Wilders (PVV)",0.859789622558119,0.355133079847909,0
"<anonymized_userid>",2,48636,3737,"Geert Wilders (PVV)",0.859824980111376,0.355228136882129,0
"<anonymized_userid>",2,48638,3738,"Geert Wilders (PVV)",0.859860337664634,0.35532319391635,0
"<anonymized_userid>",2,48640,3739,"Geert Wilders (PVV)",0.859895695217891,0.35541825095057,0
"<anonymized_userid>",2,48642,3740,"Geert Wilders (PVV)",0.859931052771148,0.355513307984791,0
"<anonymized_userid>",2,48644,3741,"Geert Wilders (PVV)",0.859966410324406,0.355608365019011,0
"<anonymized_userid>",2,48646,3742,"Geert Wilders (PVV)",0.860001767877663,0.355703422053232,0
"<anonymized_userid>",2,48648,3743,"Geert Wilders (PVV)",0.86003712543092,0.355798479087452,0
"<anonymized_userid>",2,48650,3744,"Geert Wilders (PVV)",0.860072482984177,0.355893536121673,0
"<anonymized_userid>",2,48652,3745,"Geert Wilders (PVV)",0.860107840537435,0.355988593155894,0
"<anonymized_userid>",2,48654,3746,"Geert Wilders (PVV)",0.860143198090692,0.356083650190114,0
"<anonymized_userid>",2,48656,3747,"Geert Wilders (PVV)",0.860178555643949,0.356178707224335,0
"<anonymized_userid>",2,48658,3748,"Geert Wilders (PVV)",0.860213913197207,0.356273764258555,0
"<anonymized_userid>",2,48660,3749,"Geert Wilders (PVV)",0.860249270750464,0.356368821292776,0
"<anonymized_userid>",2,48662,3750,"Geert Wilders (PVV)",0.860284628303721,0.356463878326996,0
"<anonymized_userid>",2,48664,3751,"Geert Wilders (PVV)",0.860319985856979,0.356558935361217,0
"<anonymized_userid>",2,48666,3752,"Geert Wilders (PVV)",0.860355343410236,0.356653992395437,0
"<anonymized_userid>",2,48668,3753,"Geert Wilders (PVV)",0.860390700963493,0.356749049429658,0
"<anonymized_userid>",2,48670,3754,"Geert Wilders (PVV)",0.860426058516751,0.356844106463878,0
"<anonymized_userid>",2,48672,3755,"Geert Wilders (PVV)",0.860461416070008,0.356939163498099,0
"<anonymized_userid>",2,48674,3756,"Geert Wilders (PVV)",0.860496773623265,0.357034220532319,0
"<anonymized_userid>",2,48676,3757,"Geert Wilders (PVV)",0.860532131176523,0.35712927756654,0
"<anonymized_userid>",2,48678,3758,"Geert Wilders (PVV)",0.86056748872978,0.35722433460076,0
"<anonymized_userid>",2,48680,3759,"Geert Wilders (PVV)",0.860602846283037,0.357319391634981,0
"<anonymized_userid>",2,48682,3760,"Geert Wilders (PVV)",0.860638203836295,0.357414448669202,0
"<anonymized_userid>",2,48684,3761,"Geert Wilders (PVV)",0.860673561389552,0.357509505703422,0
"<anonymized_userid>",2,48686,3762,"Geert Wilders (PVV)",0.860708918942809,0.357604562737643,0
"<anonymized_userid>",2,48688,3763,"Geert Wilders (PVV)",0.860744276496066,0.357699619771863,0
"<anonymized_userid>",2,48690,3764,"Geert Wilders (PVV)",0.860779634049324,0.357794676806084,0
"<anonymized_userid>",2,48692,3765,"Geert Wilders (PVV)",0.860814991602581,0.357889733840304,0
"<anonymized_userid>",2,48694,3766,"Geert Wilders (PVV)",0.860850349155838,0.357984790874525,0
"<anonymized_userid>",2,48696,3767,"Geert Wilders (PVV)",0.860885706709096,0.358079847908745,0
"<anonymized_userid>",2,48698,3768,"Geert Wilders (PVV)",0.860921064262353,0.358174904942966,0
"<anonymized_userid>",2,48700,3769,"Geert Wilders (PVV)",0.86095642181561,0.358269961977186,0
"<anonymized_userid>",2,48702,3770,"Geert Wilders (PVV)",0.860991779368868,0.358365019011407,0
"<anonymized_userid>",2,48704,3771,"Geert Wilders (PVV)",0.861027136922125,0.358460076045627,0
"<anonymized_userid>",2,48706,3772,"Geert Wilders (PVV)",0.861062494475382,0.358555133079848,0
"<anonymized_userid>",2,48708,3773,"Geert Wilders (PVV)",0.86109785202864,0.358650190114068,0
"<anonymized_userid>",2,48710,3774,"Geert Wilders (PVV)",0.861133209581897,0.358745247148289,0
"<anonymized_userid>",2,48712,3775,"Geert Wilders (PVV)",0.861168567135154,0.35884030418251,0
"<anonymized_userid>",2,48714,3776,"Geert Wilders (PVV)",0.861203924688412,0.35893536121673,0
"<anonymized_userid>",2,48716,3777,"Geert Wilders (PVV)",0.861239282241669,0.359030418250951,0
"<anonymized_userid>",2,48718,3778,"Geert Wilders (PVV)",0.861274639794926,0.359125475285171,0
"<anonymized_userid>",2,48720,3779,"Geert Wilders (PVV)",0.861309997348183,0.359220532319392,0
"<anonymized_userid>",2,48722,3780,"Geert Wilders (PVV)",0.861345354901441,0.359315589353612,0
"<anonymized_userid>",2,48724,3781,"Geert Wilders (PVV)",0.861380712454698,0.359410646387833,0
"<anonymized_userid>",2,48726,3782,"Geert Wilders (PVV)",0.861416070007956,0.359505703422053,0
"<anonymized_userid>",2,48728,3783,"Geert Wilders (PVV)",0.861451427561213,0.359600760456274,0
"<anonymized_userid>",2,48730,3784,"Geert Wilders (PVV)",0.86148678511447,0.359695817490494,0
"<anonymized_userid>",2,48732,3785,"Geert Wilders (PVV)",0.861522142667727,0.359790874524715,0
"<anonymized_userid>",2,48734,3786,"Geert Wilders (PVV)",0.861557500220985,0.359885931558935,0
"<anonymized_userid>",2,48736,3787,"Geert Wilders (PVV)",0.861592857774242,0.359980988593156,0
"<anonymized_userid>",2,48738,3788,"Geert Wilders (PVV)",0.861628215327499,0.360076045627376,0
"<anonymized_userid>",2,48740,3789,"Geert Wilders (PVV)",0.861663572880757,0.360171102661597,0
"<anonymized_userid>",2,48742,3790,"Geert Wilders (PVV)",0.861698930434014,0.360266159695817,0
"<anonymized_userid>",2,48744,3791,"Geert Wilders (PVV)",0.861734287987271,0.360361216730038,0
"<anonymized_userid>",2,48746,3792,"Geert Wilders (PVV)",0.861769645540529,0.360456273764259,0
"<anonymized_userid>",2,48748,3793,"Geert Wilders (PVV)",0.861805003093786,0.360551330798479,0
"<anonymized_userid>",2,48750,3794,"Geert Wilders (PVV)",0.861840360647043,0.3606463878327,0
"<anonymized_userid>",2,48752,3795,"Geert Wilders (PVV)",0.861875718200301,0.36074144486692,0
"<anonymized_userid>",2,48754,3796,"Geert Wilders (PVV)",0.861911075753558,0.360836501901141,0
"<anonymized_userid>",2,48756,3797,"Geert Wilders (PVV)",0.861946433306815,0.360931558935361,0
"<anonymized_userid>",2,48758,3798,"Geert Wilders (PVV)",0.861981790860072,0.361026615969582,0
"<anonymized_userid>",2,48760,3799,"Geert Wilders (PVV)",0.86201714841333,0.361121673003802,0
"<anonymized_userid>",2,48762,3800,"Geert Wilders (PVV)",0.862052505966587,0.361216730038023,0
"<anonymized_userid>",2,48764,3801,"Geert Wilders (PVV)",0.862087863519844,0.361311787072243,0
"<anonymized_userid>",2,48766,3802,"Geert Wilders (PVV)",0.862123221073102,0.361406844106464,0
"<anonymized_userid>",2,48768,3803,"Geert Wilders (PVV)",0.862158578626359,0.361501901140684,0
"<anonymized_userid>",2,48770,3804,"Geert Wilders (PVV)",0.862193936179616,0.361596958174905,0
"<anonymized_userid>",2,48772,3805,"Geert Wilders (PVV)",0.862229293732874,0.361692015209125,0
"<anonymized_userid>",2,48774,3806,"Geert Wilders (PVV)",0.862264651286131,0.361787072243346,0
"<anonymized_userid>",2,48776,3807,"Geert Wilders (PVV)",0.862300008839388,0.361882129277567,0
"<anonymized_userid>",2,48778,3808,"Geert Wilders (PVV)",0.862335366392646,0.361977186311787,0
"<anonymized_userid>",2,48780,3809,"Geert Wilders (PVV)",0.862370723945903,0.362072243346008,0
"<anonymized_userid>",2,48782,3810,"Geert Wilders (PVV)",0.86240608149916,0.362167300380228,0
"<anonymized_userid>",2,48784,3811,"Geert Wilders (PVV)",0.862441439052418,0.362262357414449,0
"<anonymized_userid>",2,48786,3812,"Geert Wilders (PVV)",0.862476796605675,0.362357414448669,0
"<anonymized_userid>",2,48788,3813,"Geert Wilders (PVV)",0.862512154158932,0.36245247148289,0
"<anonymized_userid>",2,48790,3814,"Geert Wilders (PVV)",0.862547511712189,0.36254752851711,0
"<anonymized_userid>",2,48792,3815,"Geert Wilders (PVV)",0.862582869265447,0.362642585551331,0
"<anonymized_userid>",2,48794,3816,"Geert Wilders (PVV)",0.862618226818704,0.362737642585551,0
"<anonymized_userid>",2,48796,3817,"Geert Wilders (PVV)",0.862653584371961,0.362832699619772,0
"<anonymized_userid>",2,48798,3818,"Geert Wilders (PVV)",0.862688941925219,0.362927756653992,0
"<anonymized_userid>",2,48800,3819,"Geert Wilders (PVV)",0.862724299478476,0.363022813688213,0
"<anonymized_userid>",2,48802,3820,"Geert Wilders (PVV)",0.862759657031733,0.363117870722433,0
"<anonymized_userid>",2,48804,3821,"Geert Wilders (PVV)",0.862795014584991,0.363212927756654,0
"<anonymized_userid>",2,48806,3822,"Geert Wilders (PVV)",0.862830372138248,0.363307984790875,0
"<anonymized_userid>",2,48808,3823,"Geert Wilders (PVV)",0.862865729691505,0.363403041825095,0
"<anonymized_userid>",2,48810,3824,"Geert Wilders (PVV)",0.862901087244763,0.363498098859316,0
"<anonymized_userid>",2,48812,3825,"Geert Wilders (PVV)",0.86293644479802,0.363593155893536,0
"<anonymized_userid>",2,48814,3826,"Geert Wilders (PVV)",0.862971802351277,0.363688212927757,0
"<anonymized_userid>",2,48816,3827,"Geert Wilders (PVV)",0.863007159904535,0.363783269961977,0
"<anonymized_userid>",2,48818,3828,"Geert Wilders (PVV)",0.863042517457792,0.363878326996198,0
"<anonymized_userid>",2,48820,3829,"Geert Wilders (PVV)",0.863077875011049,0.363973384030418,0
"<anonymized_userid>",2,48822,3830,"Geert Wilders (PVV)",0.863113232564306,0.364068441064639,0
"<anonymized_userid>",2,48824,3831,"Geert Wilders (PVV)",0.863148590117564,0.364163498098859,0
"<anonymized_userid>",2,48826,3832,"Geert Wilders (PVV)",0.863183947670821,0.36425855513308,0
"<anonymized_userid>",2,48828,3833,"Geert Wilders (PVV)",0.863219305224079,0.3643536121673,0
"<anonymized_userid>",2,48830,3834,"Geert Wilders (PVV)",0.863254662777336,0.364448669201521,0
"<anonymized_userid>",2,48832,3835,"Geert Wilders (PVV)",0.863290020330593,0.364543726235741,0
"<anonymized_userid>",2,48834,3836,"Geert Wilders (PVV)",0.86332537788385,0.364638783269962,0
"<anonymized_userid>",2,48836,3837,"Geert Wilders (PVV)",0.863360735437108,0.364733840304182,0
"<anonymized_userid>",2,48838,3838,"Geert Wilders (PVV)",0.863396092990365,0.364828897338403,0
"<anonymized_userid>",2,48840,3839,"Geert Wilders (PVV)",0.863431450543622,0.364923954372624,0
"<anonymized_userid>",2,48842,3840,"Geert Wilders (PVV)",0.86346680809688,0.365019011406844,0
"<anonymized_userid>",2,48844,3841,"Geert Wilders (PVV)",0.863502165650137,0.365114068441065,0
"<anonymized_userid>",2,48846,3842,"Geert Wilders (PVV)",0.863537523203394,0.365209125475285,0
"<anonymized_userid>",2,48848,3843,"Geert Wilders (PVV)",0.863572880756652,0.365304182509506,0
"<anonymized_userid>",2,48850,3844,"Geert Wilders (PVV)",0.863608238309909,0.365399239543726,0
"<anonymized_userid>",2,48852,3845,"Geert Wilders (PVV)",0.863643595863166,0.365494296577947,0
"<anonymized_userid>",2,48854,3846,"Geert Wilders (PVV)",0.863678953416424,0.365589353612167,0
"<anonymized_userid>",2,48856,3847,"Geert Wilders (PVV)",0.863714310969681,0.365684410646388,0
"<anonymized_userid>",2,48858,3848,"Geert Wilders (PVV)",0.863749668522938,0.365779467680608,0
"<anonymized_userid>",2,48860,3849,"Geert Wilders (PVV)",0.863785026076196,0.365874524714829,0
"<anonymized_userid>",2,48862,3850,"Geert Wilders (PVV)",0.863820383629453,0.365969581749049,0
"<anonymized_userid>",2,48864,3851,"Geert Wilders (PVV)",0.86385574118271,0.36606463878327,0
"<anonymized_userid>",2,48866,3852,"Geert Wilders (PVV)",0.863891098735967,0.36615969581749,0
"<anonymized_userid>",2,48868,3853,"Geert Wilders (PVV)",0.863926456289225,0.366254752851711,0
"<anonymized_userid>",2,48870,3854,"Geert Wilders (PVV)",0.863961813842482,0.366349809885932,0
"<anonymized_userid>",2,48872,3855,"Geert Wilders (PVV)",0.863997171395739,0.366444866920152,0
"<anonymized_userid>",2,48874,3856,"Geert Wilders (PVV)",0.864032528948997,0.366539923954373,0
"<anonymized_userid>",2,48876,3857,"Geert Wilders (PVV)",0.864067886502254,0.366634980988593,0
"<anonymized_userid>",2,48878,3858,"Geert Wilders (PVV)",0.864103244055511,0.366730038022814,0
"<anonymized_userid>",2,48880,3859,"Geert Wilders (PVV)",0.864138601608769,0.366825095057034,0
"<anonymized_userid>",2,48882,3860,"Geert Wilders (PVV)",0.864173959162026,0.366920152091255,0
"<anonymized_userid>",2,48884,3861,"Geert Wilders (PVV)",0.864209316715283,0.367015209125475,0
"<anonymized_userid>",2,48886,3862,"Geert Wilders (PVV)",0.864244674268541,0.367110266159696,0
"<anonymized_userid>",2,48888,3863,"Geert Wilders (PVV)",0.864280031821798,0.367205323193916,0
"<anonymized_userid>",2,48890,3864,"Geert Wilders (PVV)",0.864315389375055,0.367300380228137,0
"<anonymized_userid>",2,48892,3865,"Geert Wilders (PVV)",0.864350746928313,0.367395437262357,0
"<anonymized_userid>",2,48894,3866,"Geert Wilders (PVV)",0.86438610448157,0.367490494296578,0
"<anonymized_userid>",2,48896,3867,"Geert Wilders (PVV)",0.864421462034827,0.367585551330798,0
"<anonymized_userid>",2,48898,3868,"Geert Wilders (PVV)",0.864456819588085,0.367680608365019,0
"<anonymized_userid>",2,48900,3869,"Geert Wilders (PVV)",0.864492177141342,0.36777566539924,0
"<anonymized_userid>",2,48902,3870,"Geert Wilders (PVV)",0.864527534694599,0.36787072243346,0
"<anonymized_userid>",2,48904,3871,"Geert Wilders (PVV)",0.864562892247856,0.367965779467681,0
"<anonymized_userid>",2,48906,3872,"Geert Wilders (PVV)",0.864598249801114,0.368060836501901,0
"<anonymized_userid>",2,48908,3873,"Geert Wilders (PVV)",0.864633607354371,0.368155893536122,0
"<anonymized_userid>",2,48910,3874,"Geert Wilders (PVV)",0.864668964907628,0.368250950570342,0
"<anonymized_userid>",2,48912,3875,"Geert Wilders (PVV)",0.864704322460886,0.368346007604563,0
"<anonymized_userid>",2,48914,3876,"Geert Wilders (PVV)",0.864739680014143,0.368441064638783,0
"<anonymized_userid>",2,48916,3877,"Geert Wilders (PVV)",0.8647750375674,0.368536121673004,0
"<anonymized_userid>",2,48918,3878,"Geert Wilders (PVV)",0.864810395120658,0.368631178707224,0
"<anonymized_userid>",2,48920,3879,"Geert Wilders (PVV)",0.864845752673915,0.368726235741445,0
"<anonymized_userid>",2,48922,3880,"Geert Wilders (PVV)",0.864881110227172,0.368821292775665,0
"<anonymized_userid>",2,48924,3881,"Geert Wilders (PVV)",0.86491646778043,0.368916349809886,0
"<anonymized_userid>",2,48926,3882,"Geert Wilders (PVV)",0.864951825333687,0.369011406844106,0
"<anonymized_userid>",2,48928,3883,"Geert Wilders (PVV)",0.864987182886944,0.369106463878327,0
"<anonymized_userid>",2,48930,3884,"Geert Wilders (PVV)",0.865022540440202,0.369201520912548,0
"<anonymized_userid>",2,48932,3885,"Geert Wilders (PVV)",0.865057897993459,0.369296577946768,0
"<anonymized_userid>",2,48934,3886,"Geert Wilders (PVV)",0.865093255546716,0.369391634980989,0
"<anonymized_userid>",2,48936,3887,"Geert Wilders (PVV)",0.865128613099973,0.369486692015209,0
"<anonymized_userid>",2,48938,3888,"Geert Wilders (PVV)",0.865163970653231,0.36958174904943,0
"<anonymized_userid>",2,48940,3889,"Geert Wilders (PVV)",0.865199328206488,0.36967680608365,0
"<anonymized_userid>",2,48942,3890,"Geert Wilders (PVV)",0.865234685759745,0.369771863117871,0
"<anonymized_userid>",2,48944,3891,"Geert Wilders (PVV)",0.865270043313003,0.369866920152091,0
"<anonymized_userid>",2,48946,3892,"Geert Wilders (PVV)",0.86530540086626,0.369961977186312,0
"<anonymized_userid>",2,48948,3893,"Geert Wilders (PVV)",0.865340758419517,0.370057034220532,0
"<anonymized_userid>",2,48950,3894,"Geert Wilders (PVV)",0.865376115972775,0.370152091254753,0
"<anonymized_userid>",2,48952,3895,"Geert Wilders (PVV)",0.865411473526032,0.370247148288973,0
"<anonymized_userid>",2,48954,3896,"Geert Wilders (PVV)",0.865446831079289,0.370342205323194,0
"<anonymized_userid>",2,48956,3897,"Geert Wilders (PVV)",0.865482188632547,0.370437262357414,0
"<anonymized_userid>",2,48958,3898,"Geert Wilders (PVV)",0.865517546185804,0.370532319391635,0
"<anonymized_userid>",2,48960,3899,"Geert Wilders (PVV)",0.865552903739061,0.370627376425856,0
"<anonymized_userid>",2,48962,3900,"Geert Wilders (PVV)",0.865588261292319,0.370722433460076,0
"<anonymized_userid>",2,48964,3901,"Geert Wilders (PVV)",0.865623618845576,0.370817490494297,0
"<anonymized_userid>",2,48966,3902,"Geert Wilders (PVV)",0.865658976398833,0.370912547528517,0
"<anonymized_userid>",2,48968,3903,"Geert Wilders (PVV)",0.865694333952091,0.371007604562738,0
"<anonymized_userid>",2,48970,3904,"Geert Wilders (PVV)",0.865729691505348,0.371102661596958,0
"<anonymized_userid>",2,48972,3905,"Geert Wilders (PVV)",0.865765049058605,0.371197718631179,0
"<anonymized_userid>",2,48974,3906,"Geert Wilders (PVV)",0.865800406611862,0.371292775665399,0
"<anonymized_userid>",2,48976,3907,"Geert Wilders (PVV)",0.86583576416512,0.37138783269962,0
"<anonymized_userid>",2,48978,3908,"Geert Wilders (PVV)",0.865871121718377,0.37148288973384,0
"<anonymized_userid>",2,48980,3909,"Geert Wilders (PVV)",0.865906479271634,0.371577946768061,0
"<anonymized_userid>",2,48982,3910,"Geert Wilders (PVV)",0.865941836824892,0.371673003802281,0
"<anonymized_userid>",2,48984,3911,"Geert Wilders (PVV)",0.865977194378149,0.371768060836502,0
"<anonymized_userid>",2,48986,3912,"Geert Wilders (PVV)",0.866012551931406,0.371863117870722,0
"<anonymized_userid>",2,48988,3913,"Geert Wilders (PVV)",0.866047909484664,0.371958174904943,0
"<anonymized_userid>",2,48990,3914,"Geert Wilders (PVV)",0.866083267037921,0.372053231939164,0
"<anonymized_userid>",2,48992,3915,"Geert Wilders (PVV)",0.866118624591178,0.372148288973384,0
"<anonymized_userid>",2,48994,3916,"Geert Wilders (PVV)",0.866153982144436,0.372243346007605,0
"<anonymized_userid>",2,48996,3917,"Geert Wilders (PVV)",0.866189339697693,0.372338403041825,0
"<anonymized_userid>",2,48998,3918,"Geert Wilders (PVV)",0.86622469725095,0.372433460076046,0
"<anonymized_userid>",2,49000,3919,"Geert Wilders (PVV)",0.866260054804208,0.372528517110266,0
"<anonymized_userid>",2,49002,3920,"Geert Wilders (PVV)",0.866295412357465,0.372623574144487,0
"<anonymized_userid>",2,49004,3921,"Geert Wilders (PVV)",0.866330769910722,0.372718631178707,0
"<anonymized_userid>",2,49006,3922,"Geert Wilders (PVV)",0.866366127463979,0.372813688212928,0
"<anonymized_userid>",2,49008,3923,"Geert Wilders (PVV)",0.866401485017237,0.372908745247148,0
"<anonymized_userid>",2,49010,3924,"Geert Wilders (PVV)",0.866436842570494,0.373003802281369,0
"<anonymized_userid>",2,49012,3925,"Geert Wilders (PVV)",0.866472200123751,0.373098859315589,0
"<anonymized_userid>",2,49014,3926,"Geert Wilders (PVV)",0.866507557677009,0.37319391634981,0
"<anonymized_userid>",2,49016,3927,"Geert Wilders (PVV)",0.866542915230266,0.37328897338403,0
"<anonymized_userid>",2,49018,3928,"Geert Wilders (PVV)",0.866578272783523,0.373384030418251,0
"<anonymized_userid>",2,49020,3929,"Geert Wilders (PVV)",0.866613630336781,0.373479087452471,0
"<anonymized_userid>",2,49022,3930,"Geert Wilders (PVV)",0.866648987890038,0.373574144486692,0
"<anonymized_userid>",2,49024,3931,"Geert Wilders (PVV)",0.866684345443295,0.373669201520913,0
"<anonymized_userid>",2,49026,3932,"Geert Wilders (PVV)",0.866719702996553,0.373764258555133,0
"<anonymized_userid>",2,49028,3933,"Geert Wilders (PVV)",0.86675506054981,0.373859315589354,0
"<anonymized_userid>",2,49030,3934,"Geert Wilders (PVV)",0.866790418103067,0.373954372623574,0
"<anonymized_userid>",2,49032,3935,"Geert Wilders (PVV)",0.866825775656325,0.374049429657795,0
"<anonymized_userid>",2,49034,3936,"Geert Wilders (PVV)",0.866861133209582,0.374144486692015,0
"<anonymized_userid>",2,49036,3937,"Geert Wilders (PVV)",0.866896490762839,0.374239543726236,0
"<anonymized_userid>",2,49038,3938,"Geert Wilders (PVV)",0.866931848316096,0.374334600760456,0
"<anonymized_userid>",2,49040,3939,"Geert Wilders (PVV)",0.866967205869354,0.374429657794677,0
"<anonymized_userid>",2,49042,3940,"Geert Wilders (PVV)",0.867002563422611,0.374524714828897,0
"<anonymized_userid>",2,49044,3941,"Geert Wilders (PVV)",0.867037920975869,0.374619771863118,0
"<anonymized_userid>",2,49046,3942,"Geert Wilders (PVV)",0.867073278529126,0.374714828897338,0
"<anonymized_userid>",2,49048,3943,"Geert Wilders (PVV)",0.867108636082383,0.374809885931559,0
"<anonymized_userid>",2,49050,3944,"Geert Wilders (PVV)",0.86714399363564,0.374904942965779,0
"<anonymized_userid>",2,49052,3945,"Geert Wilders (PVV)",0.867179351188898,0.375,0
"<anonymized_userid>",2,49054,3946,"Geert Wilders (PVV)",0.867214708742155,0.375095057034221,0
"<anonymized_userid>",2,49056,3947,"Geert Wilders (PVV)",0.867250066295412,0.375190114068441,0
"<anonymized_userid>",2,49058,3948,"Geert Wilders (PVV)",0.86728542384867,0.375285171102662,0
"<anonymized_userid>",2,49060,3949,"Geert Wilders (PVV)",0.867320781401927,0.375380228136882,0
"<anonymized_userid>",2,49062,3950,"Geert Wilders (PVV)",0.867356138955184,0.375475285171103,0
"<anonymized_userid>",2,49064,3951,"Geert Wilders (PVV)",0.867391496508442,0.375570342205323,0
"<anonymized_userid>",2,49066,3952,"Geert Wilders (PVV)",0.867426854061699,0.375665399239544,0
"<anonymized_userid>",2,49068,3953,"Geert Wilders (PVV)",0.867462211614956,0.375760456273764,0
"<anonymized_userid>",2,49070,3954,"Geert Wilders (PVV)",0.867497569168214,0.375855513307985,0
"<anonymized_userid>",2,49072,3955,"Geert Wilders (PVV)",0.867532926721471,0.375950570342205,0
"<anonymized_userid>",2,49074,3956,"Geert Wilders (PVV)",0.867568284274728,0.376045627376426,0
"<anonymized_userid>",2,49076,3957,"Geert Wilders (PVV)",0.867603641827986,0.376140684410646,0
"<anonymized_userid>",2,49078,3958,"Geert Wilders (PVV)",0.867638999381243,0.376235741444867,0
"<anonymized_userid>",2,49080,3959,"Geert Wilders (PVV)",0.8676743569345,0.376330798479087,0
"<anonymized_userid>",2,49082,3960,"Geert Wilders (PVV)",0.867709714487757,0.376425855513308,0
"<anonymized_userid>",2,49084,3961,"Geert Wilders (PVV)",0.867745072041015,0.376520912547529,0
"<anonymized_userid>",2,49086,3962,"Geert Wilders (PVV)",0.867780429594272,0.376615969581749,0
"<anonymized_userid>",2,49088,3963,"Geert Wilders (PVV)",0.867815787147529,0.37671102661597,0
"<anonymized_userid>",2,49090,3964,"Geert Wilders (PVV)",0.867851144700787,0.37680608365019,0
"<anonymized_userid>",2,49092,3965,"Geert Wilders (PVV)",0.867886502254044,0.376901140684411,0
"<anonymized_userid>",2,49094,3966,"Geert Wilders (PVV)",0.867921859807301,0.376996197718631,0
"<anonymized_userid>",2,49096,3967,"Geert Wilders (PVV)",0.867957217360559,0.377091254752852,0
"<anonymized_userid>",2,49098,3968,"Geert Wilders (PVV)",0.867992574913816,0.377186311787072,0
"<anonymized_userid>",2,49100,3969,"Geert Wilders (PVV)",0.868027932467073,0.377281368821293,0
"<anonymized_userid>",2,49102,3970,"Geert Wilders (PVV)",0.868063290020331,0.377376425855513,0
"<anonymized_userid>",2,49104,3971,"Geert Wilders (PVV)",0.868098647573588,0.377471482889734,0
"<anonymized_userid>",2,49106,3972,"Geert Wilders (PVV)",0.868134005126845,0.377566539923954,0
"<anonymized_userid>",2,49108,3973,"Geert Wilders (PVV)",0.868169362680103,0.377661596958175,0
"<anonymized_userid>",2,49110,3974,"Geert Wilders (PVV)",0.86820472023336,0.377756653992395,0
"<anonymized_userid>",2,49112,3975,"Geert Wilders (PVV)",0.868240077786617,0.377851711026616,0
"<anonymized_userid>",2,49114,3976,"Geert Wilders (PVV)",0.868275435339875,0.377946768060836,0
"<anonymized_userid>",2,49116,3977,"Geert Wilders (PVV)",0.868310792893132,0.378041825095057,0
"<anonymized_userid>",2,49118,3978,"Geert Wilders (PVV)",0.868346150446389,0.378136882129278,0
"<anonymized_userid>",2,49120,3979,"Geert Wilders (PVV)",0.868381507999646,0.378231939163498,0
"<anonymized_userid>",2,49122,3980,"Geert Wilders (PVV)",0.868416865552904,0.378326996197719,0
"<anonymized_userid>",2,49124,3981,"Geert Wilders (PVV)",0.868452223106161,0.378422053231939,0
"<anonymized_userid>",2,49126,3982,"Geert Wilders (PVV)",0.868487580659418,0.37851711026616,0
"<anonymized_userid>",2,49128,3983,"Geert Wilders (PVV)",0.868522938212676,0.37861216730038,0
"<anonymized_userid>",2,49130,3984,"Geert Wilders (PVV)",0.868558295765933,0.378707224334601,0
"<anonymized_userid>",2,49132,3985,"Geert Wilders (PVV)",0.86859365331919,0.378802281368821,0
"<anonymized_userid>",2,49134,3986,"Geert Wilders (PVV)",0.868629010872448,0.378897338403042,0
"<anonymized_userid>",2,49136,3987,"Geert Wilders (PVV)",0.868664368425705,0.378992395437262,0
"<anonymized_userid>",2,49138,3988,"Geert Wilders (PVV)",0.868699725978962,0.379087452471483,0
"<anonymized_userid>",2,49140,3989,"Geert Wilders (PVV)",0.86873508353222,0.379182509505703,0
"<anonymized_userid>",2,49142,3990,"Geert Wilders (PVV)",0.868770441085477,0.379277566539924,0
"<anonymized_userid>",2,49144,3991,"Geert Wilders (PVV)",0.868805798638734,0.379372623574144,0
"<anonymized_userid>",2,49146,3992,"Geert Wilders (PVV)",0.868841156191992,0.379467680608365,0
"<anonymized_userid>",2,49148,3993,"Geert Wilders (PVV)",0.868876513745249,0.379562737642586,0
"<anonymized_userid>",2,49150,3994,"Geert Wilders (PVV)",0.868911871298506,0.379657794676806,0
"<anonymized_userid>",2,49152,3995,"Geert Wilders (PVV)",0.868947228851763,0.379752851711027,0
"<anonymized_userid>",2,49154,3996,"Geert Wilders (PVV)",0.868982586405021,0.379847908745247,0
"<anonymized_userid>",2,49156,3997,"Geert Wilders (PVV)",0.869017943958278,0.379942965779468,0
"<anonymized_userid>",2,49158,3998,"Geert Wilders (PVV)",0.869053301511535,0.380038022813688,0
"<anonymized_userid>",2,49160,3999,"Geert Wilders (PVV)",0.869088659064793,0.380133079847909,0
"<anonymized_userid>",2,49162,4000,"Geert Wilders (PVV)",0.86912401661805,0.380228136882129,0
"<anonymized_userid>",2,49164,4001,"Geert Wilders (PVV)",0.869159374171307,0.38032319391635,0
"<anonymized_userid>",2,49166,4002,"Geert Wilders (PVV)",0.869194731724565,0.38041825095057,0
"<anonymized_userid>",2,49168,4003,"Geert Wilders (PVV)",0.869230089277822,0.380513307984791,0
"<anonymized_userid>",2,49170,4004,"Geert Wilders (PVV)",0.869265446831079,0.380608365019011,0
"<anonymized_userid>",2,49172,4005,"Geert Wilders (PVV)",0.869300804384337,0.380703422053232,0
"<anonymized_userid>",2,49174,4006,"Geert Wilders (PVV)",0.869336161937594,0.380798479087452,0
"<anonymized_userid>",2,49176,4007,"Geert Wilders (PVV)",0.869371519490851,0.380893536121673,0
"<anonymized_userid>",2,49178,4008,"Geert Wilders (PVV)",0.869406877044109,0.380988593155894,0
"<anonymized_userid>",2,49180,4009,"Geert Wilders (PVV)",0.869442234597366,0.381083650190114,0
"<anonymized_userid>",2,49182,4010,"Geert Wilders (PVV)",0.869477592150623,0.381178707224335,0
"<anonymized_userid>",2,49184,4011,"Geert Wilders (PVV)",0.86951294970388,0.381273764258555,0
"<anonymized_userid>",2,49186,4012,"Geert Wilders (PVV)",0.869548307257138,0.381368821292776,0
"<anonymized_userid>",2,49188,4013,"Geert Wilders (PVV)",0.869583664810395,0.381463878326996,0
"<anonymized_userid>",2,49190,4014,"Geert Wilders (PVV)",0.869619022363652,0.381558935361217,0
"<anonymized_userid>",2,49192,4015,"Geert Wilders (PVV)",0.86965437991691,0.381653992395437,0
"<anonymized_userid>",2,49194,4016,"Geert Wilders (PVV)",0.869689737470167,0.381749049429658,0
"<anonymized_userid>",2,49196,4017,"Geert Wilders (PVV)",0.869725095023424,0.381844106463878,0
"<anonymized_userid>",2,49198,4018,"Geert Wilders (PVV)",0.869760452576682,0.381939163498099,0
"<anonymized_userid>",2,49200,4019,"Geert Wilders (PVV)",0.869795810129939,0.382034220532319,0
"<anonymized_userid>",2,49202,4020,"Geert Wilders (PVV)",0.869831167683196,0.38212927756654,0
"<anonymized_userid>",2,49204,4021,"Geert Wilders (PVV)",0.869866525236454,0.38222433460076,0
"<anonymized_userid>",2,49206,4022,"Geert Wilders (PVV)",0.869901882789711,0.382319391634981,0
"<anonymized_userid>",2,49208,4023,"Geert Wilders (PVV)",0.869937240342968,0.382414448669202,0
"<anonymized_userid>",2,49210,4024,"Geert Wilders (PVV)",0.869972597896226,0.382509505703422,0
"<anonymized_userid>",2,49212,4025,"Geert Wilders (PVV)",0.870007955449483,0.382604562737643,0
"<anonymized_userid>",2,49214,4026,"Geert Wilders (PVV)",0.87004331300274,0.382699619771863,0
"<anonymized_userid>",2,49216,4027,"Geert Wilders (PVV)",0.870078670555998,0.382794676806084,0
"<anonymized_userid>",2,49218,4028,"Geert Wilders (PVV)",0.870114028109255,0.382889733840304,0
"<anonymized_userid>",2,49220,4029,"Geert Wilders (PVV)",0.870149385662512,0.382984790874525,0
"<anonymized_userid>",2,49222,4030,"Geert Wilders (PVV)",0.870184743215769,0.383079847908745,0
"<anonymized_userid>",2,49224,4031,"Geert Wilders (PVV)",0.870220100769027,0.383174904942966,0
"<anonymized_userid>",2,49226,4032,"Geert Wilders (PVV)",0.870255458322284,0.383269961977186,0
"<anonymized_userid>",2,49228,4033,"Geert Wilders (PVV)",0.870290815875541,0.383365019011407,0
"<anonymized_userid>",2,49230,4034,"Geert Wilders (PVV)",0.870326173428799,0.383460076045627,0
"<anonymized_userid>",2,49232,4035,"Geert Wilders (PVV)",0.870361530982056,0.383555133079848,0
"<anonymized_userid>",2,49234,4036,"Geert Wilders (PVV)",0.870396888535313,0.383650190114068,0
"<anonymized_userid>",2,49236,4037,"Geert Wilders (PVV)",0.870432246088571,0.383745247148289,0
"<anonymized_userid>",2,49238,4038,"Geert Wilders (PVV)",0.870467603641828,0.38384030418251,0
"<anonymized_userid>",2,49240,4039,"Geert Wilders (PVV)",0.870502961195085,0.38393536121673,0
"<anonymized_userid>",2,49242,4040,"Geert Wilders (PVV)",0.870538318748343,0.384030418250951,0
"<anonymized_userid>",2,49244,4041,"Geert Wilders (PVV)",0.8705736763016,0.384125475285171,0
"<anonymized_userid>",2,49246,4042,"Geert Wilders (PVV)",0.870609033854857,0.384220532319392,0
"<anonymized_userid>",2,49248,4043,"Geert Wilders (PVV)",0.870644391408115,0.384315589353612,0
"<anonymized_userid>",2,49250,4044,"Geert Wilders (PVV)",0.870679748961372,0.384410646387833,0
"<anonymized_userid>",2,49252,4045,"Geert Wilders (PVV)",0.870715106514629,0.384505703422053,0
"<anonymized_userid>",2,49254,4046,"Geert Wilders (PVV)",0.870750464067886,0.384600760456274,0
"<anonymized_userid>",2,49256,4047,"Geert Wilders (PVV)",0.870785821621144,0.384695817490494,0
"<anonymized_userid>",2,49258,4048,"Geert Wilders (PVV)",0.870821179174401,0.384790874524715,0
"<anonymized_userid>",2,49260,4049,"Geert Wilders (PVV)",0.870856536727658,0.384885931558935,0
"<anonymized_userid>",2,49262,4050,"Geert Wilders (PVV)",0.870891894280916,0.384980988593156,0
"<anonymized_userid>",2,49264,4051,"Geert Wilders (PVV)",0.870927251834173,0.385076045627376,0
"<anonymized_userid>",2,49266,4052,"Geert Wilders (PVV)",0.87096260938743,0.385171102661597,0
"<anonymized_userid>",2,49268,4053,"Geert Wilders (PVV)",0.870997966940688,0.385266159695818,0
"<anonymized_userid>",2,49270,4054,"Geert Wilders (PVV)",0.871033324493945,0.385361216730038,0
"<anonymized_userid>",2,49272,4055,"Geert Wilders (PVV)",0.871068682047202,0.385456273764259,0
"<anonymized_userid>",2,49274,4056,"Geert Wilders (PVV)",0.87110403960046,0.385551330798479,0
"<anonymized_userid>",2,49276,4057,"Geert Wilders (PVV)",0.871139397153717,0.3856463878327,0
"<anonymized_userid>",2,49278,4058,"Geert Wilders (PVV)",0.871174754706974,0.38574144486692,0
"<anonymized_userid>",2,49280,4059,"Geert Wilders (PVV)",0.871210112260232,0.385836501901141,0
"<anonymized_userid>",2,49282,4060,"Geert Wilders (PVV)",0.871245469813489,0.385931558935361,0
"<anonymized_userid>",2,49284,4061,"Geert Wilders (PVV)",0.871280827366746,0.386026615969582,0
"<anonymized_userid>",2,49286,4062,"Geert Wilders (PVV)",0.871316184920004,0.386121673003802,0
"<anonymized_userid>",2,49288,4063,"Geert Wilders (PVV)",0.871351542473261,0.386216730038023,0
"<anonymized_userid>",2,49290,4064,"Geert Wilders (PVV)",0.871386900026518,0.386311787072243,0
"<anonymized_userid>",2,49292,4065,"Geert Wilders (PVV)",0.871422257579775,0.386406844106464,0
"<anonymized_userid>",2,49294,4066,"Geert Wilders (PVV)",0.871457615133033,0.386501901140684,0
"<anonymized_userid>",2,49296,4067,"Geert Wilders (PVV)",0.87149297268629,0.386596958174905,0
"<anonymized_userid>",2,49298,4068,"Geert Wilders (PVV)",0.871528330239547,0.386692015209125,0
"<anonymized_userid>",2,49300,4069,"Geert Wilders (PVV)",0.871563687792805,0.386787072243346,0
"<anonymized_userid>",2,49302,4070,"Geert Wilders (PVV)",0.871599045346062,0.386882129277567,0
"<anonymized_userid>",2,49304,4071,"Geert Wilders (PVV)",0.871634402899319,0.386977186311787,0
"<anonymized_userid>",2,49306,4072,"Geert Wilders (PVV)",0.871669760452577,0.387072243346008,0
"<anonymized_userid>",2,49308,4073,"Geert Wilders (PVV)",0.871705118005834,0.387167300380228,0
"<anonymized_userid>",2,49310,4074,"Geert Wilders (PVV)",0.871740475559091,0.387262357414449,0
"<anonymized_userid>",2,49312,4075,"Geert Wilders (PVV)",0.871775833112349,0.387357414448669,0
"<anonymized_userid>",2,49314,4076,"Geert Wilders (PVV)",0.871811190665606,0.38745247148289,0
"<anonymized_userid>",2,49316,4077,"Geert Wilders (PVV)",0.871846548218863,0.38754752851711,0
"<anonymized_userid>",2,49318,4078,"Geert Wilders (PVV)",0.871881905772121,0.387642585551331,0
"<anonymized_userid>",2,49320,4079,"Geert Wilders (PVV)",0.871917263325378,0.387737642585551,0
"<anonymized_userid>",2,49322,4080,"Geert Wilders (PVV)",0.871952620878635,0.387832699619772,0
"<anonymized_userid>",2,49324,4081,"Geert Wilders (PVV)",0.871987978431892,0.387927756653992,0
"<anonymized_userid>",2,49326,4082,"Geert Wilders (PVV)",0.87202333598515,0.388022813688213,0
"<anonymized_userid>",2,49328,4083,"Geert Wilders (PVV)",0.872058693538407,0.388117870722433,0
"<anonymized_userid>",2,49330,4084,"Geert Wilders (PVV)",0.872094051091664,0.388212927756654,0
"<anonymized_userid>",2,49332,4085,"Geert Wilders (PVV)",0.872129408644922,0.388307984790875,0
"<anonymized_userid>",2,49334,4086,"Geert Wilders (PVV)",0.872164766198179,0.388403041825095,0
"<anonymized_userid>",2,49336,4087,"Geert Wilders (PVV)",0.872200123751436,0.388498098859316,0
"<anonymized_userid>",2,49338,4088,"Geert Wilders (PVV)",0.872235481304694,0.388593155893536,0
"<anonymized_userid>",2,49340,4089,"Geert Wilders (PVV)",0.872270838857951,0.388688212927757,0
"<anonymized_userid>",2,49342,4090,"Geert Wilders (PVV)",0.872306196411208,0.388783269961977,0
"<anonymized_userid>",2,49344,4091,"Geert Wilders (PVV)",0.872341553964466,0.388878326996198,0
"<anonymized_userid>",2,49346,4092,"Geert Wilders (PVV)",0.872376911517723,0.388973384030418,0
"<anonymized_userid>",2,49348,4093,"Geert Wilders (PVV)",0.87241226907098,0.389068441064639,0
"<anonymized_userid>",2,49350,4094,"Geert Wilders (PVV)",0.872447626624238,0.389163498098859,0
"<anonymized_userid>",2,49352,4095,"Geert Wilders (PVV)",0.872482984177495,0.38925855513308,0
"<anonymized_userid>",2,49354,4096,"Geert Wilders (PVV)",0.872518341730752,0.3893536121673,0
"<anonymized_userid>",2,49356,4097,"Geert Wilders (PVV)",0.872553699284009,0.389448669201521,0
"<anonymized_userid>",2,49358,4098,"Geert Wilders (PVV)",0.872589056837267,0.389543726235741,0
"<anonymized_userid>",2,49360,4099,"Geert Wilders (PVV)",0.872624414390524,0.389638783269962,0
"<anonymized_userid>",2,49362,4100,"Geert Wilders (PVV)",0.872659771943782,0.389733840304183,0
"<anonymized_userid>",2,49364,4101,"Geert Wilders (PVV)",0.872695129497039,0.389828897338403,0
"<anonymized_userid>",2,49366,4102,"Geert Wilders (PVV)",0.872730487050296,0.389923954372624,0
"<anonymized_userid>",2,49368,4103,"Geert Wilders (PVV)",0.872765844603553,0.390019011406844,0
"<anonymized_userid>",2,49370,4104,"Geert Wilders (PVV)",0.872801202156811,0.390114068441065,0
"<anonymized_userid>",2,49372,4105,"Geert Wilders (PVV)",0.872836559710068,0.390209125475285,0
"<anonymized_userid>",2,49374,4106,"Geert Wilders (PVV)",0.872871917263325,0.390304182509506,0
"<anonymized_userid>",2,49376,4107,"Geert Wilders (PVV)",0.872907274816583,0.390399239543726,0
"<anonymized_userid>",2,49378,4108,"Geert Wilders (PVV)",0.87294263236984,0.390494296577947,0
"<anonymized_userid>",2,49380,4109,"Geert Wilders (PVV)",0.872977989923097,0.390589353612167,0
"<anonymized_userid>",2,49382,4110,"Geert Wilders (PVV)",0.873013347476355,0.390684410646388,0
"<anonymized_userid>",2,49384,4111,"Geert Wilders (PVV)",0.873048705029612,0.390779467680608,0
"<anonymized_userid>",2,49386,4112,"Geert Wilders (PVV)",0.873084062582869,0.390874524714829,0
"<anonymized_userid>",2,49388,4113,"Geert Wilders (PVV)",0.873119420136127,0.390969581749049,0
"<anonymized_userid>",2,49390,4114,"Geert Wilders (PVV)",0.873154777689384,0.39106463878327,0
"<anonymized_userid>",2,49392,4115,"Geert Wilders (PVV)",0.873190135242641,0.39115969581749,0
"<anonymized_userid>",2,49394,4116,"Geert Wilders (PVV)",0.873225492795899,0.391254752851711,0
"<anonymized_userid>",2,49396,4117,"Geert Wilders (PVV)",0.873260850349156,0.391349809885932,0
"<anonymized_userid>",2,49398,4118,"Geert Wilders (PVV)",0.873296207902413,0.391444866920152,0
"<anonymized_userid>",2,49400,4119,"Geert Wilders (PVV)",0.87333156545567,0.391539923954373,0
"<anonymized_userid>",2,49402,4120,"Geert Wilders (PVV)",0.873366923008928,0.391634980988593,0
"<anonymized_userid>",2,49404,4121,"Geert Wilders (PVV)",0.873402280562185,0.391730038022814,0
"<anonymized_userid>",2,49406,4122,"Geert Wilders (PVV)",0.873437638115442,0.391825095057034,0
"<anonymized_userid>",2,49408,4123,"Geert Wilders (PVV)",0.8734729956687,0.391920152091255,0
"<anonymized_userid>",2,49410,4124,"Geert Wilders (PVV)",0.873508353221957,0.392015209125475,0
"<anonymized_userid>",2,49412,4125,"Geert Wilders (PVV)",0.873543710775214,0.392110266159696,0
"<anonymized_userid>",2,49414,4126,"Geert Wilders (PVV)",0.873579068328472,0.392205323193916,0
"<anonymized_userid>",2,49416,4127,"Geert Wilders (PVV)",0.873614425881729,0.392300380228137,0
"<anonymized_userid>",2,49418,4128,"Geert Wilders (PVV)",0.873649783434986,0.392395437262357,0
"<anonymized_userid>",2,49420,4129,"Geert Wilders (PVV)",0.873685140988244,0.392490494296578,0
"<anonymized_userid>",2,49422,4130,"Geert Wilders (PVV)",0.873720498541501,0.392585551330798,0
"<anonymized_userid>",2,49424,4131,"Geert Wilders (PVV)",0.873755856094758,0.392680608365019,0
"<anonymized_userid>",2,49426,4132,"Geert Wilders (PVV)",0.873791213648016,0.39277566539924,0
"<anonymized_userid>",2,49428,4133,"Geert Wilders (PVV)",0.873826571201273,0.39287072243346,0
"<anonymized_userid>",2,49430,4134,"Geert Wilders (PVV)",0.87386192875453,0.392965779467681,0
"<anonymized_userid>",2,49432,4135,"Geert Wilders (PVV)",0.873897286307788,0.393060836501901,0
"<anonymized_userid>",2,49434,4136,"Geert Wilders (PVV)",0.873932643861045,0.393155893536122,0
"<anonymized_userid>",2,49436,4137,"Geert Wilders (PVV)",0.873968001414302,0.393250950570342,0
"<anonymized_userid>",2,49438,4138,"Geert Wilders (PVV)",0.874003358967559,0.393346007604563,0
"<anonymized_userid>",2,49440,4139,"Geert Wilders (PVV)",0.874038716520817,0.393441064638783,0
"<anonymized_userid>",2,49442,4140,"Geert Wilders (PVV)",0.874074074074074,0.393536121673004,0
"<anonymized_userid>",2,49444,4141,"Geert Wilders (PVV)",0.874109431627331,0.393631178707224,0
"<anonymized_userid>",2,49446,4142,"Geert Wilders (PVV)",0.874144789180589,0.393726235741445,0
"<anonymized_userid>",2,49448,4143,"Geert Wilders (PVV)",0.874180146733846,0.393821292775665,0
"<anonymized_userid>",2,49450,4144,"Geert Wilders (PVV)",0.874215504287103,0.393916349809886,0
"<anonymized_userid>",2,49452,4145,"Geert Wilders (PVV)",0.874250861840361,0.394011406844106,0
"<anonymized_userid>",2,49454,4146,"Geert Wilders (PVV)",0.874286219393618,0.394106463878327,0
"<anonymized_userid>",2,49456,4147,"Geert Wilders (PVV)",0.874321576946875,0.394201520912548,0
"<anonymized_userid>",2,49458,4148,"Geert Wilders (PVV)",0.874356934500133,0.394296577946768,0
"<anonymized_userid>",2,49460,4149,"Geert Wilders (PVV)",0.87439229205339,0.394391634980989,0
"<anonymized_userid>",2,49462,4150,"Geert Wilders (PVV)",0.874427649606647,0.394486692015209,0
"<anonymized_userid>",2,49464,4151,"Geert Wilders (PVV)",0.874463007159905,0.39458174904943,0
"<anonymized_userid>",2,49466,4152,"Geert Wilders (PVV)",0.874498364713162,0.39467680608365,0
"<anonymized_userid>",2,49468,4153,"Geert Wilders (PVV)",0.874533722266419,0.394771863117871,0
"<anonymized_userid>",2,49470,4154,"Geert Wilders (PVV)",0.874569079819676,0.394866920152091,0
"<anonymized_userid>",2,49472,4155,"Geert Wilders (PVV)",0.874604437372934,0.394961977186312,0
"<anonymized_userid>",2,49474,4156,"Geert Wilders (PVV)",0.874639794926191,0.395057034220532,0
"<anonymized_userid>",2,49476,4157,"Geert Wilders (PVV)",0.874675152479448,0.395152091254753,0
"<anonymized_userid>",2,49478,4158,"Geert Wilders (PVV)",0.874710510032706,0.395247148288973,0
"<anonymized_userid>",2,49480,4159,"Geert Wilders (PVV)",0.874745867585963,0.395342205323194,0
"<anonymized_userid>",2,49482,4160,"Geert Wilders (PVV)",0.87478122513922,0.395437262357414,0
"<anonymized_userid>",2,49484,4161,"Geert Wilders (PVV)",0.874816582692478,0.395532319391635,0
"<anonymized_userid>",2,49486,4162,"Geert Wilders (PVV)",0.874851940245735,0.395627376425855,0
"<anonymized_userid>",2,49488,4163,"Geert Wilders (PVV)",0.874887297798992,0.395722433460076,0
"<anonymized_userid>",2,49490,4164,"Geert Wilders (PVV)",0.87492265535225,0.395817490494297,0
"<anonymized_userid>",2,49492,4165,"Geert Wilders (PVV)",0.874958012905507,0.395912547528517,0
"<anonymized_userid>",2,49494,4166,"Geert Wilders (PVV)",0.874993370458764,0.396007604562738,0
"<anonymized_userid>",2,49496,4167,"Geert Wilders (PVV)",0.875028728012022,0.396102661596958,0
"<anonymized_userid>",2,49498,4168,"Geert Wilders (PVV)",0.875064085565279,0.396197718631179,0
"<anonymized_userid>",2,49500,4169,"Geert Wilders (PVV)",0.875099443118536,0.396292775665399,0
"<anonymized_userid>",2,49502,4170,"Geert Wilders (PVV)",0.875134800671794,0.39638783269962,0
"<anonymized_userid>",2,49504,4171,"Geert Wilders (PVV)",0.875170158225051,0.39648288973384,0
"<anonymized_userid>",2,49506,4172,"Geert Wilders (PVV)",0.875205515778308,0.396577946768061,0
"<anonymized_userid>",2,49508,4173,"Geert Wilders (PVV)",0.875240873331565,0.396673003802281,0
"<anonymized_userid>",2,49510,4174,"Geert Wilders (PVV)",0.875276230884823,0.396768060836502,0
"<anonymized_userid>",2,49512,4175,"Geert Wilders (PVV)",0.87531158843808,0.396863117870722,0
"<anonymized_userid>",2,49514,4176,"Geert Wilders (PVV)",0.875346945991337,0.396958174904943,0
"<anonymized_userid>",2,49516,4177,"Geert Wilders (PVV)",0.875382303544595,0.397053231939163,0
"<anonymized_userid>",2,49518,4178,"Geert Wilders (PVV)",0.875417661097852,0.397148288973384,0
"<anonymized_userid>",2,49520,4179,"Geert Wilders (PVV)",0.875453018651109,0.397243346007605,0
"<anonymized_userid>",2,49522,4180,"Geert Wilders (PVV)",0.875488376204367,0.397338403041825,0
"<anonymized_userid>",2,49524,4181,"Geert Wilders (PVV)",0.875523733757624,0.397433460076046,0
"<anonymized_userid>",2,49526,4182,"Geert Wilders (PVV)",0.875559091310881,0.397528517110266,0
"<anonymized_userid>",2,49528,4183,"Geert Wilders (PVV)",0.875594448864139,0.397623574144487,0
"<anonymized_userid>",2,49530,4184,"Geert Wilders (PVV)",0.875629806417396,0.397718631178707,0
"<anonymized_userid>",2,49532,4185,"Geert Wilders (PVV)",0.875665163970653,0.397813688212928,0
"<anonymized_userid>",2,49534,4186,"Geert Wilders (PVV)",0.875700521523911,0.397908745247148,0
"<anonymized_userid>",2,49536,4187,"Geert Wilders (PVV)",0.875735879077168,0.398003802281369,0
"<anonymized_userid>",2,49538,4188,"Geert Wilders (PVV)",0.875771236630425,0.398098859315589,0
"<anonymized_userid>",2,49540,4189,"Geert Wilders (PVV)",0.875806594183682,0.39819391634981,0
"<anonymized_userid>",2,49542,4190,"Geert Wilders (PVV)",0.87584195173694,0.39828897338403,0
"<anonymized_userid>",2,49544,4191,"Geert Wilders (PVV)",0.875877309290197,0.398384030418251,0
"<anonymized_userid>",2,49546,4192,"Geert Wilders (PVV)",0.875912666843454,0.398479087452471,0
"<anonymized_userid>",2,49548,4193,"Geert Wilders (PVV)",0.875948024396712,0.398574144486692,0
"<anonymized_userid>",2,49550,4194,"Geert Wilders (PVV)",0.875983381949969,0.398669201520913,0
"<anonymized_userid>",2,49552,4195,"Geert Wilders (PVV)",0.876018739503226,0.398764258555133,0
"<anonymized_userid>",2,49554,4196,"Geert Wilders (PVV)",0.876054097056484,0.398859315589354,0
"<anonymized_userid>",2,49556,4197,"Geert Wilders (PVV)",0.876089454609741,0.398954372623574,0
"<anonymized_userid>",2,49558,4198,"Geert Wilders (PVV)",0.876124812162998,0.399049429657795,0
"<anonymized_userid>",2,49560,4199,"Geert Wilders (PVV)",0.876160169716256,0.399144486692015,0
"<anonymized_userid>",2,49562,4200,"Geert Wilders (PVV)",0.876195527269513,0.399239543726236,0
"<anonymized_userid>",2,49564,4201,"Geert Wilders (PVV)",0.87623088482277,0.399334600760456,0
"<anonymized_userid>",2,49566,4202,"Geert Wilders (PVV)",0.876266242376028,0.399429657794677,0
"<anonymized_userid>",2,49568,4203,"Geert Wilders (PVV)",0.876301599929285,0.399524714828897,0
"<anonymized_userid>",2,49570,4204,"Geert Wilders (PVV)",0.876336957482542,0.399619771863118,0
"<anonymized_userid>",2,49572,4205,"Geert Wilders (PVV)",0.876372315035799,0.399714828897338,0
"<anonymized_userid>",2,49574,4206,"Geert Wilders (PVV)",0.876407672589057,0.399809885931559,0
"<anonymized_userid>",2,49576,4207,"Geert Wilders (PVV)",0.876443030142314,0.399904942965779,0
"<anonymized_userid>",2,49578,4208,"Geert Wilders (PVV)",0.876478387695572,0.4,0
"<anonymized_userid>",2,49580,4209,"Geert Wilders (PVV)",0.876513745248829,0.400095057034221,0
"<anonymized_userid>",2,49582,4210,"Geert Wilders (PVV)",0.876549102802086,0.400190114068441,0
"<anonymized_userid>",2,49584,4211,"Geert Wilders (PVV)",0.876584460355343,0.400285171102662,0
"<anonymized_userid>",2,49586,4212,"Geert Wilders (PVV)",0.876619817908601,0.400380228136882,0
"<anonymized_userid>",2,49588,4213,"Geert Wilders (PVV)",0.876655175461858,0.400475285171103,0
"<anonymized_userid>",2,49590,4214,"Geert Wilders (PVV)",0.876690533015115,0.400570342205323,0
"<anonymized_userid>",2,49592,4215,"Geert Wilders (PVV)",0.876725890568373,0.400665399239544,0
"<anonymized_userid>",2,49594,4216,"Geert Wilders (PVV)",0.87676124812163,0.400760456273764,0
"<anonymized_userid>",2,49596,4217,"Geert Wilders (PVV)",0.876796605674887,0.400855513307985,0
"<anonymized_userid>",2,49598,4218,"Geert Wilders (PVV)",0.876831963228145,0.400950570342205,0
"<anonymized_userid>",2,49600,4219,"Geert Wilders (PVV)",0.876867320781402,0.401045627376426,0
"<anonymized_userid>",2,49602,4220,"Geert Wilders (PVV)",0.876902678334659,0.401140684410646,0
"<anonymized_userid>",2,49604,4221,"Geert Wilders (PVV)",0.876938035887917,0.401235741444867,0
"<anonymized_userid>",2,49606,4222,"Geert Wilders (PVV)",0.876973393441174,0.401330798479087,0
"<anonymized_userid>",2,49608,4223,"Geert Wilders (PVV)",0.877008750994431,0.401425855513308,0
"<anonymized_userid>",2,49610,4224,"Geert Wilders (PVV)",0.877044108547689,0.401520912547529,0
"<anonymized_userid>",2,49612,4225,"Geert Wilders (PVV)",0.877079466100946,0.401615969581749,0
"<anonymized_userid>",2,49614,4226,"Geert Wilders (PVV)",0.877114823654203,0.40171102661597,0
"<anonymized_userid>",2,49616,4227,"Geert Wilders (PVV)",0.87715018120746,0.40180608365019,0
"<anonymized_userid>",2,49618,4228,"Geert Wilders (PVV)",0.877185538760718,0.401901140684411,0
"<anonymized_userid>",2,49620,4229,"Geert Wilders (PVV)",0.877220896313975,0.401996197718631,0
"<anonymized_userid>",2,49622,4230,"Geert Wilders (PVV)",0.877256253867232,0.402091254752852,0
"<anonymized_userid>",2,49624,4231,"Geert Wilders (PVV)",0.87729161142049,0.402186311787072,0
"<anonymized_userid>",2,49626,4232,"Geert Wilders (PVV)",0.877326968973747,0.402281368821293,0
"<anonymized_userid>",2,49628,4233,"Geert Wilders (PVV)",0.877362326527004,0.402376425855513,0
"<anonymized_userid>",2,49630,4234,"Geert Wilders (PVV)",0.877397684080262,0.402471482889734,0
"<anonymized_userid>",2,49632,4235,"Geert Wilders (PVV)",0.877433041633519,0.402566539923954,0
"<anonymized_userid>",2,49634,4236,"Geert Wilders (PVV)",0.877468399186776,0.402661596958175,0
"<anonymized_userid>",2,49636,4237,"Geert Wilders (PVV)",0.877503756740034,0.402756653992395,0
"<anonymized_userid>",2,49638,4238,"Geert Wilders (PVV)",0.877539114293291,0.402851711026616,0
"<anonymized_userid>",2,49640,4239,"Geert Wilders (PVV)",0.877574471846548,0.402946768060837,0
"<anonymized_userid>",2,49642,4240,"Geert Wilders (PVV)",0.877609829399806,0.403041825095057,0
"<anonymized_userid>",2,49644,4241,"Geert Wilders (PVV)",0.877645186953063,0.403136882129278,0
"<anonymized_userid>",2,49646,4242,"Geert Wilders (PVV)",0.87768054450632,0.403231939163498,0
"<anonymized_userid>",2,49648,4243,"Geert Wilders (PVV)",0.877715902059578,0.403326996197719,0
"<anonymized_userid>",2,49650,4244,"Geert Wilders (PVV)",0.877751259612835,0.403422053231939,0
"<anonymized_userid>",2,49652,4245,"Geert Wilders (PVV)",0.877786617166092,0.40351711026616,0
"<anonymized_userid>",2,49654,4246,"Geert Wilders (PVV)",0.877821974719349,0.40361216730038,0
"<anonymized_userid>",2,49656,4247,"Geert Wilders (PVV)",0.877857332272607,0.403707224334601,0
"<anonymized_userid>",2,49658,4248,"Geert Wilders (PVV)",0.877892689825864,0.403802281368821,0
"<anonymized_userid>",2,49660,4249,"Geert Wilders (PVV)",0.877928047379121,0.403897338403042,0
"<anonymized_userid>",2,49662,4250,"Geert Wilders (PVV)",0.877963404932379,0.403992395437262,0
"<anonymized_userid>",2,49664,4251,"Geert Wilders (PVV)",0.877998762485636,0.404087452471483,0
"<anonymized_userid>",2,49666,4252,"Geert Wilders (PVV)",0.878034120038893,0.404182509505703,0
"<anonymized_userid>",2,49668,4253,"Geert Wilders (PVV)",0.878069477592151,0.404277566539924,0
"<anonymized_userid>",2,49670,4254,"Geert Wilders (PVV)",0.878104835145408,0.404372623574144,0
"<anonymized_userid>",2,49672,4255,"Geert Wilders (PVV)",0.878140192698665,0.404467680608365,0
"<anonymized_userid>",2,49674,4256,"Geert Wilders (PVV)",0.878175550251923,0.404562737642586,0
"<anonymized_userid>",2,49676,4257,"Geert Wilders (PVV)",0.87821090780518,0.404657794676806,0
"<anonymized_userid>",2,49678,4258,"Geert Wilders (PVV)",0.878246265358437,0.404752851711027,0
"<anonymized_userid>",2,49680,4259,"Geert Wilders (PVV)",0.878281622911695,0.404847908745247,0
"<anonymized_userid>",2,49682,4260,"Geert Wilders (PVV)",0.878316980464952,0.404942965779468,0
"<anonymized_userid>",2,49684,4261,"Geert Wilders (PVV)",0.878352338018209,0.405038022813688,0
"<anonymized_userid>",2,49686,4262,"Geert Wilders (PVV)",0.878387695571466,0.405133079847909,0
"<anonymized_userid>",2,49688,4263,"Geert Wilders (PVV)",0.878423053124724,0.405228136882129,0
"<anonymized_userid>",2,49690,4264,"Geert Wilders (PVV)",0.878458410677981,0.40532319391635,0
"<anonymized_userid>",2,49692,4265,"Geert Wilders (PVV)",0.878493768231238,0.40541825095057,0
"<anonymized_userid>",2,49694,4266,"Geert Wilders (PVV)",0.878529125784496,0.405513307984791,0
"<anonymized_userid>",2,49696,4267,"Geert Wilders (PVV)",0.878564483337753,0.405608365019011,0
"<anonymized_userid>",2,49698,4268,"Geert Wilders (PVV)",0.87859984089101,0.405703422053232,0
"<anonymized_userid>",2,49700,4269,"Geert Wilders (PVV)",0.878635198444268,0.405798479087452,0
"<anonymized_userid>",2,49702,4270,"Geert Wilders (PVV)",0.878670555997525,0.405893536121673,0
"<anonymized_userid>",2,49704,4271,"Geert Wilders (PVV)",0.878705913550782,0.405988593155894,0
"<anonymized_userid>",2,49706,4272,"Geert Wilders (PVV)",0.87874127110404,0.406083650190114,0
"<anonymized_userid>",2,49708,4273,"Geert Wilders (PVV)",0.878776628657297,0.406178707224335,0
"<anonymized_userid>",2,49710,4274,"Geert Wilders (PVV)",0.878811986210554,0.406273764258555,0
"<anonymized_userid>",2,49712,4275,"Geert Wilders (PVV)",0.878847343763812,0.406368821292776,0
"<anonymized_userid>",2,49714,4276,"Geert Wilders (PVV)",0.878882701317069,0.406463878326996,0
"<anonymized_userid>",2,49716,4277,"Geert Wilders (PVV)",0.878918058870326,0.406558935361217,0
"<anonymized_userid>",2,49718,4278,"Geert Wilders (PVV)",0.878953416423583,0.406653992395437,0
"<anonymized_userid>",2,49720,4279,"Geert Wilders (PVV)",0.878988773976841,0.406749049429658,0
"<anonymized_userid>",2,49722,4280,"Geert Wilders (PVV)",0.879024131530098,0.406844106463878,0
"<anonymized_userid>",2,49724,4281,"Geert Wilders (PVV)",0.879059489083355,0.406939163498099,0
"<anonymized_userid>",2,49726,4282,"Geert Wilders (PVV)",0.879094846636613,0.407034220532319,0
"<anonymized_userid>",2,49728,4283,"Geert Wilders (PVV)",0.87913020418987,0.40712927756654,0
"<anonymized_userid>",2,49730,4284,"Geert Wilders (PVV)",0.879165561743127,0.40722433460076,0
"<anonymized_userid>",2,49732,4285,"Geert Wilders (PVV)",0.879200919296385,0.407319391634981,0
"<anonymized_userid>",2,49734,4286,"Geert Wilders (PVV)",0.879236276849642,0.407414448669202,0
"<anonymized_userid>",2,49736,4287,"Geert Wilders (PVV)",0.879271634402899,0.407509505703422,0
"<anonymized_userid>",2,49738,4288,"Geert Wilders (PVV)",0.879306991956157,0.407604562737643,0
"<anonymized_userid>",2,49740,4289,"Geert Wilders (PVV)",0.879342349509414,0.407699619771863,0
"<anonymized_userid>",2,49742,4290,"Geert Wilders (PVV)",0.879377707062671,0.407794676806084,0
"<anonymized_userid>",2,49744,4291,"Geert Wilders (PVV)",0.879413064615929,0.407889733840304,0
"<anonymized_userid>",2,49746,4292,"Geert Wilders (PVV)",0.879448422169186,0.407984790874525,0
"<anonymized_userid>",2,49748,4293,"Geert Wilders (PVV)",0.879483779722443,0.408079847908745,0
"<anonymized_userid>",2,49750,4294,"Geert Wilders (PVV)",0.879519137275701,0.408174904942966,0
"<anonymized_userid>",2,49752,4295,"Geert Wilders (PVV)",0.879554494828958,0.408269961977186,0
"<anonymized_userid>",2,49754,4296,"Geert Wilders (PVV)",0.879589852382215,0.408365019011407,0
"<anonymized_userid>",2,49756,4297,"Geert Wilders (PVV)",0.879625209935472,0.408460076045627,0
"<anonymized_userid>",2,49758,4298,"Geert Wilders (PVV)",0.87966056748873,0.408555133079848,0
"<anonymized_userid>",2,49760,4299,"Geert Wilders (PVV)",0.879695925041987,0.408650190114068,0
"<anonymized_userid>",2,49762,4300,"Geert Wilders (PVV)",0.879731282595244,0.408745247148289,0
"<anonymized_userid>",2,49764,4301,"Geert Wilders (PVV)",0.879766640148502,0.408840304182509,0
"<anonymized_userid>",2,49766,4302,"Geert Wilders (PVV)",0.879801997701759,0.40893536121673,0
"<anonymized_userid>",2,49768,4303,"Geert Wilders (PVV)",0.879837355255016,0.409030418250951,0
"<anonymized_userid>",2,49770,4304,"Geert Wilders (PVV)",0.879872712808274,0.409125475285171,0
"<anonymized_userid>",2,49772,4305,"Geert Wilders (PVV)",0.879908070361531,0.409220532319392,0
"<anonymized_userid>",2,49774,4306,"Geert Wilders (PVV)",0.879943427914788,0.409315589353612,0
"<anonymized_userid>",2,49776,4307,"Geert Wilders (PVV)",0.879978785468046,0.409410646387833,0
"<anonymized_userid>",2,49778,4308,"Geert Wilders (PVV)",0.880014143021303,0.409505703422053,0
"<anonymized_userid>",2,49780,4309,"Geert Wilders (PVV)",0.88004950057456,0.409600760456274,0
"<anonymized_userid>",2,49782,4310,"Geert Wilders (PVV)",0.880084858127818,0.409695817490494,0
"<anonymized_userid>",2,49784,4311,"Geert Wilders (PVV)",0.880120215681075,0.409790874524715,0
"<anonymized_userid>",2,49786,4312,"Geert Wilders (PVV)",0.880155573234332,0.409885931558935,0
"<anonymized_userid>",2,49788,4313,"Geert Wilders (PVV)",0.880190930787589,0.409980988593156,0
"<anonymized_userid>",2,49790,4314,"Geert Wilders (PVV)",0.880226288340847,0.410076045627376,0
"<anonymized_userid>",2,49792,4315,"Geert Wilders (PVV)",0.880261645894104,0.410171102661597,0
"<anonymized_userid>",2,49794,4316,"Geert Wilders (PVV)",0.880297003447361,0.410266159695817,0
"<anonymized_userid>",2,49796,4317,"Geert Wilders (PVV)",0.880332361000619,0.410361216730038,0
"<anonymized_userid>",2,49798,4318,"Geert Wilders (PVV)",0.880367718553876,0.410456273764259,0
"<anonymized_userid>",2,49800,4319,"Geert Wilders (PVV)",0.880403076107133,0.410551330798479,0
"<anonymized_userid>",2,49802,4320,"Geert Wilders (PVV)",0.880438433660391,0.4106463878327,0
"<anonymized_userid>",2,49804,4321,"Geert Wilders (PVV)",0.880473791213648,0.41074144486692,0
"<anonymized_userid>",2,49806,4322,"Geert Wilders (PVV)",0.880509148766905,0.410836501901141,0
"<anonymized_userid>",2,49808,4323,"Geert Wilders (PVV)",0.880544506320163,0.410931558935361,0
"<anonymized_userid>",2,49810,4324,"Geert Wilders (PVV)",0.88057986387342,0.411026615969582,0
"<anonymized_userid>",2,49812,4325,"Geert Wilders (PVV)",0.880615221426677,0.411121673003802,0
"<anonymized_userid>",2,49814,4326,"Geert Wilders (PVV)",0.880650578979935,0.411216730038023,0
"<anonymized_userid>",2,49816,4327,"Geert Wilders (PVV)",0.880685936533192,0.411311787072243,0
"<anonymized_userid>",2,49818,4328,"Geert Wilders (PVV)",0.880721294086449,0.411406844106464,0
"<anonymized_userid>",2,49820,4329,"Geert Wilders (PVV)",0.880756651639707,0.411501901140684,0
"<anonymized_userid>",2,49822,4330,"Geert Wilders (PVV)",0.880792009192964,0.411596958174905,0
"<anonymized_userid>",2,49824,4331,"Geert Wilders (PVV)",0.880827366746221,0.411692015209125,0
"<anonymized_userid>",2,49826,4332,"Geert Wilders (PVV)",0.880862724299478,0.411787072243346,0
"<anonymized_userid>",2,49828,4333,"Geert Wilders (PVV)",0.880898081852736,0.411882129277567,0
"<anonymized_userid>",2,49830,4334,"Geert Wilders (PVV)",0.880933439405993,0.411977186311787,0
"<anonymized_userid>",2,49832,4335,"Geert Wilders (PVV)",0.88096879695925,0.412072243346008,0
"<anonymized_userid>",2,49834,4336,"Geert Wilders (PVV)",0.881004154512508,0.412167300380228,0
"<anonymized_userid>",2,49836,4337,"Geert Wilders (PVV)",0.881039512065765,0.412262357414449,0
"<anonymized_userid>",2,49838,4338,"Geert Wilders (PVV)",0.881074869619022,0.412357414448669,0
"<anonymized_userid>",2,49840,4339,"Geert Wilders (PVV)",0.88111022717228,0.41245247148289,0
"<anonymized_userid>",2,49842,4340,"Geert Wilders (PVV)",0.881145584725537,0.41254752851711,0
"<anonymized_userid>",2,49844,4341,"Geert Wilders (PVV)",0.881180942278794,0.412642585551331,0
"<anonymized_userid>",2,49846,4342,"Geert Wilders (PVV)",0.881216299832052,0.412737642585551,0
"<anonymized_userid>",2,49848,4343,"Geert Wilders (PVV)",0.881251657385309,0.412832699619772,0
"<anonymized_userid>",2,49850,4344,"Geert Wilders (PVV)",0.881287014938566,0.412927756653992,0
"<anonymized_userid>",2,49852,4345,"Geert Wilders (PVV)",0.881322372491824,0.413022813688213,0
"<anonymized_userid>",2,49854,4346,"Geert Wilders (PVV)",0.881357730045081,0.413117870722433,0
"<anonymized_userid>",2,49856,4347,"Geert Wilders (PVV)",0.881393087598338,0.413212927756654,0
"<anonymized_userid>",2,49858,4348,"Geert Wilders (PVV)",0.881428445151595,0.413307984790875,0
"<anonymized_userid>",2,49860,4349,"Geert Wilders (PVV)",0.881463802704853,0.413403041825095,0
"<anonymized_userid>",2,49862,4350,"Geert Wilders (PVV)",0.88149916025811,0.413498098859316,0
"<anonymized_userid>",2,49864,4351,"Geert Wilders (PVV)",0.881534517811367,0.413593155893536,0
"<anonymized_userid>",2,49866,4352,"Geert Wilders (PVV)",0.881569875364625,0.413688212927757,0
"<anonymized_userid>",2,49868,4353,"Geert Wilders (PVV)",0.881605232917882,0.413783269961977,0
"<anonymized_userid>",2,49870,4354,"Geert Wilders (PVV)",0.881640590471139,0.413878326996198,0
"<anonymized_userid>",2,49872,4355,"Geert Wilders (PVV)",0.881675948024397,0.413973384030418,0
"<anonymized_userid>",2,49874,4356,"Geert Wilders (PVV)",0.881711305577654,0.414068441064639,0
"<anonymized_userid>",2,49876,4357,"Geert Wilders (PVV)",0.881746663130911,0.414163498098859,0
"<anonymized_userid>",2,49878,4358,"Geert Wilders (PVV)",0.881782020684169,0.41425855513308,0
"<anonymized_userid>",2,49880,4359,"Geert Wilders (PVV)",0.881817378237426,0.4143536121673,0
"<anonymized_userid>",2,49882,4360,"Geert Wilders (PVV)",0.881852735790683,0.414448669201521,0
"<anonymized_userid>",2,49884,4361,"Geert Wilders (PVV)",0.881888093343941,0.414543726235741,0
"<anonymized_userid>",2,49886,4362,"Geert Wilders (PVV)",0.881923450897198,0.414638783269962,0
"<anonymized_userid>",2,49888,4363,"Geert Wilders (PVV)",0.881958808450455,0.414733840304183,0
"<anonymized_userid>",2,49890,4364,"Geert Wilders (PVV)",0.881994166003712,0.414828897338403,0
"<anonymized_userid>",2,49892,4365,"Geert Wilders (PVV)",0.88202952355697,0.414923954372624,0
"<anonymized_userid>",2,49894,4366,"Geert Wilders (PVV)",0.882064881110227,0.415019011406844,0
"<anonymized_userid>",2,49896,4367,"Geert Wilders (PVV)",0.882100238663485,0.415114068441065,0
"<anonymized_userid>",2,49898,4368,"Geert Wilders (PVV)",0.882135596216742,0.415209125475285,0
"<anonymized_userid>",2,49900,4369,"Geert Wilders (PVV)",0.882170953769999,0.415304182509506,0
"<anonymized_userid>",2,49902,4370,"Geert Wilders (PVV)",0.882206311323256,0.415399239543726,0
"<anonymized_userid>",2,49904,4371,"Geert Wilders (PVV)",0.882241668876514,0.415494296577947,0
"<anonymized_userid>",2,49906,4372,"Geert Wilders (PVV)",0.882277026429771,0.415589353612167,0
"<anonymized_userid>",2,49908,4373,"Geert Wilders (PVV)",0.882312383983028,0.415684410646388,0
"<anonymized_userid>",2,49910,4374,"Geert Wilders (PVV)",0.882347741536286,0.415779467680608,0
"<anonymized_userid>",2,49912,4375,"Geert Wilders (PVV)",0.882383099089543,0.415874524714829,0
"<anonymized_userid>",2,49914,4376,"Geert Wilders (PVV)",0.8824184566428,0.415969581749049,0
"<anonymized_userid>",2,49916,4377,"Geert Wilders (PVV)",0.882453814196058,0.41606463878327,0
"<anonymized_userid>",2,49918,4378,"Geert Wilders (PVV)",0.882489171749315,0.416159695817491,0
"<anonymized_userid>",2,49920,4379,"Geert Wilders (PVV)",0.882524529302572,0.416254752851711,0
"<anonymized_userid>",2,49922,4380,"Geert Wilders (PVV)",0.88255988685583,0.416349809885932,0
"<anonymized_userid>",2,49924,4381,"Geert Wilders (PVV)",0.882595244409087,0.416444866920152,0
"<anonymized_userid>",2,49926,4382,"Geert Wilders (PVV)",0.882630601962344,0.416539923954373,0
"<anonymized_userid>",2,49928,4383,"Geert Wilders (PVV)",0.882665959515602,0.416634980988593,0
"<anonymized_userid>",2,49930,4384,"Geert Wilders (PVV)",0.882701317068859,0.416730038022814,0
"<anonymized_userid>",2,49932,4385,"Geert Wilders (PVV)",0.882736674622116,0.416825095057034,0
"<anonymized_userid>",2,49934,4386,"Geert Wilders (PVV)",0.882772032175373,0.416920152091255,0
"<anonymized_userid>",2,49936,4387,"Geert Wilders (PVV)",0.882807389728631,0.417015209125475,0
"<anonymized_userid>",2,49938,4388,"Geert Wilders (PVV)",0.882842747281888,0.417110266159696,0
"<anonymized_userid>",2,49940,4389,"Geert Wilders (PVV)",0.882878104835145,0.417205323193916,0
"<anonymized_userid>",2,49942,4390,"Geert Wilders (PVV)",0.882913462388403,0.417300380228137,0
"<anonymized_userid>",2,49944,4391,"Geert Wilders (PVV)",0.88294881994166,0.417395437262357,0
"<anonymized_userid>",2,49946,4392,"Geert Wilders (PVV)",0.882984177494917,0.417490494296578,0
"<anonymized_userid>",2,49948,4393,"Geert Wilders (PVV)",0.883019535048175,0.417585551330798,0
"<anonymized_userid>",2,49950,4394,"Geert Wilders (PVV)",0.883054892601432,0.417680608365019,0
"<anonymized_userid>",2,49952,4395,"Geert Wilders (PVV)",0.883090250154689,0.41777566539924,0
"<anonymized_userid>",2,49954,4396,"Geert Wilders (PVV)",0.883125607707947,0.41787072243346,0
"<anonymized_userid>",2,49956,4397,"Geert Wilders (PVV)",0.883160965261204,0.417965779467681,0
"<anonymized_userid>",2,49958,4398,"Geert Wilders (PVV)",0.883196322814461,0.418060836501901,0
"<anonymized_userid>",2,49960,4399,"Geert Wilders (PVV)",0.883231680367719,0.418155893536122,0
"<anonymized_userid>",2,49962,4400,"Geert Wilders (PVV)",0.883267037920976,0.418250950570342,0
"<anonymized_userid>",2,49964,4401,"Geert Wilders (PVV)",0.883302395474233,0.418346007604563,0
"<anonymized_userid>",2,49966,4402,"Geert Wilders (PVV)",0.883337753027491,0.418441064638783,0
"<anonymized_userid>",2,49968,4403,"Geert Wilders (PVV)",0.883373110580748,0.418536121673004,0
"<anonymized_userid>",2,49970,4404,"Geert Wilders (PVV)",0.883408468134005,0.418631178707224,0
"<anonymized_userid>",2,49972,4405,"Geert Wilders (PVV)",0.883443825687262,0.418726235741445,0
"<anonymized_userid>",2,49974,4406,"Geert Wilders (PVV)",0.88347918324052,0.418821292775665,0
"<anonymized_userid>",2,49976,4407,"Geert Wilders (PVV)",0.883514540793777,0.418916349809886,0
"<anonymized_userid>",2,49978,4408,"Geert Wilders (PVV)",0.883549898347034,0.419011406844106,0
"<anonymized_userid>",2,49980,4409,"Geert Wilders (PVV)",0.883585255900292,0.419106463878327,0
"<anonymized_userid>",2,49982,4410,"Geert Wilders (PVV)",0.883620613453549,0.419201520912548,0
"<anonymized_userid>",2,49984,4411,"Geert Wilders (PVV)",0.883655971006806,0.419296577946768,0
"<anonymized_userid>",2,49986,4412,"Geert Wilders (PVV)",0.883691328560064,0.419391634980989,0
"<anonymized_userid>",2,49988,4413,"Geert Wilders (PVV)",0.883726686113321,0.419486692015209,0
"<anonymized_userid>",2,49990,4414,"Geert Wilders (PVV)",0.883762043666578,0.41958174904943,0
"<anonymized_userid>",2,49992,4415,"Geert Wilders (PVV)",0.883797401219836,0.41967680608365,0
"<anonymized_userid>",2,49994,4416,"Geert Wilders (PVV)",0.883832758773093,0.419771863117871,0
"<anonymized_userid>",2,49996,4417,"Geert Wilders (PVV)",0.88386811632635,0.419866920152091,0
"<anonymized_userid>",2,49998,4418,"Geert Wilders (PVV)",0.883903473879608,0.419961977186312,0
"<anonymized_userid>",2,50000,4419,"Geert Wilders (PVV)",0.883938831432865,0.420057034220532,0
"<anonymized_userid>",2,50002,4420,"Geert Wilders (PVV)",0.883974188986122,0.420152091254753,0
"<anonymized_userid>",2,50004,4421,"Geert Wilders (PVV)",0.884009546539379,0.420247148288973,0
"<anonymized_userid>",2,50006,4422,"Geert Wilders (PVV)",0.884044904092637,0.420342205323194,0
"<anonymized_userid>",2,50008,4423,"Geert Wilders (PVV)",0.884080261645894,0.420437262357414,0
"<anonymized_userid>",2,50010,4424,"Geert Wilders (PVV)",0.884115619199151,0.420532319391635,0
"<anonymized_userid>",2,50012,4425,"Geert Wilders (PVV)",0.884150976752409,0.420627376425856,0
"<anonymized_userid>",2,50014,4426,"Geert Wilders (PVV)",0.884186334305666,0.420722433460076,0
"<anonymized_userid>",2,50016,4427,"Geert Wilders (PVV)",0.884221691858923,0.420817490494297,0
"<anonymized_userid>",2,50018,4428,"Geert Wilders (PVV)",0.884257049412181,0.420912547528517,0
"<anonymized_userid>",2,50020,4429,"Geert Wilders (PVV)",0.884292406965438,0.421007604562738,0
"<anonymized_userid>",2,50022,4430,"Geert Wilders (PVV)",0.884327764518695,0.421102661596958,0
"<anonymized_userid>",2,50024,4431,"Geert Wilders (PVV)",0.884363122071953,0.421197718631179,0
"<anonymized_userid>",2,50026,4432,"Geert Wilders (PVV)",0.88439847962521,0.421292775665399,0
"<anonymized_userid>",2,50028,4433,"Geert Wilders (PVV)",0.884433837178467,0.42138783269962,0
"<anonymized_userid>",2,50030,4434,"Geert Wilders (PVV)",0.884469194731725,0.42148288973384,0
"<anonymized_userid>",2,50032,4435,"Geert Wilders (PVV)",0.884504552284982,0.421577946768061,0
"<anonymized_userid>",2,50034,4436,"Geert Wilders (PVV)",0.884539909838239,0.421673003802281,0
"<anonymized_userid>",2,50036,4437,"Geert Wilders (PVV)",0.884575267391497,0.421768060836502,0
"<anonymized_userid>",2,50038,4438,"Geert Wilders (PVV)",0.884610624944754,0.421863117870722,0
"<anonymized_userid>",2,50040,4439,"Geert Wilders (PVV)",0.884645982498011,0.421958174904943,0
"<anonymized_userid>",2,50042,4440,"Geert Wilders (PVV)",0.884681340051268,0.422053231939163,0
"<anonymized_userid>",2,50044,4441,"Geert Wilders (PVV)",0.884716697604526,0.422148288973384,0
"<anonymized_userid>",2,50046,4442,"Geert Wilders (PVV)",0.884752055157783,0.422243346007605,0
"<anonymized_userid>",2,50048,4443,"Geert Wilders (PVV)",0.88478741271104,0.422338403041825,0
"<anonymized_userid>",2,50050,4444,"Geert Wilders (PVV)",0.884822770264298,0.422433460076046,0
"<anonymized_userid>",2,50052,4445,"Geert Wilders (PVV)",0.884858127817555,0.422528517110266,0
"<anonymized_userid>",2,50054,4446,"Geert Wilders (PVV)",0.884893485370812,0.422623574144487,0
"<anonymized_userid>",2,50056,4447,"Geert Wilders (PVV)",0.88492884292407,0.422718631178707,0
"<anonymized_userid>",2,50058,4448,"Geert Wilders (PVV)",0.884964200477327,0.422813688212928,0
"<anonymized_userid>",2,50060,4449,"Geert Wilders (PVV)",0.884999558030584,0.422908745247148,0
"<anonymized_userid>",2,50062,4450,"Geert Wilders (PVV)",0.885034915583842,0.423003802281369,0
"<anonymized_userid>",2,50064,4451,"Geert Wilders (PVV)",0.885070273137099,0.423098859315589,0
"<anonymized_userid>",2,50066,4452,"Geert Wilders (PVV)",0.885105630690356,0.42319391634981,0
"<anonymized_userid>",2,50068,4453,"Geert Wilders (PVV)",0.885140988243614,0.42328897338403,0
"<anonymized_userid>",2,50070,4454,"Geert Wilders (PVV)",0.885176345796871,0.423384030418251,0
"<anonymized_userid>",2,50072,4455,"Geert Wilders (PVV)",0.885211703350128,0.423479087452471,0
"<anonymized_userid>",2,50074,4456,"Geert Wilders (PVV)",0.885247060903385,0.423574144486692,0
"<anonymized_userid>",2,50076,4457,"Geert Wilders (PVV)",0.885282418456643,0.423669201520913,0
"<anonymized_userid>",2,50078,4458,"Geert Wilders (PVV)",0.8853177760099,0.423764258555133,0
"<anonymized_userid>",2,50080,4459,"Geert Wilders (PVV)",0.885353133563157,0.423859315589354,0
"<anonymized_userid>",2,50082,4460,"Geert Wilders (PVV)",0.885388491116415,0.423954372623574,0
"<anonymized_userid>",2,50084,4461,"Geert Wilders (PVV)",0.885423848669672,0.424049429657795,0
"<anonymized_userid>",2,50086,4462,"Geert Wilders (PVV)",0.885459206222929,0.424144486692015,0
"<anonymized_userid>",2,50088,4463,"Geert Wilders (PVV)",0.885494563776187,0.424239543726236,0
"<anonymized_userid>",2,50090,4464,"Geert Wilders (PVV)",0.885529921329444,0.424334600760456,0
"<anonymized_userid>",2,50092,4465,"Geert Wilders (PVV)",0.885565278882701,0.424429657794677,0
"<anonymized_userid>",2,50094,4466,"Geert Wilders (PVV)",0.885600636435959,0.424524714828897,0
"<anonymized_userid>",2,50096,4467,"Geert Wilders (PVV)",0.885635993989216,0.424619771863118,0
"<anonymized_userid>",2,50098,4468,"Geert Wilders (PVV)",0.885671351542473,0.424714828897338,0
"<anonymized_userid>",2,50100,4469,"Geert Wilders (PVV)",0.885706709095731,0.424809885931559,0
"<anonymized_userid>",2,50102,4470,"Geert Wilders (PVV)",0.885742066648988,0.424904942965779,0
"<anonymized_userid>",2,50104,4471,"Geert Wilders (PVV)",0.885777424202245,0.425,0
"<anonymized_userid>",2,50106,4472,"Geert Wilders (PVV)",0.885812781755502,0.425095057034221,0
"<anonymized_userid>",2,50108,4473,"Geert Wilders (PVV)",0.88584813930876,0.425190114068441,0
"<anonymized_userid>",2,50110,4474,"Geert Wilders (PVV)",0.885883496862017,0.425285171102662,0
"<anonymized_userid>",2,50112,4475,"Geert Wilders (PVV)",0.885918854415275,0.425380228136882,0
"<anonymized_userid>",2,50114,4476,"Geert Wilders (PVV)",0.885954211968532,0.425475285171103,0
"<anonymized_userid>",2,50116,4477,"Geert Wilders (PVV)",0.885989569521789,0.425570342205323,0
"<anonymized_userid>",2,50118,4478,"Geert Wilders (PVV)",0.886024927075046,0.425665399239544,0
"<anonymized_userid>",2,50120,4479,"Geert Wilders (PVV)",0.886060284628304,0.425760456273764,0
"<anonymized_userid>",2,50122,4480,"Geert Wilders (PVV)",0.886095642181561,0.425855513307985,0
"<anonymized_userid>",2,50124,4481,"Geert Wilders (PVV)",0.886130999734818,0.425950570342205,0
"<anonymized_userid>",2,50126,4482,"Geert Wilders (PVV)",0.886166357288076,0.426045627376426,0
"<anonymized_userid>",2,50128,4483,"Geert Wilders (PVV)",0.886201714841333,0.426140684410646,0
"<anonymized_userid>",2,50130,4484,"Geert Wilders (PVV)",0.88623707239459,0.426235741444867,0
"<anonymized_userid>",2,50132,4485,"Geert Wilders (PVV)",0.886272429947848,0.426330798479087,0
"<anonymized_userid>",2,50134,4486,"Geert Wilders (PVV)",0.886307787501105,0.426425855513308,0
"<anonymized_userid>",2,50136,4487,"Geert Wilders (PVV)",0.886343145054362,0.426520912547528,0
"<anonymized_userid>",2,50138,4488,"Geert Wilders (PVV)",0.88637850260762,0.426615969581749,0
"<anonymized_userid>",2,50140,4489,"Geert Wilders (PVV)",0.886413860160877,0.42671102661597,0
"<anonymized_userid>",2,50142,4490,"Geert Wilders (PVV)",0.886449217714134,0.42680608365019,0
"<anonymized_userid>",2,50144,4491,"Geert Wilders (PVV)",0.886484575267392,0.426901140684411,0
"<anonymized_userid>",2,50146,4492,"Geert Wilders (PVV)",0.886519932820649,0.426996197718631,0
"<anonymized_userid>",2,50148,4493,"Geert Wilders (PVV)",0.886555290373906,0.427091254752852,0
"<anonymized_userid>",2,50150,4494,"Geert Wilders (PVV)",0.886590647927163,0.427186311787072,0
"<anonymized_userid>",2,50152,4495,"Geert Wilders (PVV)",0.886626005480421,0.427281368821293,0
"<anonymized_userid>",2,50154,4496,"Geert Wilders (PVV)",0.886661363033678,0.427376425855513,0
"<anonymized_userid>",2,50156,4497,"Geert Wilders (PVV)",0.886696720586935,0.427471482889734,0
"<anonymized_userid>",2,50158,4498,"Geert Wilders (PVV)",0.886732078140193,0.427566539923954,0
"<anonymized_userid>",2,50160,4499,"Geert Wilders (PVV)",0.88676743569345,0.427661596958175,0
"<anonymized_userid>",2,50162,4500,"Geert Wilders (PVV)",0.886802793246707,0.427756653992395,0
"<anonymized_userid>",2,50164,4501,"Geert Wilders (PVV)",0.886838150799965,0.427851711026616,0
"<anonymized_userid>",2,50166,4502,"Geert Wilders (PVV)",0.886873508353222,0.427946768060836,0
"<anonymized_userid>",2,50168,4503,"Geert Wilders (PVV)",0.886908865906479,0.428041825095057,0
"<anonymized_userid>",2,50170,4504,"Geert Wilders (PVV)",0.886944223459737,0.428136882129278,0
"<anonymized_userid>",2,50172,4505,"Geert Wilders (PVV)",0.886979581012994,0.428231939163498,0
"<anonymized_userid>",2,50174,4506,"Geert Wilders (PVV)",0.887014938566251,0.428326996197719,0
"<anonymized_userid>",2,50176,4507,"Geert Wilders (PVV)",0.887050296119508,0.428422053231939,0
"<anonymized_userid>",2,50178,4508,"Geert Wilders (PVV)",0.887085653672766,0.42851711026616,0
"<anonymized_userid>",2,50180,4509,"Geert Wilders (PVV)",0.887121011226023,0.42861216730038,0
"<anonymized_userid>",2,50182,4510,"Geert Wilders (PVV)",0.887156368779281,0.428707224334601,0
"<anonymized_userid>",2,50184,4511,"Geert Wilders (PVV)",0.887191726332538,0.428802281368821,0
"<anonymized_userid>",2,50186,4512,"Geert Wilders (PVV)",0.887227083885795,0.428897338403042,0
"<anonymized_userid>",2,50188,4513,"Geert Wilders (PVV)",0.887262441439052,0.428992395437262,0
"<anonymized_userid>",2,50190,4514,"Geert Wilders (PVV)",0.88729779899231,0.429087452471483,0
"<anonymized_userid>",2,50192,4515,"Geert Wilders (PVV)",0.887333156545567,0.429182509505703,0
"<anonymized_userid>",2,50194,4516,"Geert Wilders (PVV)",0.887368514098824,0.429277566539924,0
"<anonymized_userid>",2,50196,4517,"Geert Wilders (PVV)",0.887403871652082,0.429372623574144,0
"<anonymized_userid>",2,50198,4518,"Geert Wilders (PVV)",0.887439229205339,0.429467680608365,0
"<anonymized_userid>",2,50200,4519,"Geert Wilders (PVV)",0.887474586758596,0.429562737642586,0
"<anonymized_userid>",2,50202,4520,"Geert Wilders (PVV)",0.887509944311854,0.429657794676806,0
"<anonymized_userid>",2,50204,4521,"Geert Wilders (PVV)",0.887545301865111,0.429752851711027,0
"<anonymized_userid>",2,50206,4522,"Geert Wilders (PVV)",0.887580659418368,0.429847908745247,0
"<anonymized_userid>",2,50208,4523,"Geert Wilders (PVV)",0.887616016971626,0.429942965779468,0
"<anonymized_userid>",2,50210,4524,"Geert Wilders (PVV)",0.887651374524883,0.430038022813688,0
"<anonymized_userid>",2,50212,4525,"Geert Wilders (PVV)",0.88768673207814,0.430133079847909,0
"<anonymized_userid>",2,50214,4526,"Geert Wilders (PVV)",0.887722089631398,0.430228136882129,0
"<anonymized_userid>",2,50216,4527,"Geert Wilders (PVV)",0.887757447184655,0.43032319391635,0
"<anonymized_userid>",2,50218,4528,"Geert Wilders (PVV)",0.887792804737912,0.43041825095057,0
"<anonymized_userid>",2,50220,4529,"Geert Wilders (PVV)",0.887828162291169,0.430513307984791,0
"<anonymized_userid>",2,50222,4530,"Geert Wilders (PVV)",0.887863519844427,0.430608365019011,0
"<anonymized_userid>",2,50224,4531,"Geert Wilders (PVV)",0.887898877397684,0.430703422053232,0
"<anonymized_userid>",2,50226,4532,"Geert Wilders (PVV)",0.887934234950941,0.430798479087452,0
"<anonymized_userid>",2,50228,4533,"Geert Wilders (PVV)",0.887969592504199,0.430893536121673,0
"<anonymized_userid>",2,50230,4534,"Geert Wilders (PVV)",0.888004950057456,0.430988593155894,0
"<anonymized_userid>",2,50232,4535,"Geert Wilders (PVV)",0.888040307610713,0.431083650190114,0
"<anonymized_userid>",2,50234,4536,"Geert Wilders (PVV)",0.888075665163971,0.431178707224335,0
"<anonymized_userid>",2,50236,4537,"Geert Wilders (PVV)",0.888111022717228,0.431273764258555,0
"<anonymized_userid>",2,50238,4538,"Geert Wilders (PVV)",0.888146380270485,0.431368821292776,0
"<anonymized_userid>",2,50240,4539,"Geert Wilders (PVV)",0.888181737823743,0.431463878326996,0
"<anonymized_userid>",2,50242,4540,"Geert Wilders (PVV)",0.888217095377,0.431558935361217,0
"<anonymized_userid>",2,50244,4541,"Geert Wilders (PVV)",0.888252452930257,0.431653992395437,0
"<anonymized_userid>",2,50246,4542,"Geert Wilders (PVV)",0.888287810483515,0.431749049429658,0
"<anonymized_userid>",2,50248,4543,"Geert Wilders (PVV)",0.888323168036772,0.431844106463878,0
"<anonymized_userid>",2,50250,4544,"Geert Wilders (PVV)",0.888358525590029,0.431939163498099,0
"<anonymized_userid>",2,50252,4545,"Geert Wilders (PVV)",0.888393883143286,0.432034220532319,0
"<anonymized_userid>",2,50254,4546,"Geert Wilders (PVV)",0.888429240696544,0.43212927756654,0
"<anonymized_userid>",2,50256,4547,"Geert Wilders (PVV)",0.888464598249801,0.43222433460076,0
"<anonymized_userid>",2,50258,4548,"Geert Wilders (PVV)",0.888499955803058,0.432319391634981,0
"<anonymized_userid>",2,50260,4549,"Geert Wilders (PVV)",0.888535313356316,0.432414448669202,0
"<anonymized_userid>",2,50262,4550,"Geert Wilders (PVV)",0.888570670909573,0.432509505703422,0
"<anonymized_userid>",2,50264,4551,"Geert Wilders (PVV)",0.88860602846283,0.432604562737643,0
"<anonymized_userid>",2,50266,4552,"Geert Wilders (PVV)",0.888641386016088,0.432699619771863,0
"<anonymized_userid>",2,50268,4553,"Geert Wilders (PVV)",0.888676743569345,0.432794676806084,0
"<anonymized_userid>",2,50270,4554,"Geert Wilders (PVV)",0.888712101122602,0.432889733840304,0
"<anonymized_userid>",2,50272,4555,"Geert Wilders (PVV)",0.88874745867586,0.432984790874525,0
"<anonymized_userid>",2,50274,4556,"Geert Wilders (PVV)",0.888782816229117,0.433079847908745,0
"<anonymized_userid>",2,50276,4557,"Geert Wilders (PVV)",0.888818173782374,0.433174904942966,0
"<anonymized_userid>",2,50278,4558,"Geert Wilders (PVV)",0.888853531335632,0.433269961977186,0
"<anonymized_userid>",2,50280,4559,"Geert Wilders (PVV)",0.888888888888889,0.433365019011407,0
"<anonymized_userid>",2,50282,4560,"Geert Wilders (PVV)",0.888924246442146,0.433460076045627,0
"<anonymized_userid>",2,50284,4561,"Geert Wilders (PVV)",0.888959603995404,0.433555133079848,0
"<anonymized_userid>",2,50286,4562,"Geert Wilders (PVV)",0.888994961548661,0.433650190114068,0
"<anonymized_userid>",2,50288,4563,"Geert Wilders (PVV)",0.889030319101918,0.433745247148289,0
"<anonymized_userid>",2,50290,4564,"Geert Wilders (PVV)",0.889065676655175,0.43384030418251,0
"<anonymized_userid>",2,50292,4565,"Geert Wilders (PVV)",0.889101034208433,0.43393536121673,0
"<anonymized_userid>",2,50294,4566,"Geert Wilders (PVV)",0.88913639176169,0.434030418250951,0
"<anonymized_userid>",2,50296,4567,"Geert Wilders (PVV)",0.889171749314947,0.434125475285171,0
"<anonymized_userid>",2,50298,4568,"Geert Wilders (PVV)",0.889207106868205,0.434220532319392,0
"<anonymized_userid>",2,50300,4569,"Geert Wilders (PVV)",0.889242464421462,0.434315589353612,0
"<anonymized_userid>",2,50302,4570,"Geert Wilders (PVV)",0.889277821974719,0.434410646387833,0
"<anonymized_userid>",2,50304,4571,"Geert Wilders (PVV)",0.889313179527977,0.434505703422053,0
"<anonymized_userid>",2,50306,4572,"Geert Wilders (PVV)",0.889348537081234,0.434600760456274,0
"<anonymized_userid>",2,50308,4573,"Geert Wilders (PVV)",0.889383894634491,0.434695817490494,0
"<anonymized_userid>",2,50310,4574,"Geert Wilders (PVV)",0.889419252187749,0.434790874524715,0
"<anonymized_userid>",2,50312,4575,"Geert Wilders (PVV)",0.889454609741006,0.434885931558935,0
"<anonymized_userid>",2,50314,4576,"Geert Wilders (PVV)",0.889489967294263,0.434980988593156,0
"<anonymized_userid>",2,50316,4577,"Geert Wilders (PVV)",0.889525324847521,0.435076045627376,0
"<anonymized_userid>",2,50318,4578,"Geert Wilders (PVV)",0.889560682400778,0.435171102661597,0
"<anonymized_userid>",2,50320,4579,"Geert Wilders (PVV)",0.889596039954035,0.435266159695818,0
"<anonymized_userid>",2,50322,4580,"Geert Wilders (PVV)",0.889631397507292,0.435361216730038,0
"<anonymized_userid>",2,50324,4581,"Geert Wilders (PVV)",0.88966675506055,0.435456273764259,0
"<anonymized_userid>",2,50326,4582,"Geert Wilders (PVV)",0.889702112613807,0.435551330798479,0
"<anonymized_userid>",2,50328,4583,"Geert Wilders (PVV)",0.889737470167064,0.4356463878327,0
"<anonymized_userid>",2,50330,4584,"Geert Wilders (PVV)",0.889772827720322,0.43574144486692,0
"<anonymized_userid>",2,50332,4585,"Geert Wilders (PVV)",0.889808185273579,0.435836501901141,0
"<anonymized_userid>",2,50334,4586,"Geert Wilders (PVV)",0.889843542826836,0.435931558935361,0
"<anonymized_userid>",2,50336,4587,"Geert Wilders (PVV)",0.889878900380094,0.436026615969582,0
"<anonymized_userid>",2,50338,4588,"Geert Wilders (PVV)",0.889914257933351,0.436121673003802,0
"<anonymized_userid>",2,50340,4589,"Geert Wilders (PVV)",0.889949615486608,0.436216730038023,0
"<anonymized_userid>",2,50342,4590,"Geert Wilders (PVV)",0.889984973039866,0.436311787072243,0
"<anonymized_userid>",2,50344,4591,"Geert Wilders (PVV)",0.890020330593123,0.436406844106464,0
"<anonymized_userid>",2,50346,4592,"Geert Wilders (PVV)",0.89005568814638,0.436501901140684,0
"<anonymized_userid>",2,50348,4593,"Geert Wilders (PVV)",0.890091045699638,0.436596958174905,0
"<anonymized_userid>",2,50350,4594,"Geert Wilders (PVV)",0.890126403252895,0.436692015209125,0
"<anonymized_userid>",2,50352,4595,"Geert Wilders (PVV)",0.890161760806152,0.436787072243346,0
"<anonymized_userid>",2,50354,4596,"Geert Wilders (PVV)",0.89019711835941,0.436882129277567,0
"<anonymized_userid>",2,50356,4597,"Geert Wilders (PVV)",0.890232475912667,0.436977186311787,0
"<anonymized_userid>",2,50358,4598,"Geert Wilders (PVV)",0.890267833465924,0.437072243346008,0
"<anonymized_userid>",2,50360,4599,"Geert Wilders (PVV)",0.890303191019181,0.437167300380228,0
"<anonymized_userid>",2,50362,4600,"Geert Wilders (PVV)",0.890338548572439,0.437262357414449,0
"<anonymized_userid>",2,50364,4601,"Geert Wilders (PVV)",0.890373906125696,0.437357414448669,0
"<anonymized_userid>",2,50366,4602,"Geert Wilders (PVV)",0.890409263678953,0.43745247148289,0
"<anonymized_userid>",2,50368,4603,"Geert Wilders (PVV)",0.890444621232211,0.43754752851711,0
"<anonymized_userid>",2,50370,4604,"Geert Wilders (PVV)",0.890479978785468,0.437642585551331,0
"<anonymized_userid>",2,50372,4605,"Geert Wilders (PVV)",0.890515336338725,0.437737642585551,0
"<anonymized_userid>",2,50374,4606,"Geert Wilders (PVV)",0.890550693891983,0.437832699619772,0
"<anonymized_userid>",2,50376,4607,"Geert Wilders (PVV)",0.89058605144524,0.437927756653992,0
"<anonymized_userid>",2,50378,4608,"Geert Wilders (PVV)",0.890621408998497,0.438022813688213,0
"<anonymized_userid>",2,50380,4609,"Geert Wilders (PVV)",0.890656766551755,0.438117870722433,0
"<anonymized_userid>",2,50382,4610,"Geert Wilders (PVV)",0.890692124105012,0.438212927756654,0
"<anonymized_userid>",2,50384,4611,"Geert Wilders (PVV)",0.890727481658269,0.438307984790875,0
"<anonymized_userid>",2,50386,4612,"Geert Wilders (PVV)",0.890762839211527,0.438403041825095,0
"<anonymized_userid>",2,50388,4613,"Geert Wilders (PVV)",0.890798196764784,0.438498098859316,0
"<anonymized_userid>",2,50390,4614,"Geert Wilders (PVV)",0.890833554318041,0.438593155893536,0
"<anonymized_userid>",2,50392,4615,"Geert Wilders (PVV)",0.890868911871298,0.438688212927757,0
"<anonymized_userid>",2,50394,4616,"Geert Wilders (PVV)",0.890904269424556,0.438783269961977,0
"<anonymized_userid>",2,50396,4617,"Geert Wilders (PVV)",0.890939626977813,0.438878326996198,0
"<anonymized_userid>",2,50398,4618,"Geert Wilders (PVV)",0.89097498453107,0.438973384030418,0
"<anonymized_userid>",2,50400,4619,"Geert Wilders (PVV)",0.891010342084328,0.439068441064639,0
"<anonymized_userid>",2,50402,4620,"Geert Wilders (PVV)",0.891045699637585,0.439163498098859,0
"<anonymized_userid>",2,50404,4621,"Geert Wilders (PVV)",0.891081057190842,0.43925855513308,0
"<anonymized_userid>",2,50406,4622,"Geert Wilders (PVV)",0.8911164147441,0.4393536121673,0
"<anonymized_userid>",2,50408,4623,"Geert Wilders (PVV)",0.891151772297357,0.439448669201521,0
"<anonymized_userid>",2,50410,4624,"Geert Wilders (PVV)",0.891187129850614,0.439543726235741,0
"<anonymized_userid>",2,50412,4625,"Geert Wilders (PVV)",0.891222487403872,0.439638783269962,0
"<anonymized_userid>",2,50414,4626,"Geert Wilders (PVV)",0.891257844957129,0.439733840304182,0
"<anonymized_userid>",2,50416,4627,"Geert Wilders (PVV)",0.891293202510386,0.439828897338403,0
"<anonymized_userid>",2,50418,4628,"Geert Wilders (PVV)",0.891328560063644,0.439923954372624,0
"<anonymized_userid>",2,50420,4629,"Geert Wilders (PVV)",0.891363917616901,0.440019011406844,0
"<anonymized_userid>",2,50422,4630,"Geert Wilders (PVV)",0.891399275170158,0.440114068441065,0
"<anonymized_userid>",2,50424,4631,"Geert Wilders (PVV)",0.891434632723415,0.440209125475285,0
"<anonymized_userid>",2,50426,4632,"Geert Wilders (PVV)",0.891469990276673,0.440304182509506,0
"<anonymized_userid>",2,50428,4633,"Geert Wilders (PVV)",0.89150534782993,0.440399239543726,0
"<anonymized_userid>",2,50430,4634,"Geert Wilders (PVV)",0.891540705383188,0.440494296577947,0
"<anonymized_userid>",2,50432,4635,"Geert Wilders (PVV)",0.891576062936445,0.440589353612167,0
"<anonymized_userid>",2,50434,4636,"Geert Wilders (PVV)",0.891611420489702,0.440684410646388,0
"<anonymized_userid>",2,50436,4637,"Geert Wilders (PVV)",0.891646778042959,0.440779467680608,0
"<anonymized_userid>",2,50438,4638,"Geert Wilders (PVV)",0.891682135596217,0.440874524714829,0
"<anonymized_userid>",2,50440,4639,"Geert Wilders (PVV)",0.891717493149474,0.440969581749049,0
"<anonymized_userid>",2,50442,4640,"Geert Wilders (PVV)",0.891752850702731,0.44106463878327,0
"<anonymized_userid>",2,50444,4641,"Geert Wilders (PVV)",0.891788208255989,0.44115969581749,0
"<anonymized_userid>",2,50446,4642,"Geert Wilders (PVV)",0.891823565809246,0.441254752851711,0
"<anonymized_userid>",2,50448,4643,"Geert Wilders (PVV)",0.891858923362503,0.441349809885932,0
"<anonymized_userid>",2,50450,4644,"Geert Wilders (PVV)",0.891894280915761,0.441444866920152,0
"<anonymized_userid>",2,50452,4645,"Geert Wilders (PVV)",0.891929638469018,0.441539923954373,0
"<anonymized_userid>",2,50454,4646,"Geert Wilders (PVV)",0.891964996022275,0.441634980988593,0
"<anonymized_userid>",2,50456,4647,"Geert Wilders (PVV)",0.892000353575533,0.441730038022814,0
"<anonymized_userid>",2,50458,4648,"Geert Wilders (PVV)",0.89203571112879,0.441825095057034,0
"<anonymized_userid>",2,50460,4649,"Geert Wilders (PVV)",0.892071068682047,0.441920152091255,0
"<anonymized_userid>",2,50462,4650,"Geert Wilders (PVV)",0.892106426235305,0.442015209125475,0
"<anonymized_userid>",2,50464,4651,"Geert Wilders (PVV)",0.892141783788562,0.442110266159696,0
"<anonymized_userid>",2,50466,4652,"Geert Wilders (PVV)",0.892177141341819,0.442205323193916,0
"<anonymized_userid>",2,50468,4653,"Geert Wilders (PVV)",0.892212498895076,0.442300380228137,0
"<anonymized_userid>",2,50470,4654,"Geert Wilders (PVV)",0.892247856448334,0.442395437262357,0
"<anonymized_userid>",2,50472,4655,"Geert Wilders (PVV)",0.892283214001591,0.442490494296578,0
"<anonymized_userid>",2,50474,4656,"Geert Wilders (PVV)",0.892318571554848,0.442585551330798,0
"<anonymized_userid>",2,50476,4657,"Geert Wilders (PVV)",0.892353929108106,0.442680608365019,0
"<anonymized_userid>",2,50478,4658,"Geert Wilders (PVV)",0.892389286661363,0.44277566539924,0
"<anonymized_userid>",2,50480,4659,"Geert Wilders (PVV)",0.89242464421462,0.44287072243346,0
"<anonymized_userid>",2,50482,4660,"Geert Wilders (PVV)",0.892460001767878,0.442965779467681,0
"<anonymized_userid>",2,50484,4661,"Geert Wilders (PVV)",0.892495359321135,0.443060836501901,0
"<anonymized_userid>",2,50486,4662,"Geert Wilders (PVV)",0.892530716874392,0.443155893536122,0
"<anonymized_userid>",2,50488,4663,"Geert Wilders (PVV)",0.89256607442765,0.443250950570342,0
"<anonymized_userid>",2,50490,4664,"Geert Wilders (PVV)",0.892601431980907,0.443346007604563,0
"<anonymized_userid>",2,50492,4665,"Geert Wilders (PVV)",0.892636789534164,0.443441064638783,0
"<anonymized_userid>",2,50494,4666,"Geert Wilders (PVV)",0.892672147087422,0.443536121673004,0
"<anonymized_userid>",2,50496,4667,"Geert Wilders (PVV)",0.892707504640679,0.443631178707224,0
"<anonymized_userid>",2,50498,4668,"Geert Wilders (PVV)",0.892742862193936,0.443726235741445,0
"<anonymized_userid>",2,50500,4669,"Geert Wilders (PVV)",0.892778219747194,0.443821292775665,0
"<anonymized_userid>",2,50502,4670,"Geert Wilders (PVV)",0.892813577300451,0.443916349809886,0
"<anonymized_userid>",2,50504,4671,"Geert Wilders (PVV)",0.892848934853708,0.444011406844106,0
"<anonymized_userid>",2,50506,4672,"Geert Wilders (PVV)",0.892884292406965,0.444106463878327,0
"<anonymized_userid>",2,50508,4673,"Geert Wilders (PVV)",0.892919649960223,0.444201520912548,0
"<anonymized_userid>",2,50510,4674,"Geert Wilders (PVV)",0.89295500751348,0.444296577946768,0
"<anonymized_userid>",2,50512,4675,"Geert Wilders (PVV)",0.892990365066737,0.444391634980989,0
"<anonymized_userid>",2,50514,4676,"Geert Wilders (PVV)",0.893025722619995,0.444486692015209,0
"<anonymized_userid>",2,50516,4677,"Geert Wilders (PVV)",0.893061080173252,0.44458174904943,0
"<anonymized_userid>",2,50518,4678,"Geert Wilders (PVV)",0.893096437726509,0.44467680608365,0
"<anonymized_userid>",2,50520,4679,"Geert Wilders (PVV)",0.893131795279767,0.444771863117871,0
"<anonymized_userid>",2,50522,4680,"Geert Wilders (PVV)",0.893167152833024,0.444866920152091,0
"<anonymized_userid>",2,50524,4681,"Geert Wilders (PVV)",0.893202510386281,0.444961977186312,0
"<anonymized_userid>",2,50526,4682,"Geert Wilders (PVV)",0.893237867939539,0.445057034220532,0
"<anonymized_userid>",2,50528,4683,"Geert Wilders (PVV)",0.893273225492796,0.445152091254753,0
"<anonymized_userid>",2,50530,4684,"Geert Wilders (PVV)",0.893308583046053,0.445247148288973,0
"<anonymized_userid>",2,50532,4685,"Geert Wilders (PVV)",0.893343940599311,0.445342205323194,0
"<anonymized_userid>",2,50534,4686,"Geert Wilders (PVV)",0.893379298152568,0.445437262357414,0
"<anonymized_userid>",2,50536,4687,"Geert Wilders (PVV)",0.893414655705825,0.445532319391635,0
"<anonymized_userid>",2,50538,4688,"Geert Wilders (PVV)",0.893450013259082,0.445627376425856,0
"<anonymized_userid>",2,50540,4689,"Geert Wilders (PVV)",0.89348537081234,0.445722433460076,0
"<anonymized_userid>",2,50542,4690,"Geert Wilders (PVV)",0.893520728365597,0.445817490494297,0
"<anonymized_userid>",2,50544,4691,"Geert Wilders (PVV)",0.893556085918854,0.445912547528517,0
"<anonymized_userid>",2,50546,4692,"Geert Wilders (PVV)",0.893591443472112,0.446007604562738,0
"<anonymized_userid>",2,50548,4693,"Geert Wilders (PVV)",0.893626801025369,0.446102661596958,0
"<anonymized_userid>",2,50550,4694,"Geert Wilders (PVV)",0.893662158578626,0.446197718631179,0
"<anonymized_userid>",2,50552,4695,"Geert Wilders (PVV)",0.893697516131884,0.446292775665399,0
"<anonymized_userid>",2,50554,4696,"Geert Wilders (PVV)",0.893732873685141,0.44638783269962,0
"<anonymized_userid>",2,50556,4697,"Geert Wilders (PVV)",0.893768231238398,0.44648288973384,0
"<anonymized_userid>",2,50558,4698,"Geert Wilders (PVV)",0.893803588791656,0.446577946768061,0
"<anonymized_userid>",2,50560,4699,"Geert Wilders (PVV)",0.893838946344913,0.446673003802281,0
"<anonymized_userid>",2,50562,4700,"Geert Wilders (PVV)",0.89387430389817,0.446768060836502,0
"<anonymized_userid>",2,50564,4701,"Geert Wilders (PVV)",0.893909661451428,0.446863117870722,0
"<anonymized_userid>",2,50566,4702,"Geert Wilders (PVV)",0.893945019004685,0.446958174904943,0
"<anonymized_userid>",2,50568,4703,"Geert Wilders (PVV)",0.893980376557942,0.447053231939164,0
"<anonymized_userid>",2,50570,4704,"Geert Wilders (PVV)",0.8940157341112,0.447148288973384,0
"<anonymized_userid>",2,50572,4705,"Geert Wilders (PVV)",0.894051091664457,0.447243346007605,0
"<anonymized_userid>",2,50574,4706,"Geert Wilders (PVV)",0.894086449217714,0.447338403041825,0
"<anonymized_userid>",2,50576,4707,"Geert Wilders (PVV)",0.894121806770971,0.447433460076046,0
"<anonymized_userid>",2,50578,4708,"Geert Wilders (PVV)",0.894157164324229,0.447528517110266,0
"<anonymized_userid>",2,50580,4709,"Geert Wilders (PVV)",0.894192521877486,0.447623574144487,0
"<anonymized_userid>",2,50582,4710,"Geert Wilders (PVV)",0.894227879430743,0.447718631178707,0
"<anonymized_userid>",2,50584,4711,"Geert Wilders (PVV)",0.894263236984001,0.447813688212928,0
"<anonymized_userid>",2,50586,4712,"Geert Wilders (PVV)",0.894298594537258,0.447908745247148,0
"<anonymized_userid>",2,50588,4713,"Geert Wilders (PVV)",0.894333952090515,0.448003802281369,0
"<anonymized_userid>",2,50590,4714,"Geert Wilders (PVV)",0.894369309643773,0.448098859315589,0
"<anonymized_userid>",2,50592,4715,"Geert Wilders (PVV)",0.89440466719703,0.44819391634981,0
"<anonymized_userid>",2,50594,4716,"Geert Wilders (PVV)",0.894440024750287,0.44828897338403,0
"<anonymized_userid>",2,50596,4717,"Geert Wilders (PVV)",0.894475382303545,0.448384030418251,0
"<anonymized_userid>",2,50598,4718,"Geert Wilders (PVV)",0.894510739856802,0.448479087452472,0
"<anonymized_userid>",2,50600,4719,"Geert Wilders (PVV)",0.894546097410059,0.448574144486692,0
"<anonymized_userid>",2,50602,4720,"Geert Wilders (PVV)",0.894581454963317,0.448669201520913,0
"<anonymized_userid>",2,50604,4721,"Geert Wilders (PVV)",0.894616812516574,0.448764258555133,0
"<anonymized_userid>",2,50606,4722,"Geert Wilders (PVV)",0.894652170069831,0.448859315589354,0
"<anonymized_userid>",2,50608,4723,"Geert Wilders (PVV)",0.894687527623088,0.448954372623574,0
"<anonymized_userid>",2,50610,4724,"Geert Wilders (PVV)",0.894722885176346,0.449049429657795,0
"<anonymized_userid>",2,50612,4725,"Geert Wilders (PVV)",0.894758242729603,0.449144486692015,0
"<anonymized_userid>",2,50614,4726,"Geert Wilders (PVV)",0.89479360028286,0.449239543726236,0
"<anonymized_userid>",2,50616,4727,"Geert Wilders (PVV)",0.894828957836118,0.449334600760456,0
"<anonymized_userid>",2,50618,4728,"Geert Wilders (PVV)",0.894864315389375,0.449429657794677,0
"<anonymized_userid>",2,50620,4729,"Geert Wilders (PVV)",0.894899672942632,0.449524714828897,0
"<anonymized_userid>",2,50622,4730,"Geert Wilders (PVV)",0.89493503049589,0.449619771863118,0
"<anonymized_userid>",2,50624,4731,"Geert Wilders (PVV)",0.894970388049147,0.449714828897338,0
"<anonymized_userid>",2,50626,4732,"Geert Wilders (PVV)",0.895005745602404,0.449809885931559,0
"<anonymized_userid>",2,50628,4733,"Geert Wilders (PVV)",0.895041103155662,0.449904942965779,0
"<anonymized_userid>",2,50630,4734,"Geert Wilders (PVV)",0.895076460708919,0.45,0
"<anonymized_userid>",2,50632,4735,"Geert Wilders (PVV)",0.895111818262176,0.450095057034221,0
"<anonymized_userid>",2,50634,4736,"Geert Wilders (PVV)",0.895147175815434,0.450190114068441,0
"<anonymized_userid>",2,50636,4737,"Geert Wilders (PVV)",0.895182533368691,0.450285171102662,0
"<anonymized_userid>",2,50638,4738,"Geert Wilders (PVV)",0.895217890921948,0.450380228136882,0
"<anonymized_userid>",2,50640,4739,"Geert Wilders (PVV)",0.895253248475205,0.450475285171103,0
"<anonymized_userid>",2,50642,4740,"Geert Wilders (PVV)",0.895288606028463,0.450570342205323,0
"<anonymized_userid>",2,50644,4741,"Geert Wilders (PVV)",0.89532396358172,0.450665399239544,0
"<anonymized_userid>",2,50646,4742,"Geert Wilders (PVV)",0.895359321134978,0.450760456273764,0
"<anonymized_userid>",2,50648,4743,"Geert Wilders (PVV)",0.895394678688235,0.450855513307985,0
"<anonymized_userid>",2,50650,4744,"Geert Wilders (PVV)",0.895430036241492,0.450950570342205,0
"<anonymized_userid>",2,50652,4745,"Geert Wilders (PVV)",0.895465393794749,0.451045627376426,0
"<anonymized_userid>",2,50654,4746,"Geert Wilders (PVV)",0.895500751348007,0.451140684410646,0
"<anonymized_userid>",2,50656,4747,"Geert Wilders (PVV)",0.895536108901264,0.451235741444867,0
"<anonymized_userid>",2,50658,4748,"Geert Wilders (PVV)",0.895571466454521,0.451330798479087,0
"<anonymized_userid>",2,50660,4749,"Geert Wilders (PVV)",0.895606824007779,0.451425855513308,0
"<anonymized_userid>",2,50662,4750,"Geert Wilders (PVV)",0.895642181561036,0.451520912547529,0
"<anonymized_userid>",2,50664,4751,"Geert Wilders (PVV)",0.895677539114293,0.451615969581749,0
"<anonymized_userid>",2,50666,4752,"Geert Wilders (PVV)",0.895712896667551,0.45171102661597,0
"<anonymized_userid>",2,50668,4753,"Geert Wilders (PVV)",0.895748254220808,0.45180608365019,0
"<anonymized_userid>",2,50670,4754,"Geert Wilders (PVV)",0.895783611774065,0.451901140684411,0
"<anonymized_userid>",2,50672,4755,"Geert Wilders (PVV)",0.895818969327323,0.451996197718631,0
"<anonymized_userid>",2,50674,4756,"Geert Wilders (PVV)",0.89585432688058,0.452091254752852,0
"<anonymized_userid>",2,50676,4757,"Geert Wilders (PVV)",0.895889684433837,0.452186311787072,0
"<anonymized_userid>",2,50678,4758,"Geert Wilders (PVV)",0.895925041987094,0.452281368821293,0
"<anonymized_userid>",2,50680,4759,"Geert Wilders (PVV)",0.895960399540352,0.452376425855513,0
"<anonymized_userid>",2,50682,4760,"Geert Wilders (PVV)",0.895995757093609,0.452471482889734,0
"<anonymized_userid>",2,50684,4761,"Geert Wilders (PVV)",0.896031114646866,0.452566539923954,0
"<anonymized_userid>",2,50686,4762,"Geert Wilders (PVV)",0.896066472200124,0.452661596958175,0
"<anonymized_userid>",2,50688,4763,"Geert Wilders (PVV)",0.896101829753381,0.452756653992395,0
"<anonymized_userid>",2,50690,4764,"Geert Wilders (PVV)",0.896137187306638,0.452851711026616,0
"<anonymized_userid>",2,50692,4765,"Geert Wilders (PVV)",0.896172544859896,0.452946768060837,0
"<anonymized_userid>",2,50694,4766,"Geert Wilders (PVV)",0.896207902413153,0.453041825095057,0
"<anonymized_userid>",2,50696,4767,"Geert Wilders (PVV)",0.89624325996641,0.453136882129278,0
"<anonymized_userid>",2,50698,4768,"Geert Wilders (PVV)",0.896278617519668,0.453231939163498,0
"<anonymized_userid>",2,50700,4769,"Geert Wilders (PVV)",0.896313975072925,0.453326996197719,0
"<anonymized_userid>",2,50702,4770,"Geert Wilders (PVV)",0.896349332626182,0.453422053231939,0
"<anonymized_userid>",2,50704,4771,"Geert Wilders (PVV)",0.89638469017944,0.45351711026616,0
"<anonymized_userid>",2,50706,4772,"Geert Wilders (PVV)",0.896420047732697,0.45361216730038,0
"<anonymized_userid>",2,50708,4773,"Geert Wilders (PVV)",0.896455405285954,0.453707224334601,0
"<anonymized_userid>",2,50710,4774,"Geert Wilders (PVV)",0.896490762839211,0.453802281368821,0
"<anonymized_userid>",2,50712,4775,"Geert Wilders (PVV)",0.896526120392469,0.453897338403042,0
"<anonymized_userid>",2,50714,4776,"Geert Wilders (PVV)",0.896561477945726,0.453992395437262,0
"<anonymized_userid>",2,50716,4777,"Geert Wilders (PVV)",0.896596835498984,0.454087452471483,0
"<anonymized_userid>",2,50718,4778,"Geert Wilders (PVV)",0.896632193052241,0.454182509505703,0
"<anonymized_userid>",2,50720,4779,"Geert Wilders (PVV)",0.896667550605498,0.454277566539924,0
"<anonymized_userid>",2,50722,4780,"Geert Wilders (PVV)",0.896702908158755,0.454372623574144,0
"<anonymized_userid>",2,50724,4781,"Geert Wilders (PVV)",0.896738265712013,0.454467680608365,0
"<anonymized_userid>",2,50726,4782,"Geert Wilders (PVV)",0.89677362326527,0.454562737642586,0
"<anonymized_userid>",2,50728,4783,"Geert Wilders (PVV)",0.896808980818527,0.454657794676806,0
"<anonymized_userid>",2,50730,4784,"Geert Wilders (PVV)",0.896844338371785,0.454752851711027,0
"<anonymized_userid>",2,50732,4785,"Geert Wilders (PVV)",0.896879695925042,0.454847908745247,0
"<anonymized_userid>",2,50734,4786,"Geert Wilders (PVV)",0.896915053478299,0.454942965779468,0
"<anonymized_userid>",2,50736,4787,"Geert Wilders (PVV)",0.896950411031557,0.455038022813688,0
"<anonymized_userid>",2,50738,4788,"Geert Wilders (PVV)",0.896985768584814,0.455133079847909,0
"<anonymized_userid>",2,50740,4789,"Geert Wilders (PVV)",0.897021126138071,0.455228136882129,0
"<anonymized_userid>",2,50742,4790,"Geert Wilders (PVV)",0.897056483691329,0.45532319391635,0
"<anonymized_userid>",2,50744,4791,"Geert Wilders (PVV)",0.897091841244586,0.45541825095057,0
"<anonymized_userid>",2,50746,4792,"Geert Wilders (PVV)",0.897127198797843,0.455513307984791,0
"<anonymized_userid>",2,50748,4793,"Geert Wilders (PVV)",0.897162556351101,0.455608365019011,0
"<anonymized_userid>",2,50750,4794,"Geert Wilders (PVV)",0.897197913904358,0.455703422053232,0
"<anonymized_userid>",2,50752,4795,"Geert Wilders (PVV)",0.897233271457615,0.455798479087452,0
"<anonymized_userid>",2,50754,4796,"Geert Wilders (PVV)",0.897268629010872,0.455893536121673,0
"<anonymized_userid>",2,50756,4797,"Geert Wilders (PVV)",0.89730398656413,0.455988593155894,0
"<anonymized_userid>",2,50758,4798,"Geert Wilders (PVV)",0.897339344117387,0.456083650190114,0
"<anonymized_userid>",2,50760,4799,"Geert Wilders (PVV)",0.897374701670644,0.456178707224335,0
"<anonymized_userid>",2,50762,4800,"Geert Wilders (PVV)",0.897410059223902,0.456273764258555,0
"<anonymized_userid>",2,50764,4801,"Geert Wilders (PVV)",0.897445416777159,0.456368821292776,0
"<anonymized_userid>",2,50766,4802,"Geert Wilders (PVV)",0.897480774330416,0.456463878326996,0
"<anonymized_userid>",2,50768,4803,"Geert Wilders (PVV)",0.897516131883674,0.456558935361217,0
"<anonymized_userid>",2,50770,4804,"Geert Wilders (PVV)",0.897551489436931,0.456653992395437,0
"<anonymized_userid>",2,50772,4805,"Geert Wilders (PVV)",0.897586846990188,0.456749049429658,0
"<anonymized_userid>",2,50774,4806,"Geert Wilders (PVV)",0.897622204543446,0.456844106463878,0
"<anonymized_userid>",2,50776,4807,"Geert Wilders (PVV)",0.897657562096703,0.456939163498099,0
"<anonymized_userid>",2,50778,4808,"Geert Wilders (PVV)",0.89769291964996,0.457034220532319,0
"<anonymized_userid>",2,50780,4809,"Geert Wilders (PVV)",0.897728277203218,0.45712927756654,0
"<anonymized_userid>",2,50782,4810,"Geert Wilders (PVV)",0.897763634756475,0.45722433460076,0
"<anonymized_userid>",2,50784,4811,"Geert Wilders (PVV)",0.897798992309732,0.457319391634981,0
"<anonymized_userid>",2,50786,4812,"Geert Wilders (PVV)",0.897834349862989,0.457414448669202,0
"<anonymized_userid>",2,50788,4813,"Geert Wilders (PVV)",0.897869707416247,0.457509505703422,0
"<anonymized_userid>",2,50790,4814,"Geert Wilders (PVV)",0.897905064969504,0.457604562737643,0
"<anonymized_userid>",2,50792,4815,"Geert Wilders (PVV)",0.897940422522761,0.457699619771863,0
"<anonymized_userid>",2,50794,4816,"Geert Wilders (PVV)",0.897975780076019,0.457794676806084,0
"<anonymized_userid>",2,50796,4817,"Geert Wilders (PVV)",0.898011137629276,0.457889733840304,0
"<anonymized_userid>",2,50798,4818,"Geert Wilders (PVV)",0.898046495182533,0.457984790874525,0
"<anonymized_userid>",2,50800,4819,"Geert Wilders (PVV)",0.898081852735791,0.458079847908745,0
"<anonymized_userid>",2,50802,4820,"Geert Wilders (PVV)",0.898117210289048,0.458174904942966,0
"<anonymized_userid>",2,50804,4821,"Geert Wilders (PVV)",0.898152567842305,0.458269961977186,0
"<anonymized_userid>",2,50806,4822,"Geert Wilders (PVV)",0.898187925395563,0.458365019011407,0
"<anonymized_userid>",2,50808,4823,"Geert Wilders (PVV)",0.89822328294882,0.458460076045627,0
"<anonymized_userid>",2,50810,4824,"Geert Wilders (PVV)",0.898258640502077,0.458555133079848,0
"<anonymized_userid>",2,50812,4825,"Geert Wilders (PVV)",0.898293998055335,0.458650190114068,0
"<anonymized_userid>",2,50814,4826,"Geert Wilders (PVV)",0.898329355608592,0.458745247148289,0
"<anonymized_userid>",2,50816,4827,"Geert Wilders (PVV)",0.898364713161849,0.458840304182509,0
"<anonymized_userid>",2,50818,4828,"Geert Wilders (PVV)",0.898400070715107,0.45893536121673,0
"<anonymized_userid>",2,50820,4829,"Geert Wilders (PVV)",0.898435428268364,0.459030418250951,0
"<anonymized_userid>",2,50822,4830,"Geert Wilders (PVV)",0.898470785821621,0.459125475285171,0
"<anonymized_userid>",2,50824,4831,"Geert Wilders (PVV)",0.898506143374878,0.459220532319392,0
"<anonymized_userid>",2,50826,4832,"Geert Wilders (PVV)",0.898541500928136,0.459315589353612,0
"<anonymized_userid>",2,50828,4833,"Geert Wilders (PVV)",0.898576858481393,0.459410646387833,0
"<anonymized_userid>",2,50830,4834,"Geert Wilders (PVV)",0.89861221603465,0.459505703422053,0
"<anonymized_userid>",2,50832,4835,"Geert Wilders (PVV)",0.898647573587908,0.459600760456274,0
"<anonymized_userid>",2,50834,4836,"Geert Wilders (PVV)",0.898682931141165,0.459695817490494,0
"<anonymized_userid>",2,50836,4837,"Geert Wilders (PVV)",0.898718288694422,0.459790874524715,0
"<anonymized_userid>",2,50838,4838,"Geert Wilders (PVV)",0.89875364624768,0.459885931558935,0
"<anonymized_userid>",2,50840,4839,"Geert Wilders (PVV)",0.898789003800937,0.459980988593156,0
"<anonymized_userid>",2,50842,4840,"Geert Wilders (PVV)",0.898824361354194,0.460076045627376,0
"<anonymized_userid>",2,50844,4841,"Geert Wilders (PVV)",0.898859718907452,0.460171102661597,0
"<anonymized_userid>",2,50846,4842,"Geert Wilders (PVV)",0.898895076460709,0.460266159695817,0
"<anonymized_userid>",2,50848,4843,"Geert Wilders (PVV)",0.898930434013966,0.460361216730038,0
"<anonymized_userid>",2,50850,4844,"Geert Wilders (PVV)",0.898965791567224,0.460456273764259,0
"<anonymized_userid>",2,50852,4845,"Geert Wilders (PVV)",0.899001149120481,0.460551330798479,0
"<anonymized_userid>",2,50854,4846,"Geert Wilders (PVV)",0.899036506673738,0.4606463878327,0
"<anonymized_userid>",2,50856,4847,"Geert Wilders (PVV)",0.899071864226995,0.46074144486692,0
"<anonymized_userid>",2,50858,4848,"Geert Wilders (PVV)",0.899107221780253,0.460836501901141,0
"<anonymized_userid>",2,50860,4849,"Geert Wilders (PVV)",0.89914257933351,0.460931558935361,0
"<anonymized_userid>",2,50862,4850,"Geert Wilders (PVV)",0.899177936886767,0.461026615969582,0
"<anonymized_userid>",2,50864,4851,"Geert Wilders (PVV)",0.899213294440025,0.461121673003802,0
"<anonymized_userid>",2,50866,4852,"Geert Wilders (PVV)",0.899248651993282,0.461216730038023,0
"<anonymized_userid>",2,50868,4853,"Geert Wilders (PVV)",0.899284009546539,0.461311787072243,0
"<anonymized_userid>",2,50870,4854,"Geert Wilders (PVV)",0.899319367099797,0.461406844106464,0
"<anonymized_userid>",2,50872,4855,"Geert Wilders (PVV)",0.899354724653054,0.461501901140684,0
"<anonymized_userid>",2,50874,4856,"Geert Wilders (PVV)",0.899390082206311,0.461596958174905,0
"<anonymized_userid>",2,50876,4857,"Geert Wilders (PVV)",0.899425439759569,0.461692015209125,0
"<anonymized_userid>",2,50878,4858,"Geert Wilders (PVV)",0.899460797312826,0.461787072243346,0
"<anonymized_userid>",2,50880,4859,"Geert Wilders (PVV)",0.899496154866083,0.461882129277567,0
"<anonymized_userid>",2,50882,4860,"Geert Wilders (PVV)",0.899531512419341,0.461977186311787,0
"<anonymized_userid>",2,50884,4861,"Geert Wilders (PVV)",0.899566869972598,0.462072243346008,0
"<anonymized_userid>",2,50886,4862,"Geert Wilders (PVV)",0.899602227525855,0.462167300380228,0
"<anonymized_userid>",2,50888,4863,"Geert Wilders (PVV)",0.899637585079113,0.462262357414449,0
"<anonymized_userid>",2,50890,4864,"Geert Wilders (PVV)",0.89967294263237,0.462357414448669,0
"<anonymized_userid>",2,50892,4865,"Geert Wilders (PVV)",0.899708300185627,0.46245247148289,0
"<anonymized_userid>",2,50894,4866,"Geert Wilders (PVV)",0.899743657738884,0.46254752851711,0
"<anonymized_userid>",2,50896,4867,"Geert Wilders (PVV)",0.899779015292142,0.462642585551331,0
"<anonymized_userid>",2,50898,4868,"Geert Wilders (PVV)",0.899814372845399,0.462737642585551,0
"<anonymized_userid>",2,50900,4869,"Geert Wilders (PVV)",0.899849730398656,0.462832699619772,0
"<anonymized_userid>",2,50902,4870,"Geert Wilders (PVV)",0.899885087951914,0.462927756653992,0
"<anonymized_userid>",2,50904,4871,"Geert Wilders (PVV)",0.899920445505171,0.463022813688213,0
"<anonymized_userid>",2,50906,4872,"Geert Wilders (PVV)",0.899955803058428,0.463117870722433,0
"<anonymized_userid>",2,50908,4873,"Geert Wilders (PVV)",0.899991160611686,0.463212927756654,0
"<anonymized_userid>",2,50910,4874,"Geert Wilders (PVV)",0.900026518164943,0.463307984790875,0
"<anonymized_userid>",2,50912,4875,"Geert Wilders (PVV)",0.9000618757182,0.463403041825095,0
"<anonymized_userid>",2,50914,4876,"Geert Wilders (PVV)",0.900097233271458,0.463498098859316,0
"<anonymized_userid>",2,50916,4877,"Geert Wilders (PVV)",0.900132590824715,0.463593155893536,0
"<anonymized_userid>",2,50918,4878,"Geert Wilders (PVV)",0.900167948377972,0.463688212927757,0
"<anonymized_userid>",2,50920,4879,"Geert Wilders (PVV)",0.90020330593123,0.463783269961977,0
"<anonymized_userid>",2,50922,4880,"Geert Wilders (PVV)",0.900238663484487,0.463878326996198,0
"<anonymized_userid>",2,50924,4881,"Geert Wilders (PVV)",0.900274021037744,0.463973384030418,0
"<anonymized_userid>",2,50926,4882,"Geert Wilders (PVV)",0.900309378591001,0.464068441064639,0
"<anonymized_userid>",2,50928,4883,"Geert Wilders (PVV)",0.900344736144259,0.464163498098859,0
"<anonymized_userid>",1,50929,4884,"Geert Wilders (PVV)",0.900362414920887,0.46425855513308,0
"<anonymized_userid>",1,50930,4885,"Geert Wilders (PVV)",0.900380093697516,0.4643536121673,0
"<anonymized_userid>",1,50931,4886,"Geert Wilders (PVV)",0.900397772474145,0.464448669201521,0
"<anonymized_userid>",1,50932,4887,"Geert Wilders (PVV)",0.900415451250773,0.464543726235741,0
"<anonymized_userid>",1,50933,4888,"Geert Wilders (PVV)",0.900433130027402,0.464638783269962,0
"<anonymized_userid>",1,50934,4889,"Geert Wilders (PVV)",0.900450808804031,0.464733840304183,0
"<anonymized_userid>",1,50935,4890,"Geert Wilders (PVV)",0.900468487580659,0.464828897338403,0
"<anonymized_userid>",1,50936,4891,"Geert Wilders (PVV)",0.900486166357288,0.464923954372624,0
"<anonymized_userid>",1,50937,4892,"Geert Wilders (PVV)",0.900503845133917,0.465019011406844,0
"<anonymized_userid>",1,50938,4893,"Geert Wilders (PVV)",0.900521523910545,0.465114068441065,0
"<anonymized_userid>",1,50939,4894,"Geert Wilders (PVV)",0.900539202687174,0.465209125475285,0
"<anonymized_userid>",1,50940,4895,"Geert Wilders (PVV)",0.900556881463803,0.465304182509506,0
"<anonymized_userid>",1,50941,4896,"Geert Wilders (PVV)",0.900574560240431,0.465399239543726,0
"<anonymized_userid>",1,50942,4897,"Geert Wilders (PVV)",0.90059223901706,0.465494296577947,0
"<anonymized_userid>",1,50943,4898,"Geert Wilders (PVV)",0.900609917793689,0.465589353612167,0
"<anonymized_userid>",1,50944,4899,"Geert Wilders (PVV)",0.900627596570317,0.465684410646388,0
"<anonymized_userid>",1,50945,4900,"Geert Wilders (PVV)",0.900645275346946,0.465779467680608,0
"<anonymized_userid>",1,50946,4901,"Geert Wilders (PVV)",0.900662954123575,0.465874524714829,0
"<anonymized_userid>",1,50947,4902,"Geert Wilders (PVV)",0.900680632900203,0.465969581749049,0
"<anonymized_userid>",1,50948,4903,"Geert Wilders (PVV)",0.900698311676832,0.46606463878327,0
"<anonymized_userid>",1,50949,4904,"Geert Wilders (PVV)",0.900715990453461,0.466159695817491,0
"<anonymized_userid>",1,50950,4905,"Geert Wilders (PVV)",0.900733669230089,0.466254752851711,0
"<anonymized_userid>",1,50951,4906,"Geert Wilders (PVV)",0.900751348006718,0.466349809885932,0
"<anonymized_userid>",1,50952,4907,"Geert Wilders (PVV)",0.900769026783347,0.466444866920152,0
"<anonymized_userid>",1,50953,4908,"Geert Wilders (PVV)",0.900786705559975,0.466539923954373,0
"<anonymized_userid>",1,50954,4909,"Geert Wilders (PVV)",0.900804384336604,0.466634980988593,0
"<anonymized_userid>",1,50955,4910,"Geert Wilders (PVV)",0.900822063113233,0.466730038022814,0
"<anonymized_userid>",1,50956,4911,"Geert Wilders (PVV)",0.900839741889861,0.466825095057034,0
"<anonymized_userid>",1,50957,4912,"Geert Wilders (PVV)",0.90085742066649,0.466920152091255,0
"<anonymized_userid>",1,50958,4913,"Geert Wilders (PVV)",0.900875099443118,0.467015209125475,0
"<anonymized_userid>",1,50959,4914,"Geert Wilders (PVV)",0.900892778219747,0.467110266159696,0
"<anonymized_userid>",1,50960,4915,"Geert Wilders (PVV)",0.900910456996376,0.467205323193916,0
"<anonymized_userid>",1,50961,4916,"Geert Wilders (PVV)",0.900928135773004,0.467300380228137,0
"<anonymized_userid>",1,50962,4917,"Geert Wilders (PVV)",0.900945814549633,0.467395437262357,0
"<anonymized_userid>",1,50963,4918,"Geert Wilders (PVV)",0.900963493326262,0.467490494296578,0
"<anonymized_userid>",1,50964,4919,"Geert Wilders (PVV)",0.900981172102891,0.467585551330798,0
"<anonymized_userid>",1,50965,4920,"Geert Wilders (PVV)",0.900998850879519,0.467680608365019,0
"<anonymized_userid>",1,50966,4921,"Geert Wilders (PVV)",0.901016529656148,0.46777566539924,0
"<anonymized_userid>",1,50967,4922,"Geert Wilders (PVV)",0.901034208432776,0.46787072243346,0
"<anonymized_userid>",1,50968,4923,"Geert Wilders (PVV)",0.901051887209405,0.467965779467681,0
"<anonymized_userid>",1,50969,4924,"Geert Wilders (PVV)",0.901069565986034,0.468060836501901,0
"<anonymized_userid>",1,50970,4925,"Geert Wilders (PVV)",0.901087244762662,0.468155893536122,0
"<anonymized_userid>",1,50971,4926,"Geert Wilders (PVV)",0.901104923539291,0.468250950570342,0
"<anonymized_userid>",1,50972,4927,"Geert Wilders (PVV)",0.90112260231592,0.468346007604563,0
"<anonymized_userid>",1,50973,4928,"Geert Wilders (PVV)",0.901140281092548,0.468441064638783,0
"<anonymized_userid>",1,50974,4929,"Geert Wilders (PVV)",0.901157959869177,0.468536121673004,0
"<anonymized_userid>",1,50975,4930,"Geert Wilders (PVV)",0.901175638645806,0.468631178707224,0
"<anonymized_userid>",1,50976,4931,"Geert Wilders (PVV)",0.901193317422434,0.468726235741445,0
"<anonymized_userid>",1,50977,4932,"Geert Wilders (PVV)",0.901210996199063,0.468821292775665,0
"<anonymized_userid>",1,50978,4933,"Geert Wilders (PVV)",0.901228674975692,0.468916349809886,0
"<anonymized_userid>",1,50979,4934,"Geert Wilders (PVV)",0.90124635375232,0.469011406844106,0
"<anonymized_userid>",1,50980,4935,"Geert Wilders (PVV)",0.901264032528949,0.469106463878327,0
"<anonymized_userid>",1,50981,4936,"Geert Wilders (PVV)",0.901281711305578,0.469201520912548,0
"<anonymized_userid>",1,50982,4937,"Geert Wilders (PVV)",0.901299390082206,0.469296577946768,0
"<anonymized_userid>",1,50983,4938,"Geert Wilders (PVV)",0.901317068858835,0.469391634980989,0
"<anonymized_userid>",1,50984,4939,"Geert Wilders (PVV)",0.901334747635464,0.469486692015209,0
"<anonymized_userid>",1,50985,4940,"Geert Wilders (PVV)",0.901352426412092,0.46958174904943,0
"<anonymized_userid>",1,50986,4941,"Geert Wilders (PVV)",0.901370105188721,0.46967680608365,0
"<anonymized_userid>",1,50987,4942,"Geert Wilders (PVV)",0.90138778396535,0.469771863117871,0
"<anonymized_userid>",1,50988,4943,"Geert Wilders (PVV)",0.901405462741978,0.469866920152091,0
"<anonymized_userid>",1,50989,4944,"Geert Wilders (PVV)",0.901423141518607,0.469961977186312,0
"<anonymized_userid>",1,50990,4945,"Geert Wilders (PVV)",0.901440820295236,0.470057034220532,0
"<anonymized_userid>",1,50991,4946,"Geert Wilders (PVV)",0.901458499071864,0.470152091254753,0
"<anonymized_userid>",1,50992,4947,"Geert Wilders (PVV)",0.901476177848493,0.470247148288973,0
"<anonymized_userid>",1,50993,4948,"Geert Wilders (PVV)",0.901493856625121,0.470342205323194,0
"<anonymized_userid>",1,50994,4949,"Geert Wilders (PVV)",0.90151153540175,0.470437262357414,0
"<anonymized_userid>",1,50995,4950,"Geert Wilders (PVV)",0.901529214178379,0.470532319391635,0
"<anonymized_userid>",1,50996,4951,"Geert Wilders (PVV)",0.901546892955008,0.470627376425856,0
"<anonymized_userid>",1,50997,4952,"Geert Wilders (PVV)",0.901564571731636,0.470722433460076,0
"<anonymized_userid>",1,50998,4953,"Geert Wilders (PVV)",0.901582250508265,0.470817490494297,0
"<anonymized_userid>",1,50999,4954,"Geert Wilders (PVV)",0.901599929284894,0.470912547528517,0
"<anonymized_userid>",1,51000,4955,"Geert Wilders (PVV)",0.901617608061522,0.471007604562738,0
"<anonymized_userid>",1,51001,4956,"Geert Wilders (PVV)",0.901635286838151,0.471102661596958,0
"<anonymized_userid>",1,51002,4957,"Geert Wilders (PVV)",0.901652965614779,0.471197718631179,0
"<anonymized_userid>",1,51003,4958,"Geert Wilders (PVV)",0.901670644391408,0.471292775665399,0
"<anonymized_userid>",1,51004,4959,"Geert Wilders (PVV)",0.901688323168037,0.47138783269962,0
"<anonymized_userid>",1,51005,4960,"Geert Wilders (PVV)",0.901706001944665,0.47148288973384,0
"<anonymized_userid>",1,51006,4961,"Geert Wilders (PVV)",0.901723680721294,0.471577946768061,0
"<anonymized_userid>",1,51007,4962,"Geert Wilders (PVV)",0.901741359497923,0.471673003802281,0
"<anonymized_userid>",1,51008,4963,"Geert Wilders (PVV)",0.901759038274551,0.471768060836502,0
"<anonymized_userid>",1,51009,4964,"Geert Wilders (PVV)",0.90177671705118,0.471863117870722,0
"<anonymized_userid>",1,51010,4965,"Geert Wilders (PVV)",0.901794395827809,0.471958174904943,0
"<anonymized_userid>",1,51011,4966,"Geert Wilders (PVV)",0.901812074604437,0.472053231939163,0
"<anonymized_userid>",1,51012,4967,"Geert Wilders (PVV)",0.901829753381066,0.472148288973384,0
"<anonymized_userid>",1,51013,4968,"Geert Wilders (PVV)",0.901847432157695,0.472243346007605,0
"<anonymized_userid>",1,51014,4969,"Geert Wilders (PVV)",0.901865110934323,0.472338403041825,0
"<anonymized_userid>",1,51015,4970,"Geert Wilders (PVV)",0.901882789710952,0.472433460076046,0
"<anonymized_userid>",1,51016,4971,"Geert Wilders (PVV)",0.901900468487581,0.472528517110266,0
"<anonymized_userid>",1,51017,4972,"Geert Wilders (PVV)",0.901918147264209,0.472623574144487,0
"<anonymized_userid>",1,51018,4973,"Geert Wilders (PVV)",0.901935826040838,0.472718631178707,0
"<anonymized_userid>",1,51019,4974,"Geert Wilders (PVV)",0.901953504817467,0.472813688212928,0
"<anonymized_userid>",1,51020,4975,"Geert Wilders (PVV)",0.901971183594095,0.472908745247148,0
"<anonymized_userid>",1,51021,4976,"Geert Wilders (PVV)",0.901988862370724,0.473003802281369,0
"<anonymized_userid>",1,51022,4977,"Geert Wilders (PVV)",0.902006541147353,0.473098859315589,0
"<anonymized_userid>",1,51023,4978,"Geert Wilders (PVV)",0.902024219923981,0.47319391634981,0
"<anonymized_userid>",1,51024,4979,"Geert Wilders (PVV)",0.90204189870061,0.47328897338403,0
"<anonymized_userid>",1,51025,4980,"Geert Wilders (PVV)",0.902059577477239,0.473384030418251,0
"<anonymized_userid>",1,51026,4981,"Geert Wilders (PVV)",0.902077256253867,0.473479087452471,0
"<anonymized_userid>",1,51027,4982,"Geert Wilders (PVV)",0.902094935030496,0.473574144486692,0
"<anonymized_userid>",1,51028,4983,"Geert Wilders (PVV)",0.902112613807125,0.473669201520913,0
"<anonymized_userid>",1,51029,4984,"Geert Wilders (PVV)",0.902130292583753,0.473764258555133,0
"<anonymized_userid>",1,51030,4985,"Geert Wilders (PVV)",0.902147971360382,0.473859315589354,0
"<anonymized_userid>",1,51031,4986,"Geert Wilders (PVV)",0.902165650137011,0.473954372623574,0
"<anonymized_userid>",1,51032,4987,"Geert Wilders (PVV)",0.902183328913639,0.474049429657795,0
"<anonymized_userid>",1,51033,4988,"Geert Wilders (PVV)",0.902201007690268,0.474144486692015,0
"<anonymized_userid>",1,51034,4989,"Geert Wilders (PVV)",0.902218686466897,0.474239543726236,0
"<anonymized_userid>",1,51035,4990,"Geert Wilders (PVV)",0.902236365243525,0.474334600760456,0
"<anonymized_userid>",1,51036,4991,"Geert Wilders (PVV)",0.902254044020154,0.474429657794677,0
"<anonymized_userid>",1,51037,4992,"Geert Wilders (PVV)",0.902271722796782,0.474524714828897,0
"<anonymized_userid>",1,51038,4993,"Geert Wilders (PVV)",0.902289401573411,0.474619771863118,0
"<anonymized_userid>",1,51039,4994,"Geert Wilders (PVV)",0.90230708035004,0.474714828897338,0
"<anonymized_userid>",1,51040,4995,"Geert Wilders (PVV)",0.902324759126668,0.474809885931559,0
"<anonymized_userid>",1,51041,4996,"Geert Wilders (PVV)",0.902342437903297,0.474904942965779,0
"<anonymized_userid>",1,51042,4997,"Geert Wilders (PVV)",0.902360116679926,0.475,0
"<anonymized_userid>",1,51043,4998,"Geert Wilders (PVV)",0.902377795456554,0.475095057034221,0
"<anonymized_userid>",1,51044,4999,"Geert Wilders (PVV)",0.902395474233183,0.475190114068441,0
"<anonymized_userid>",1,51045,5000,"Geert Wilders (PVV)",0.902413153009812,0.475285171102662,0
"<anonymized_userid>",1,51046,5001,"Geert Wilders (PVV)",0.90243083178644,0.475380228136882,0
"<anonymized_userid>",1,51047,5002,"Geert Wilders (PVV)",0.902448510563069,0.475475285171103,0
"<anonymized_userid>",1,51048,5003,"Geert Wilders (PVV)",0.902466189339698,0.475570342205323,0
"<anonymized_userid>",1,51049,5004,"Geert Wilders (PVV)",0.902483868116326,0.475665399239544,0
"<anonymized_userid>",1,51050,5005,"Geert Wilders (PVV)",0.902501546892955,0.475760456273764,0
"<anonymized_userid>",1,51051,5006,"Geert Wilders (PVV)",0.902519225669584,0.475855513307985,0
"<anonymized_userid>",1,51052,5007,"Geert Wilders (PVV)",0.902536904446212,0.475950570342205,0
"<anonymized_userid>",1,51053,5008,"Geert Wilders (PVV)",0.902554583222841,0.476045627376426,0
"<anonymized_userid>",1,51054,5009,"Geert Wilders (PVV)",0.90257226199947,0.476140684410646,0
"<anonymized_userid>",1,51055,5010,"Geert Wilders (PVV)",0.902589940776098,0.476235741444867,0
"<anonymized_userid>",1,51056,5011,"Geert Wilders (PVV)",0.902607619552727,0.476330798479087,0
"<anonymized_userid>",1,51057,5012,"Geert Wilders (PVV)",0.902625298329356,0.476425855513308,0
"<anonymized_userid>",1,51058,5013,"Geert Wilders (PVV)",0.902642977105984,0.476520912547529,0
"<anonymized_userid>",1,51059,5014,"Geert Wilders (PVV)",0.902660655882613,0.476615969581749,0
"<anonymized_userid>",1,51060,5015,"Geert Wilders (PVV)",0.902678334659242,0.47671102661597,0
"<anonymized_userid>",1,51061,5016,"Geert Wilders (PVV)",0.90269601343587,0.47680608365019,0
"<anonymized_userid>",1,51062,5017,"Geert Wilders (PVV)",0.902713692212499,0.476901140684411,0
"<anonymized_userid>",1,51063,5018,"Geert Wilders (PVV)",0.902731370989128,0.476996197718631,0
"<anonymized_userid>",1,51064,5019,"Geert Wilders (PVV)",0.902749049765756,0.477091254752852,0
"<anonymized_userid>",1,51065,5020,"Geert Wilders (PVV)",0.902766728542385,0.477186311787072,0
"<anonymized_userid>",1,51066,5021,"Geert Wilders (PVV)",0.902784407319014,0.477281368821293,0
"<anonymized_userid>",1,51067,5022,"Geert Wilders (PVV)",0.902802086095642,0.477376425855513,0
"<anonymized_userid>",1,51068,5023,"Geert Wilders (PVV)",0.902819764872271,0.477471482889734,0
"<anonymized_userid>",1,51069,5024,"Geert Wilders (PVV)",0.9028374436489,0.477566539923954,0
"<anonymized_userid>",1,51070,5025,"Geert Wilders (PVV)",0.902855122425528,0.477661596958175,0
"<anonymized_userid>",1,51071,5026,"Geert Wilders (PVV)",0.902872801202157,0.477756653992395,0
"<anonymized_userid>",1,51072,5027,"Geert Wilders (PVV)",0.902890479978785,0.477851711026616,0
"<anonymized_userid>",1,51073,5028,"Geert Wilders (PVV)",0.902908158755414,0.477946768060837,0
"<anonymized_userid>",1,51074,5029,"Geert Wilders (PVV)",0.902925837532043,0.478041825095057,0
"<anonymized_userid>",1,51075,5030,"Geert Wilders (PVV)",0.902943516308671,0.478136882129278,0
"<anonymized_userid>",1,51076,5031,"Geert Wilders (PVV)",0.9029611950853,0.478231939163498,0
"<anonymized_userid>",1,51077,5032,"Geert Wilders (PVV)",0.902978873861929,0.478326996197719,0
"<anonymized_userid>",1,51078,5033,"Geert Wilders (PVV)",0.902996552638557,0.478422053231939,0
"<anonymized_userid>",1,51079,5034,"Geert Wilders (PVV)",0.903014231415186,0.47851711026616,0
"<anonymized_userid>",1,51080,5035,"Geert Wilders (PVV)",0.903031910191815,0.47861216730038,0
"<anonymized_userid>",1,51081,5036,"Geert Wilders (PVV)",0.903049588968443,0.478707224334601,0
"<anonymized_userid>",1,51082,5037,"Geert Wilders (PVV)",0.903067267745072,0.478802281368821,0
"<anonymized_userid>",1,51083,5038,"Geert Wilders (PVV)",0.903084946521701,0.478897338403042,0
"<anonymized_userid>",1,51084,5039,"Geert Wilders (PVV)",0.903102625298329,0.478992395437262,0
"<anonymized_userid>",1,51085,5040,"Geert Wilders (PVV)",0.903120304074958,0.479087452471483,0
"<anonymized_userid>",1,51086,5041,"Geert Wilders (PVV)",0.903137982851587,0.479182509505703,0
"<anonymized_userid>",1,51087,5042,"Geert Wilders (PVV)",0.903155661628215,0.479277566539924,0
"<anonymized_userid>",1,51088,5043,"Geert Wilders (PVV)",0.903173340404844,0.479372623574145,0
"<anonymized_userid>",1,51089,5044,"Geert Wilders (PVV)",0.903191019181473,0.479467680608365,0
"<anonymized_userid>",1,51090,5045,"Geert Wilders (PVV)",0.903208697958101,0.479562737642586,0
"<anonymized_userid>",1,51091,5046,"Geert Wilders (PVV)",0.90322637673473,0.479657794676806,0
"<anonymized_userid>",1,51092,5047,"Geert Wilders (PVV)",0.903244055511359,0.479752851711027,0
"<anonymized_userid>",1,51093,5048,"Geert Wilders (PVV)",0.903261734287987,0.479847908745247,0
"<anonymized_userid>",1,51094,5049,"Geert Wilders (PVV)",0.903279413064616,0.479942965779468,0
"<anonymized_userid>",1,51095,5050,"Geert Wilders (PVV)",0.903297091841245,0.480038022813688,0
"<anonymized_userid>",1,51096,5051,"Geert Wilders (PVV)",0.903314770617873,0.480133079847909,0
"<anonymized_userid>",1,51097,5052,"Geert Wilders (PVV)",0.903332449394502,0.480228136882129,0
"<anonymized_userid>",1,51098,5053,"Geert Wilders (PVV)",0.903350128171131,0.48032319391635,0
"<anonymized_userid>",1,51099,5054,"Geert Wilders (PVV)",0.903367806947759,0.48041825095057,0
"<anonymized_userid>",1,51100,5055,"Geert Wilders (PVV)",0.903385485724388,0.480513307984791,0
"<anonymized_userid>",1,51101,5056,"Geert Wilders (PVV)",0.903403164501017,0.480608365019011,0
"<anonymized_userid>",1,51102,5057,"Geert Wilders (PVV)",0.903420843277645,0.480703422053232,0
"<anonymized_userid>",1,51103,5058,"Geert Wilders (PVV)",0.903438522054274,0.480798479087452,0
"<anonymized_userid>",1,51104,5059,"Geert Wilders (PVV)",0.903456200830903,0.480893536121673,0
"<anonymized_userid>",1,51105,5060,"Geert Wilders (PVV)",0.903473879607531,0.480988593155894,0
"<anonymized_userid>",1,51106,5061,"Geert Wilders (PVV)",0.90349155838416,0.481083650190114,0
"<anonymized_userid>",1,51107,5062,"Geert Wilders (PVV)",0.903509237160788,0.481178707224335,0
"<anonymized_userid>",1,51108,5063,"Geert Wilders (PVV)",0.903526915937417,0.481273764258555,0
"<anonymized_userid>",1,51109,5064,"Geert Wilders (PVV)",0.903544594714046,0.481368821292776,0
"<anonymized_userid>",1,51110,5065,"Geert Wilders (PVV)",0.903562273490674,0.481463878326996,0
"<anonymized_userid>",1,51111,5066,"Geert Wilders (PVV)",0.903579952267303,0.481558935361217,0
"<anonymized_userid>",1,51112,5067,"Geert Wilders (PVV)",0.903597631043932,0.481653992395437,0
"<anonymized_userid>",1,51113,5068,"Geert Wilders (PVV)",0.90361530982056,0.481749049429658,0
"<anonymized_userid>",1,51114,5069,"Geert Wilders (PVV)",0.903632988597189,0.481844106463878,0
"<anonymized_userid>",1,51115,5070,"Geert Wilders (PVV)",0.903650667373818,0.481939163498099,0
"<anonymized_userid>",1,51116,5071,"Geert Wilders (PVV)",0.903668346150446,0.482034220532319,0
"<anonymized_userid>",1,51117,5072,"Geert Wilders (PVV)",0.903686024927075,0.48212927756654,0
"<anonymized_userid>",1,51118,5073,"Geert Wilders (PVV)",0.903703703703704,0.48222433460076,0
"<anonymized_userid>",1,51119,5074,"Geert Wilders (PVV)",0.903721382480332,0.482319391634981,0
"<anonymized_userid>",1,51120,5075,"Geert Wilders (PVV)",0.903739061256961,0.482414448669202,0
"<anonymized_userid>",1,51121,5076,"Geert Wilders (PVV)",0.90375674003359,0.482509505703422,0
"<anonymized_userid>",1,51122,5077,"Geert Wilders (PVV)",0.903774418810218,0.482604562737643,0
"<anonymized_userid>",1,51123,5078,"Geert Wilders (PVV)",0.903792097586847,0.482699619771863,0
"<anonymized_userid>",1,51124,5079,"Geert Wilders (PVV)",0.903809776363476,0.482794676806084,0
"<anonymized_userid>",1,51125,5080,"Geert Wilders (PVV)",0.903827455140104,0.482889733840304,0
"<anonymized_userid>",1,51126,5081,"Geert Wilders (PVV)",0.903845133916733,0.482984790874525,0
"<anonymized_userid>",1,51127,5082,"Geert Wilders (PVV)",0.903862812693362,0.483079847908745,0
"<anonymized_userid>",1,51128,5083,"Geert Wilders (PVV)",0.90388049146999,0.483174904942966,0
"<anonymized_userid>",1,51129,5084,"Geert Wilders (PVV)",0.903898170246619,0.483269961977186,0
"<anonymized_userid>",1,51130,5085,"Geert Wilders (PVV)",0.903915849023248,0.483365019011407,0
"<anonymized_userid>",1,51131,5086,"Geert Wilders (PVV)",0.903933527799876,0.483460076045627,0
"<anonymized_userid>",1,51132,5087,"Geert Wilders (PVV)",0.903951206576505,0.483555133079848,0
"<anonymized_userid>",1,51133,5088,"Geert Wilders (PVV)",0.903968885353134,0.483650190114068,0
"<anonymized_userid>",1,51134,5089,"Geert Wilders (PVV)",0.903986564129762,0.483745247148289,0
"<anonymized_userid>",1,51135,5090,"Geert Wilders (PVV)",0.904004242906391,0.48384030418251,0
"<anonymized_userid>",1,51136,5091,"Geert Wilders (PVV)",0.90402192168302,0.48393536121673,0
"<anonymized_userid>",1,51137,5092,"Geert Wilders (PVV)",0.904039600459648,0.484030418250951,0
"<anonymized_userid>",1,51138,5093,"Geert Wilders (PVV)",0.904057279236277,0.484125475285171,0
"<anonymized_userid>",1,51139,5094,"Geert Wilders (PVV)",0.904074958012905,0.484220532319392,0
"<anonymized_userid>",1,51140,5095,"Geert Wilders (PVV)",0.904092636789534,0.484315589353612,0
"<anonymized_userid>",1,51141,5096,"Geert Wilders (PVV)",0.904110315566163,0.484410646387833,0
"<anonymized_userid>",1,51142,5097,"Geert Wilders (PVV)",0.904127994342791,0.484505703422053,0
"<anonymized_userid>",1,51143,5098,"Geert Wilders (PVV)",0.90414567311942,0.484600760456274,0
"<anonymized_userid>",1,51144,5099,"Geert Wilders (PVV)",0.904163351896049,0.484695817490494,0
"<anonymized_userid>",1,51145,5100,"Geert Wilders (PVV)",0.904181030672677,0.484790874524715,0
"<anonymized_userid>",1,51146,5101,"Geert Wilders (PVV)",0.904198709449306,0.484885931558935,0
"<anonymized_userid>",1,51147,5102,"Geert Wilders (PVV)",0.904216388225935,0.484980988593156,0
"<anonymized_userid>",1,51148,5103,"Geert Wilders (PVV)",0.904234067002563,0.485076045627376,0
"<anonymized_userid>",1,51149,5104,"Geert Wilders (PVV)",0.904251745779192,0.485171102661597,0
"<anonymized_userid>",1,51150,5105,"Geert Wilders (PVV)",0.904269424555821,0.485266159695817,0
"<anonymized_userid>",1,51151,5106,"Geert Wilders (PVV)",0.904287103332449,0.485361216730038,0
"<anonymized_userid>",1,51152,5107,"Geert Wilders (PVV)",0.904304782109078,0.485456273764259,0
"<anonymized_userid>",1,51153,5108,"Geert Wilders (PVV)",0.904322460885707,0.485551330798479,0
"<anonymized_userid>",1,51154,5109,"Geert Wilders (PVV)",0.904340139662335,0.4856463878327,0
"<anonymized_userid>",1,51155,5110,"Geert Wilders (PVV)",0.904357818438964,0.48574144486692,0
"<anonymized_userid>",1,51156,5111,"Geert Wilders (PVV)",0.904375497215593,0.485836501901141,0
"<anonymized_userid>",1,51157,5112,"Geert Wilders (PVV)",0.904393175992221,0.485931558935361,0
"<anonymized_userid>",1,51158,5113,"Geert Wilders (PVV)",0.90441085476885,0.486026615969582,0
"<anonymized_userid>",1,51159,5114,"Geert Wilders (PVV)",0.904428533545479,0.486121673003802,0
"<anonymized_userid>",1,51160,5115,"Geert Wilders (PVV)",0.904446212322107,0.486216730038023,0
"<anonymized_userid>",1,51161,5116,"Geert Wilders (PVV)",0.904463891098736,0.486311787072243,0
"<anonymized_userid>",1,51162,5117,"Geert Wilders (PVV)",0.904481569875365,0.486406844106464,0
"<anonymized_userid>",1,51163,5118,"Geert Wilders (PVV)",0.904499248651993,0.486501901140684,0
"<anonymized_userid>",1,51164,5119,"Geert Wilders (PVV)",0.904516927428622,0.486596958174905,0
"<anonymized_userid>",1,51165,5120,"Geert Wilders (PVV)",0.904534606205251,0.486692015209125,0
"<anonymized_userid>",1,51166,5121,"Geert Wilders (PVV)",0.904552284981879,0.486787072243346,0
"<anonymized_userid>",1,51167,5122,"Geert Wilders (PVV)",0.904569963758508,0.486882129277567,0
"<anonymized_userid>",1,51168,5123,"Geert Wilders (PVV)",0.904587642535137,0.486977186311787,0
"<anonymized_userid>",1,51169,5124,"Geert Wilders (PVV)",0.904605321311765,0.487072243346008,0
"<anonymized_userid>",1,51170,5125,"Geert Wilders (PVV)",0.904623000088394,0.487167300380228,0
"<anonymized_userid>",1,51171,5126,"Geert Wilders (PVV)",0.904640678865023,0.487262357414449,0
"<anonymized_userid>",1,51172,5127,"Geert Wilders (PVV)",0.904658357641651,0.487357414448669,0
"<anonymized_userid>",1,51173,5128,"Geert Wilders (PVV)",0.90467603641828,0.48745247148289,0
"<anonymized_userid>",1,51174,5129,"Geert Wilders (PVV)",0.904693715194908,0.48754752851711,0
"<anonymized_userid>",1,51175,5130,"Geert Wilders (PVV)",0.904711393971537,0.487642585551331,0
"<anonymized_userid>",1,51176,5131,"Geert Wilders (PVV)",0.904729072748166,0.487737642585551,0
"<anonymized_userid>",1,51177,5132,"Geert Wilders (PVV)",0.904746751524794,0.487832699619772,0
"<anonymized_userid>",1,51178,5133,"Geert Wilders (PVV)",0.904764430301423,0.487927756653992,0
"<anonymized_userid>",1,51179,5134,"Geert Wilders (PVV)",0.904782109078052,0.488022813688213,0
"<anonymized_userid>",1,51180,5135,"Geert Wilders (PVV)",0.90479978785468,0.488117870722433,0
"<anonymized_userid>",1,51181,5136,"Geert Wilders (PVV)",0.904817466631309,0.488212927756654,0
"<anonymized_userid>",1,51182,5137,"Geert Wilders (PVV)",0.904835145407938,0.488307984790875,0
"<anonymized_userid>",1,51183,5138,"Geert Wilders (PVV)",0.904852824184566,0.488403041825095,0
"<anonymized_userid>",1,51184,5139,"Geert Wilders (PVV)",0.904870502961195,0.488498098859316,0
"<anonymized_userid>",1,51185,5140,"Geert Wilders (PVV)",0.904888181737824,0.488593155893536,0
"<anonymized_userid>",1,51186,5141,"Geert Wilders (PVV)",0.904905860514452,0.488688212927757,0
"<anonymized_userid>",1,51187,5142,"Geert Wilders (PVV)",0.904923539291081,0.488783269961977,0
"<anonymized_userid>",1,51188,5143,"Geert Wilders (PVV)",0.90494121806771,0.488878326996198,0
"<anonymized_userid>",1,51189,5144,"Geert Wilders (PVV)",0.904958896844338,0.488973384030418,0
"<anonymized_userid>",1,51190,5145,"Geert Wilders (PVV)",0.904976575620967,0.489068441064639,0
"<anonymized_userid>",1,51191,5146,"Geert Wilders (PVV)",0.904994254397596,0.489163498098859,0
"<anonymized_userid>",1,51192,5147,"Geert Wilders (PVV)",0.905011933174224,0.48925855513308,0
"<anonymized_userid>",1,51193,5148,"Geert Wilders (PVV)",0.905029611950853,0.4893536121673,0
"<anonymized_userid>",1,51194,5149,"Geert Wilders (PVV)",0.905047290727482,0.489448669201521,0
"<anonymized_userid>",1,51195,5150,"Geert Wilders (PVV)",0.90506496950411,0.489543726235741,0
"<anonymized_userid>",1,51196,5151,"Geert Wilders (PVV)",0.905082648280739,0.489638783269962,0
"<anonymized_userid>",1,51197,5152,"Geert Wilders (PVV)",0.905100327057368,0.489733840304182,0
"<anonymized_userid>",1,51198,5153,"Geert Wilders (PVV)",0.905118005833996,0.489828897338403,0
"<anonymized_userid>",1,51199,5154,"Geert Wilders (PVV)",0.905135684610625,0.489923954372624,0
"<anonymized_userid>",1,51200,5155,"Geert Wilders (PVV)",0.905153363387254,0.490019011406844,0
"<anonymized_userid>",1,51201,5156,"Geert Wilders (PVV)",0.905171042163882,0.490114068441065,0
"<anonymized_userid>",1,51202,5157,"Geert Wilders (PVV)",0.905188720940511,0.490209125475285,0
"<anonymized_userid>",1,51203,5158,"Geert Wilders (PVV)",0.90520639971714,0.490304182509506,0
"<anonymized_userid>",1,51204,5159,"Geert Wilders (PVV)",0.905224078493768,0.490399239543726,0
"<anonymized_userid>",1,51205,5160,"Geert Wilders (PVV)",0.905241757270397,0.490494296577947,0
"<anonymized_userid>",1,51206,5161,"Geert Wilders (PVV)",0.905259436047026,0.490589353612167,0
"<anonymized_userid>",1,51207,5162,"Geert Wilders (PVV)",0.905277114823654,0.490684410646388,0
"<anonymized_userid>",1,51208,5163,"Geert Wilders (PVV)",0.905294793600283,0.490779467680608,0
"<anonymized_userid>",1,51209,5164,"Geert Wilders (PVV)",0.905312472376911,0.490874524714829,0
"<anonymized_userid>",1,51210,5165,"Geert Wilders (PVV)",0.90533015115354,0.490969581749049,0
"<anonymized_userid>",1,51211,5166,"Geert Wilders (PVV)",0.905347829930169,0.49106463878327,0
"<anonymized_userid>",1,51212,5167,"Geert Wilders (PVV)",0.905365508706797,0.49115969581749,0
"<anonymized_userid>",1,51213,5168,"Geert Wilders (PVV)",0.905383187483426,0.491254752851711,0
"<anonymized_userid>",1,51214,5169,"Geert Wilders (PVV)",0.905400866260055,0.491349809885932,0
"<anonymized_userid>",1,51215,5170,"Geert Wilders (PVV)",0.905418545036684,0.491444866920152,0
"<anonymized_userid>",1,51216,5171,"Geert Wilders (PVV)",0.905436223813312,0.491539923954373,0
"<anonymized_userid>",1,51217,5172,"Geert Wilders (PVV)",0.905453902589941,0.491634980988593,0
"<anonymized_userid>",1,51218,5173,"Geert Wilders (PVV)",0.905471581366569,0.491730038022814,0
"<anonymized_userid>",1,51219,5174,"Geert Wilders (PVV)",0.905489260143198,0.491825095057034,0
"<anonymized_userid>",1,51220,5175,"Geert Wilders (PVV)",0.905506938919827,0.491920152091255,0
"<anonymized_userid>",1,51221,5176,"Geert Wilders (PVV)",0.905524617696455,0.492015209125475,0
"<anonymized_userid>",1,51222,5177,"Geert Wilders (PVV)",0.905542296473084,0.492110266159696,0
"<anonymized_userid>",1,51223,5178,"Geert Wilders (PVV)",0.905559975249713,0.492205323193916,0
"<anonymized_userid>",1,51224,5179,"Geert Wilders (PVV)",0.905577654026341,0.492300380228137,0
"<anonymized_userid>",1,51225,5180,"Geert Wilders (PVV)",0.90559533280297,0.492395437262357,0
"<anonymized_userid>",1,51226,5181,"Geert Wilders (PVV)",0.905613011579599,0.492490494296578,0
"<anonymized_userid>",1,51227,5182,"Geert Wilders (PVV)",0.905630690356227,0.492585551330798,0
"<anonymized_userid>",1,51228,5183,"Geert Wilders (PVV)",0.905648369132856,0.492680608365019,0
"<anonymized_userid>",1,51229,5184,"Geert Wilders (PVV)",0.905666047909485,0.49277566539924,0
"<anonymized_userid>",1,51230,5185,"Geert Wilders (PVV)",0.905683726686113,0.49287072243346,0
"<anonymized_userid>",1,51231,5186,"Geert Wilders (PVV)",0.905701405462742,0.492965779467681,0
"<anonymized_userid>",1,51232,5187,"Geert Wilders (PVV)",0.905719084239371,0.493060836501901,0
"<anonymized_userid>",1,51233,5188,"Geert Wilders (PVV)",0.905736763015999,0.493155893536122,0
"<anonymized_userid>",1,51234,5189,"Geert Wilders (PVV)",0.905754441792628,0.493250950570342,0
"<anonymized_userid>",1,51235,5190,"Geert Wilders (PVV)",0.905772120569257,0.493346007604563,0
"<anonymized_userid>",1,51236,5191,"Geert Wilders (PVV)",0.905789799345885,0.493441064638783,0
"<anonymized_userid>",1,51237,5192,"Geert Wilders (PVV)",0.905807478122514,0.493536121673004,0
"<anonymized_userid>",1,51238,5193,"Geert Wilders (PVV)",0.905825156899143,0.493631178707224,0
"<anonymized_userid>",1,51239,5194,"Geert Wilders (PVV)",0.905842835675771,0.493726235741445,0
"<anonymized_userid>",1,51240,5195,"Geert Wilders (PVV)",0.9058605144524,0.493821292775665,0
"<anonymized_userid>",1,51241,5196,"Geert Wilders (PVV)",0.905878193229029,0.493916349809886,0
"<anonymized_userid>",1,51242,5197,"Geert Wilders (PVV)",0.905895872005657,0.494011406844106,0
"<anonymized_userid>",1,51243,5198,"Geert Wilders (PVV)",0.905913550782286,0.494106463878327,0
"<anonymized_userid>",1,51244,5199,"Geert Wilders (PVV)",0.905931229558914,0.494201520912548,0
"<anonymized_userid>",1,51245,5200,"Geert Wilders (PVV)",0.905948908335543,0.494296577946768,0
"<anonymized_userid>",1,51246,5201,"Geert Wilders (PVV)",0.905966587112172,0.494391634980989,0
"<anonymized_userid>",1,51247,5202,"Geert Wilders (PVV)",0.905984265888801,0.494486692015209,0
"<anonymized_userid>",1,51248,5203,"Geert Wilders (PVV)",0.906001944665429,0.49458174904943,0
"<anonymized_userid>",1,51249,5204,"Geert Wilders (PVV)",0.906019623442058,0.49467680608365,0
"<anonymized_userid>",1,51250,5205,"Geert Wilders (PVV)",0.906037302218687,0.494771863117871,0
"<anonymized_userid>",1,51251,5206,"Geert Wilders (PVV)",0.906054980995315,0.494866920152091,0
"<anonymized_userid>",1,51252,5207,"Geert Wilders (PVV)",0.906072659771944,0.494961977186312,0
"<anonymized_userid>",1,51253,5208,"Geert Wilders (PVV)",0.906090338548572,0.495057034220532,0
"<anonymized_userid>",1,51254,5209,"Geert Wilders (PVV)",0.906108017325201,0.495152091254753,0
"<anonymized_userid>",1,51255,5210,"Geert Wilders (PVV)",0.90612569610183,0.495247148288973,0
"<anonymized_userid>",1,51256,5211,"Geert Wilders (PVV)",0.906143374878458,0.495342205323194,0
"<anonymized_userid>",1,51257,5212,"Geert Wilders (PVV)",0.906161053655087,0.495437262357414,0
"<anonymized_userid>",1,51258,5213,"Geert Wilders (PVV)",0.906178732431716,0.495532319391635,0
"<anonymized_userid>",1,51259,5214,"Geert Wilders (PVV)",0.906196411208344,0.495627376425856,0
"<anonymized_userid>",1,51260,5215,"Geert Wilders (PVV)",0.906214089984973,0.495722433460076,0
"<anonymized_userid>",1,51261,5216,"Geert Wilders (PVV)",0.906231768761602,0.495817490494297,0
"<anonymized_userid>",1,51262,5217,"Geert Wilders (PVV)",0.90624944753823,0.495912547528517,0
"<anonymized_userid>",1,51263,5218,"Geert Wilders (PVV)",0.906267126314859,0.496007604562738,0
"<anonymized_userid>",1,51264,5219,"Geert Wilders (PVV)",0.906284805091488,0.496102661596958,0
"<anonymized_userid>",1,51265,5220,"Geert Wilders (PVV)",0.906302483868116,0.496197718631179,0
"<anonymized_userid>",1,51266,5221,"Geert Wilders (PVV)",0.906320162644745,0.496292775665399,0
"<anonymized_userid>",1,51267,5222,"Geert Wilders (PVV)",0.906337841421374,0.49638783269962,0
"<anonymized_userid>",1,51268,5223,"Geert Wilders (PVV)",0.906355520198002,0.49648288973384,0
"<anonymized_userid>",1,51269,5224,"Geert Wilders (PVV)",0.906373198974631,0.496577946768061,0
"<anonymized_userid>",1,51270,5225,"Geert Wilders (PVV)",0.90639087775126,0.496673003802281,0
"<anonymized_userid>",1,51271,5226,"Geert Wilders (PVV)",0.906408556527888,0.496768060836502,0
"<anonymized_userid>",1,51272,5227,"Geert Wilders (PVV)",0.906426235304517,0.496863117870722,0
"<anonymized_userid>",1,51273,5228,"Geert Wilders (PVV)",0.906443914081146,0.496958174904943,0
"<anonymized_userid>",1,51274,5229,"Geert Wilders (PVV)",0.906461592857774,0.497053231939164,0
"<anonymized_userid>",1,51275,5230,"Geert Wilders (PVV)",0.906479271634403,0.497148288973384,0
"<anonymized_userid>",1,51276,5231,"Geert Wilders (PVV)",0.906496950411032,0.497243346007605,0
"<anonymized_userid>",1,51277,5232,"Geert Wilders (PVV)",0.90651462918766,0.497338403041825,0
"<anonymized_userid>",1,51278,5233,"Geert Wilders (PVV)",0.906532307964289,0.497433460076046,0
"<anonymized_userid>",1,51279,5234,"Geert Wilders (PVV)",0.906549986740918,0.497528517110266,0
"<anonymized_userid>",1,51280,5235,"Geert Wilders (PVV)",0.906567665517546,0.497623574144487,0
"<anonymized_userid>",1,51281,5236,"Geert Wilders (PVV)",0.906585344294175,0.497718631178707,0
"<anonymized_userid>",1,51282,5237,"Geert Wilders (PVV)",0.906603023070804,0.497813688212928,0
"<anonymized_userid>",1,51283,5238,"Geert Wilders (PVV)",0.906620701847432,0.497908745247148,0
"<anonymized_userid>",1,51284,5239,"Geert Wilders (PVV)",0.906638380624061,0.498003802281369,0
"<anonymized_userid>",1,51285,5240,"Geert Wilders (PVV)",0.906656059400689,0.498098859315589,0
"<anonymized_userid>",1,51286,5241,"Geert Wilders (PVV)",0.906673738177318,0.49819391634981,0
"<anonymized_userid>",1,51287,5242,"Geert Wilders (PVV)",0.906691416953947,0.49828897338403,0
"<anonymized_userid>",1,51288,5243,"Geert Wilders (PVV)",0.906709095730575,0.498384030418251,0
"<anonymized_userid>",1,51289,5244,"Geert Wilders (PVV)",0.906726774507204,0.498479087452471,0
"<anonymized_userid>",1,51290,5245,"Geert Wilders (PVV)",0.906744453283833,0.498574144486692,0
"<anonymized_userid>",1,51291,5246,"Geert Wilders (PVV)",0.906762132060461,0.498669201520913,0
"<anonymized_userid>",1,51292,5247,"Geert Wilders (PVV)",0.90677981083709,0.498764258555133,0
"<anonymized_userid>",1,51293,5248,"Geert Wilders (PVV)",0.906797489613719,0.498859315589354,0
"<anonymized_userid>",1,51294,5249,"Geert Wilders (PVV)",0.906815168390347,0.498954372623574,0
"<anonymized_userid>",1,51295,5250,"Geert Wilders (PVV)",0.906832847166976,0.499049429657795,0
"<anonymized_userid>",1,51296,5251,"Geert Wilders (PVV)",0.906850525943605,0.499144486692015,0
"<anonymized_userid>",1,51297,5252,"Geert Wilders (PVV)",0.906868204720233,0.499239543726236,0
"<anonymized_userid>",1,51298,5253,"Geert Wilders (PVV)",0.906885883496862,0.499334600760456,0
"<anonymized_userid>",1,51299,5254,"Geert Wilders (PVV)",0.906903562273491,0.499429657794677,0
"<anonymized_userid>",1,51300,5255,"Geert Wilders (PVV)",0.906921241050119,0.499524714828897,0
"<anonymized_userid>",1,51301,5256,"Geert Wilders (PVV)",0.906938919826748,0.499619771863118,0
"<anonymized_userid>",1,51302,5257,"Geert Wilders (PVV)",0.906956598603377,0.499714828897338,0
"<anonymized_userid>",1,51303,5258,"Geert Wilders (PVV)",0.906974277380005,0.499809885931559,0
"<anonymized_userid>",1,51304,5259,"Geert Wilders (PVV)",0.906991956156634,0.499904942965779,0
"<anonymized_userid>",1,51305,5260,"Geert Wilders (PVV)",0.907009634933263,0.5,0
"<anonymized_userid>",1,51306,5261,"Geert Wilders (PVV)",0.907027313709891,0.500095057034221,1
"<anonymized_userid>",1,51307,5262,"Geert Wilders (PVV)",0.90704499248652,0.500190114068441,1
"<anonymized_userid>",1,51308,5263,"Geert Wilders (PVV)",0.907062671263149,0.500285171102662,0
"<anonymized_userid>",1,51309,5264,"Geert Wilders (PVV)",0.907080350039777,0.500380228136882,0
"<anonymized_userid>",1,51310,5265,"Geert Wilders (PVV)",0.907098028816406,0.500475285171103,0
"<anonymized_userid>",1,51311,5266,"Geert Wilders (PVV)",0.907115707593035,0.500570342205323,0
"<anonymized_userid>",1,51312,5267,"Geert Wilders (PVV)",0.907133386369663,0.500665399239544,0
"<anonymized_userid>",1,51313,5268,"Geert Wilders (PVV)",0.907151065146292,0.500760456273764,0
"<anonymized_userid>",1,51314,5269,"Geert Wilders (PVV)",0.907168743922921,0.500855513307985,0
"<anonymized_userid>",1,51315,5270,"Geert Wilders (PVV)",0.907186422699549,0.500950570342205,0
"<anonymized_userid>",1,51316,5271,"Geert Wilders (PVV)",0.907204101476178,0.501045627376426,0
"<anonymized_userid>",1,51317,5272,"Geert Wilders (PVV)",0.907221780252807,0.501140684410646,0
"<anonymized_userid>",1,51318,5273,"Geert Wilders (PVV)",0.907239459029435,0.501235741444867,0
"<anonymized_userid>",1,51319,5274,"Geert Wilders (PVV)",0.907257137806064,0.501330798479087,0
"<anonymized_userid>",1,51320,5275,"Geert Wilders (PVV)",0.907274816582692,0.501425855513308,0
"<anonymized_userid>",1,51321,5276,"Geert Wilders (PVV)",0.907292495359321,0.501520912547529,0
"<anonymized_userid>",1,51322,5277,"Geert Wilders (PVV)",0.90731017413595,0.501615969581749,0
"<anonymized_userid>",1,51323,5278,"Geert Wilders (PVV)",0.907327852912578,0.50171102661597,0
"<anonymized_userid>",1,51324,5279,"Geert Wilders (PVV)",0.907345531689207,0.50180608365019,0
"<anonymized_userid>",1,51325,5280,"Geert Wilders (PVV)",0.907363210465836,0.501901140684411,0
"<anonymized_userid>",1,51326,5281,"Geert Wilders (PVV)",0.907380889242464,0.501996197718631,0
"<anonymized_userid>",1,51327,5282,"Geert Wilders (PVV)",0.907398568019093,0.502091254752852,0
"<anonymized_userid>",1,51328,5283,"Geert Wilders (PVV)",0.907416246795722,0.502186311787072,0
"<anonymized_userid>",1,51329,5284,"Geert Wilders (PVV)",0.90743392557235,0.502281368821293,0
"<anonymized_userid>",1,51330,5285,"Geert Wilders (PVV)",0.907451604348979,0.502376425855513,0
"<anonymized_userid>",1,51331,5286,"Geert Wilders (PVV)",0.907469283125608,0.502471482889734,0
"<anonymized_userid>",1,51332,5287,"Geert Wilders (PVV)",0.907486961902236,0.502566539923954,0
"<anonymized_userid>",1,51333,5288,"Geert Wilders (PVV)",0.907504640678865,0.502661596958175,0
"<anonymized_userid>",1,51334,5289,"Geert Wilders (PVV)",0.907522319455494,0.502756653992395,0
"<anonymized_userid>",1,51335,5290,"Geert Wilders (PVV)",0.907539998232122,0.502851711026616,0
"<anonymized_userid>",1,51336,5291,"Geert Wilders (PVV)",0.907557677008751,0.502946768060836,0
"<anonymized_userid>",1,51337,5292,"Geert Wilders (PVV)",0.90757535578538,0.503041825095057,0
"<anonymized_userid>",1,51338,5293,"Geert Wilders (PVV)",0.907593034562008,0.503136882129278,0
"<anonymized_userid>",1,51339,5294,"Geert Wilders (PVV)",0.907610713338637,0.503231939163498,0
"<anonymized_userid>",1,51340,5295,"Geert Wilders (PVV)",0.907628392115266,0.503326996197719,0
"<anonymized_userid>",1,51341,5296,"Geert Wilders (PVV)",0.907646070891894,0.503422053231939,0
"<anonymized_userid>",1,51342,5297,"Geert Wilders (PVV)",0.907663749668523,0.50351711026616,0
"<anonymized_userid>",1,51343,5298,"Geert Wilders (PVV)",0.907681428445152,0.50361216730038,0
"<anonymized_userid>",1,51344,5299,"Geert Wilders (PVV)",0.90769910722178,0.503707224334601,0
"<anonymized_userid>",1,51345,5300,"Geert Wilders (PVV)",0.907716785998409,0.503802281368821,0
"<anonymized_userid>",1,51346,5301,"Geert Wilders (PVV)",0.907734464775038,0.503897338403042,0
"<anonymized_userid>",1,51347,5302,"Geert Wilders (PVV)",0.907752143551666,0.503992395437262,0
"<anonymized_userid>",1,51348,5303,"Geert Wilders (PVV)",0.907769822328295,0.504087452471483,0
"<anonymized_userid>",1,51349,5304,"Geert Wilders (PVV)",0.907787501104924,0.504182509505703,0
"<anonymized_userid>",1,51350,5305,"Geert Wilders (PVV)",0.907805179881552,0.504277566539924,0
"<anonymized_userid>",1,51351,5306,"Geert Wilders (PVV)",0.907822858658181,0.504372623574144,0
"<anonymized_userid>",1,51352,5307,"Geert Wilders (PVV)",0.90784053743481,0.504467680608365,0
"<anonymized_userid>",1,51353,5308,"Geert Wilders (PVV)",0.907858216211438,0.504562737642586,0
"<anonymized_userid>",1,51354,5309,"Geert Wilders (PVV)",0.907875894988067,0.504657794676806,0
"<anonymized_userid>",1,51355,5310,"Geert Wilders (PVV)",0.907893573764695,0.504752851711027,0
"<anonymized_userid>",1,51356,5311,"Geert Wilders (PVV)",0.907911252541324,0.504847908745247,0
"<anonymized_userid>",1,51357,5312,"Geert Wilders (PVV)",0.907928931317953,0.504942965779468,0
"<anonymized_userid>",1,51358,5313,"Geert Wilders (PVV)",0.907946610094581,0.505038022813688,0
"<anonymized_userid>",1,51359,5314,"Geert Wilders (PVV)",0.90796428887121,0.505133079847909,0
"<anonymized_userid>",1,51360,5315,"Geert Wilders (PVV)",0.907981967647839,0.505228136882129,0
"<anonymized_userid>",1,51361,5316,"Geert Wilders (PVV)",0.907999646424467,0.50532319391635,0
"<anonymized_userid>",1,51362,5317,"Geert Wilders (PVV)",0.908017325201096,0.50541825095057,0
"<anonymized_userid>",1,51363,5318,"Geert Wilders (PVV)",0.908035003977725,0.505513307984791,0
"<anonymized_userid>",1,51364,5319,"Geert Wilders (PVV)",0.908052682754353,0.505608365019011,0
"<anonymized_userid>",1,51365,5320,"Geert Wilders (PVV)",0.908070361530982,0.505703422053232,0
"<anonymized_userid>",1,51366,5321,"Geert Wilders (PVV)",0.908088040307611,0.505798479087452,0
"<anonymized_userid>",1,51367,5322,"Geert Wilders (PVV)",0.908105719084239,0.505893536121673,0
"<anonymized_userid>",1,51368,5323,"Geert Wilders (PVV)",0.908123397860868,0.505988593155894,0
"<anonymized_userid>",1,51369,5324,"Geert Wilders (PVV)",0.908141076637497,0.506083650190114,0
"<anonymized_userid>",1,51370,5325,"Geert Wilders (PVV)",0.908158755414125,0.506178707224335,0
"<anonymized_userid>",1,51371,5326,"Geert Wilders (PVV)",0.908176434190754,0.506273764258555,0
"<anonymized_userid>",1,51372,5327,"Geert Wilders (PVV)",0.908194112967383,0.506368821292776,0
"<anonymized_userid>",1,51373,5328,"Geert Wilders (PVV)",0.908211791744011,0.506463878326996,0
"<anonymized_userid>",1,51374,5329,"Geert Wilders (PVV)",0.90822947052064,0.506558935361217,0
"<anonymized_userid>",1,51375,5330,"Geert Wilders (PVV)",0.908247149297269,0.506653992395437,0
"<anonymized_userid>",1,51376,5331,"Geert Wilders (PVV)",0.908264828073897,0.506749049429658,0
"<anonymized_userid>",1,51377,5332,"Geert Wilders (PVV)",0.908282506850526,0.506844106463878,0
"<anonymized_userid>",1,51378,5333,"Geert Wilders (PVV)",0.908300185627155,0.506939163498099,0
"<anonymized_userid>",1,51379,5334,"Geert Wilders (PVV)",0.908317864403783,0.507034220532319,0
"<anonymized_userid>",1,51380,5335,"Geert Wilders (PVV)",0.908335543180412,0.50712927756654,0
"<anonymized_userid>",1,51381,5336,"Geert Wilders (PVV)",0.908353221957041,0.50722433460076,0
"<anonymized_userid>",1,51382,5337,"Geert Wilders (PVV)",0.908370900733669,0.507319391634981,0
"<anonymized_userid>",1,51383,5338,"Geert Wilders (PVV)",0.908388579510298,0.507414448669201,0
"<anonymized_userid>",1,51384,5339,"Geert Wilders (PVV)",0.908406258286927,0.507509505703422,0
"<anonymized_userid>",1,51385,5340,"Geert Wilders (PVV)",0.908423937063555,0.507604562737643,0
"<anonymized_userid>",1,51386,5341,"Geert Wilders (PVV)",0.908441615840184,0.507699619771863,0
"<anonymized_userid>",1,51387,5342,"Geert Wilders (PVV)",0.908459294616813,0.507794676806084,0
"<anonymized_userid>",1,51388,5343,"Geert Wilders (PVV)",0.908476973393441,0.507889733840304,0
"<anonymized_userid>",1,51389,5344,"Geert Wilders (PVV)",0.90849465217007,0.507984790874525,0
"<anonymized_userid>",1,51390,5345,"Geert Wilders (PVV)",0.908512330946698,0.508079847908745,0
"<anonymized_userid>",1,51391,5346,"Geert Wilders (PVV)",0.908530009723327,0.508174904942966,0
"<anonymized_userid>",1,51392,5347,"Geert Wilders (PVV)",0.908547688499956,0.508269961977186,0
"<anonymized_userid>",1,51393,5348,"Geert Wilders (PVV)",0.908565367276584,0.508365019011407,0
"<anonymized_userid>",1,51394,5349,"Geert Wilders (PVV)",0.908583046053213,0.508460076045627,0
"<anonymized_userid>",1,51395,5350,"Geert Wilders (PVV)",0.908600724829842,0.508555133079848,0
"<anonymized_userid>",1,51396,5351,"Geert Wilders (PVV)",0.90861840360647,0.508650190114068,0
"<anonymized_userid>",1,51397,5352,"Geert Wilders (PVV)",0.908636082383099,0.508745247148289,0
"<anonymized_userid>",1,51398,5353,"Geert Wilders (PVV)",0.908653761159728,0.508840304182509,0
"<anonymized_userid>",1,51399,5354,"Geert Wilders (PVV)",0.908671439936356,0.50893536121673,0
"<anonymized_userid>",1,51400,5355,"Geert Wilders (PVV)",0.908689118712985,0.509030418250951,0
"<anonymized_userid>",1,51401,5356,"Geert Wilders (PVV)",0.908706797489614,0.509125475285171,0
"<anonymized_userid>",1,51402,5357,"Geert Wilders (PVV)",0.908724476266242,0.509220532319392,0
"<anonymized_userid>",1,51403,5358,"Geert Wilders (PVV)",0.908742155042871,0.509315589353612,0
"<anonymized_userid>",1,51404,5359,"Geert Wilders (PVV)",0.9087598338195,0.509410646387833,0
"<anonymized_userid>",1,51405,5360,"Geert Wilders (PVV)",0.908777512596128,0.509505703422053,0
"<anonymized_userid>",1,51406,5361,"Geert Wilders (PVV)",0.908795191372757,0.509600760456274,0
"<anonymized_userid>",1,51407,5362,"Geert Wilders (PVV)",0.908812870149386,0.509695817490494,0
"<anonymized_userid>",1,51408,5363,"Geert Wilders (PVV)",0.908830548926014,0.509790874524715,0
"<anonymized_userid>",1,51409,5364,"Geert Wilders (PVV)",0.908848227702643,0.509885931558935,0
"<anonymized_userid>",1,51410,5365,"Geert Wilders (PVV)",0.908865906479272,0.509980988593156,0
"<anonymized_userid>",1,51411,5366,"Geert Wilders (PVV)",0.9088835852559,0.510076045627376,0
"<anonymized_userid>",1,51412,5367,"Geert Wilders (PVV)",0.908901264032529,0.510171102661597,0
"<anonymized_userid>",1,51413,5368,"Geert Wilders (PVV)",0.908918942809158,0.510266159695817,0
"<anonymized_userid>",1,51414,5369,"Geert Wilders (PVV)",0.908936621585786,0.510361216730038,0
"<anonymized_userid>",1,51415,5370,"Geert Wilders (PVV)",0.908954300362415,0.510456273764259,0
"<anonymized_userid>",1,51416,5371,"Geert Wilders (PVV)",0.908971979139044,0.510551330798479,0
"<anonymized_userid>",1,51417,5372,"Geert Wilders (PVV)",0.908989657915672,0.5106463878327,0
"<anonymized_userid>",1,51418,5373,"Geert Wilders (PVV)",0.909007336692301,0.51074144486692,0
"<anonymized_userid>",1,51419,5374,"Geert Wilders (PVV)",0.90902501546893,0.510836501901141,0
"<anonymized_userid>",1,51420,5375,"Geert Wilders (PVV)",0.909042694245558,0.510931558935361,0
"<anonymized_userid>",1,51421,5376,"Geert Wilders (PVV)",0.909060373022187,0.511026615969582,0
"<anonymized_userid>",1,51422,5377,"Geert Wilders (PVV)",0.909078051798816,0.511121673003802,0
"<anonymized_userid>",1,51423,5378,"Geert Wilders (PVV)",0.909095730575444,0.511216730038023,0
"<anonymized_userid>",1,51424,5379,"Geert Wilders (PVV)",0.909113409352073,0.511311787072243,0
"<anonymized_userid>",1,51425,5380,"Geert Wilders (PVV)",0.909131088128701,0.511406844106464,0
"<anonymized_userid>",1,51426,5381,"Geert Wilders (PVV)",0.90914876690533,0.511501901140684,0
"<anonymized_userid>",1,51427,5382,"Geert Wilders (PVV)",0.909166445681959,0.511596958174905,0
"<anonymized_userid>",1,51428,5383,"Geert Wilders (PVV)",0.909184124458587,0.511692015209125,0
"<anonymized_userid>",1,51429,5384,"Geert Wilders (PVV)",0.909201803235216,0.511787072243346,0
"<anonymized_userid>",1,51430,5385,"Geert Wilders (PVV)",0.909219482011845,0.511882129277566,0
"<anonymized_userid>",1,51431,5386,"Geert Wilders (PVV)",0.909237160788473,0.511977186311787,0
"<anonymized_userid>",1,51432,5387,"Geert Wilders (PVV)",0.909254839565102,0.512072243346008,0
"<anonymized_userid>",1,51433,5388,"Geert Wilders (PVV)",0.909272518341731,0.512167300380228,0
"<anonymized_userid>",1,51434,5389,"Geert Wilders (PVV)",0.909290197118359,0.512262357414449,0
"<anonymized_userid>",1,51435,5390,"Geert Wilders (PVV)",0.909307875894988,0.512357414448669,0
"<anonymized_userid>",1,51436,5391,"Geert Wilders (PVV)",0.909325554671617,0.51245247148289,0
"<anonymized_userid>",1,51437,5392,"Geert Wilders (PVV)",0.909343233448245,0.51254752851711,0
"<anonymized_userid>",1,51438,5393,"Geert Wilders (PVV)",0.909360912224874,0.512642585551331,0
"<anonymized_userid>",1,51439,5394,"Geert Wilders (PVV)",0.909378591001503,0.512737642585551,0
"<anonymized_userid>",1,51440,5395,"Geert Wilders (PVV)",0.909396269778131,0.512832699619772,0
"<anonymized_userid>",1,51441,5396,"Geert Wilders (PVV)",0.90941394855476,0.512927756653992,0
"<anonymized_userid>",1,51442,5397,"Geert Wilders (PVV)",0.909431627331389,0.513022813688213,0
"<anonymized_userid>",1,51443,5398,"Geert Wilders (PVV)",0.909449306108017,0.513117870722433,0
"<anonymized_userid>",1,51444,5399,"Geert Wilders (PVV)",0.909466984884646,0.513212927756654,0
"<anonymized_userid>",1,51445,5400,"Geert Wilders (PVV)",0.909484663661275,0.513307984790874,0
"<anonymized_userid>",1,51446,5401,"Geert Wilders (PVV)",0.909502342437903,0.513403041825095,0
"<anonymized_userid>",1,51447,5402,"Geert Wilders (PVV)",0.909520021214532,0.513498098859316,0
"<anonymized_userid>",1,51448,5403,"Geert Wilders (PVV)",0.909537699991161,0.513593155893536,0
"<anonymized_userid>",1,51449,5404,"Geert Wilders (PVV)",0.909555378767789,0.513688212927757,0
"<anonymized_userid>",1,51450,5405,"Geert Wilders (PVV)",0.909573057544418,0.513783269961977,0
"<anonymized_userid>",1,51451,5406,"Geert Wilders (PVV)",0.909590736321047,0.513878326996198,0
"<anonymized_userid>",1,51452,5407,"Geert Wilders (PVV)",0.909608415097675,0.513973384030418,0
"<anonymized_userid>",1,51453,5408,"Geert Wilders (PVV)",0.909626093874304,0.514068441064639,0
"<anonymized_userid>",1,51454,5409,"Geert Wilders (PVV)",0.909643772650933,0.514163498098859,0
"<anonymized_userid>",1,51455,5410,"Geert Wilders (PVV)",0.909661451427561,0.51425855513308,0
"<anonymized_userid>",1,51456,5411,"Geert Wilders (PVV)",0.90967913020419,0.5143536121673,0
"<anonymized_userid>",1,51457,5412,"Geert Wilders (PVV)",0.909696808980819,0.514448669201521,0
"<anonymized_userid>",1,51458,5413,"Geert Wilders (PVV)",0.909714487757447,0.514543726235741,0
"<anonymized_userid>",1,51459,5414,"Geert Wilders (PVV)",0.909732166534076,0.514638783269962,0
"<anonymized_userid>",1,51460,5415,"Geert Wilders (PVV)",0.909749845310704,0.514733840304182,0
"<anonymized_userid>",1,51461,5416,"Geert Wilders (PVV)",0.909767524087333,0.514828897338403,0
"<anonymized_userid>",1,51462,5417,"Geert Wilders (PVV)",0.909785202863962,0.514923954372624,0
"<anonymized_userid>",1,51463,5418,"Geert Wilders (PVV)",0.90980288164059,0.515019011406844,0
"<anonymized_userid>",1,51464,5419,"Geert Wilders (PVV)",0.909820560417219,0.515114068441065,0
"<anonymized_userid>",1,51465,5420,"Geert Wilders (PVV)",0.909838239193848,0.515209125475285,0
"<anonymized_userid>",1,51466,5421,"Geert Wilders (PVV)",0.909855917970476,0.515304182509506,0
"<anonymized_userid>",1,51467,5422,"Geert Wilders (PVV)",0.909873596747105,0.515399239543726,0
"<anonymized_userid>",1,51468,5423,"Geert Wilders (PVV)",0.909891275523734,0.515494296577947,0
"<anonymized_userid>",1,51469,5424,"Geert Wilders (PVV)",0.909908954300362,0.515589353612167,0
"<anonymized_userid>",1,51470,5425,"Geert Wilders (PVV)",0.909926633076991,0.515684410646388,0
"<anonymized_userid>",1,51471,5426,"Geert Wilders (PVV)",0.90994431185362,0.515779467680608,0
"<anonymized_userid>",1,51472,5427,"Geert Wilders (PVV)",0.909961990630248,0.515874524714829,0
"<anonymized_userid>",1,51473,5428,"Geert Wilders (PVV)",0.909979669406877,0.515969581749049,0
"<anonymized_userid>",1,51474,5429,"Geert Wilders (PVV)",0.909997348183506,0.51606463878327,0
"<anonymized_userid>",1,51475,5430,"Geert Wilders (PVV)",0.910015026960134,0.516159695817491,0
"<anonymized_userid>",1,51476,5431,"Geert Wilders (PVV)",0.910032705736763,0.516254752851711,0
"<anonymized_userid>",1,51477,5432,"Geert Wilders (PVV)",0.910050384513392,0.516349809885932,0
"<anonymized_userid>",1,51478,5433,"Geert Wilders (PVV)",0.91006806329002,0.516444866920152,0
"<anonymized_userid>",1,51479,5434,"Geert Wilders (PVV)",0.910085742066649,0.516539923954373,0
"<anonymized_userid>",1,51480,5435,"Geert Wilders (PVV)",0.910103420843278,0.516634980988593,0
"<anonymized_userid>",1,51481,5436,"Geert Wilders (PVV)",0.910121099619906,0.516730038022814,0
"<anonymized_userid>",1,51482,5437,"Geert Wilders (PVV)",0.910138778396535,0.516825095057034,0
"<anonymized_userid>",1,51483,5438,"Geert Wilders (PVV)",0.910156457173164,0.516920152091255,0
"<anonymized_userid>",1,51484,5439,"Geert Wilders (PVV)",0.910174135949792,0.517015209125475,0
"<anonymized_userid>",1,51485,5440,"Geert Wilders (PVV)",0.910191814726421,0.517110266159696,0
"<anonymized_userid>",1,51486,5441,"Geert Wilders (PVV)",0.91020949350305,0.517205323193916,0
"<anonymized_userid>",1,51487,5442,"Geert Wilders (PVV)",0.910227172279678,0.517300380228137,0
"<anonymized_userid>",1,51488,5443,"Geert Wilders (PVV)",0.910244851056307,0.517395437262357,0
"<anonymized_userid>",1,51489,5444,"Geert Wilders (PVV)",0.910262529832936,0.517490494296578,0
"<anonymized_userid>",1,51490,5445,"Geert Wilders (PVV)",0.910280208609564,0.517585551330799,0
"<anonymized_userid>",1,51491,5446,"Geert Wilders (PVV)",0.910297887386193,0.517680608365019,0
"<anonymized_userid>",1,51492,5447,"Geert Wilders (PVV)",0.910315566162821,0.51777566539924,0
"<anonymized_userid>",1,51493,5448,"Geert Wilders (PVV)",0.91033324493945,0.51787072243346,0
"<anonymized_userid>",1,51494,5449,"Geert Wilders (PVV)",0.910350923716079,0.517965779467681,0
"<anonymized_userid>",1,51495,5450,"Geert Wilders (PVV)",0.910368602492707,0.518060836501901,0
"<anonymized_userid>",1,51496,5451,"Geert Wilders (PVV)",0.910386281269336,0.518155893536122,0
"<anonymized_userid>",1,51497,5452,"Geert Wilders (PVV)",0.910403960045965,0.518250950570342,0
"<anonymized_userid>",1,51498,5453,"Geert Wilders (PVV)",0.910421638822594,0.518346007604563,0
"<anonymized_userid>",1,51499,5454,"Geert Wilders (PVV)",0.910439317599222,0.518441064638783,0
"<anonymized_userid>",1,51500,5455,"Geert Wilders (PVV)",0.910456996375851,0.518536121673004,0
"<anonymized_userid>",1,51501,5456,"Geert Wilders (PVV)",0.910474675152479,0.518631178707224,0
"<anonymized_userid>",1,51502,5457,"Geert Wilders (PVV)",0.910492353929108,0.518726235741445,0
"<anonymized_userid>",1,51503,5458,"Geert Wilders (PVV)",0.910510032705737,0.518821292775665,0
"<anonymized_userid>",1,51504,5459,"Geert Wilders (PVV)",0.910527711482365,0.518916349809886,0
"<anonymized_userid>",1,51505,5460,"Geert Wilders (PVV)",0.910545390258994,0.519011406844107,0
"<anonymized_userid>",1,51506,5461,"Geert Wilders (PVV)",0.910563069035623,0.519106463878327,0
"<anonymized_userid>",1,51507,5462,"Geert Wilders (PVV)",0.910580747812251,0.519201520912548,0
"<anonymized_userid>",1,51508,5463,"Geert Wilders (PVV)",0.91059842658888,0.519296577946768,0
"<anonymized_userid>",1,51509,5464,"Geert Wilders (PVV)",0.910616105365509,0.519391634980989,0
"<anonymized_userid>",1,51510,5465,"Geert Wilders (PVV)",0.910633784142137,0.519486692015209,0
"<anonymized_userid>",1,51511,5466,"Geert Wilders (PVV)",0.910651462918766,0.51958174904943,0
"<anonymized_userid>",1,51512,5467,"Geert Wilders (PVV)",0.910669141695395,0.51967680608365,0
"<anonymized_userid>",1,51513,5468,"Geert Wilders (PVV)",0.910686820472023,0.519771863117871,0
"<anonymized_userid>",1,51514,5469,"Geert Wilders (PVV)",0.910704499248652,0.519866920152091,0
"<anonymized_userid>",1,51515,5470,"Geert Wilders (PVV)",0.910722178025281,0.519961977186312,0
"<anonymized_userid>",1,51516,5471,"Geert Wilders (PVV)",0.910739856801909,0.520057034220532,0
"<anonymized_userid>",1,51517,5472,"Geert Wilders (PVV)",0.910757535578538,0.520152091254753,0
"<anonymized_userid>",1,51518,5473,"Geert Wilders (PVV)",0.910775214355167,0.520247148288973,0
"<anonymized_userid>",1,51519,5474,"Geert Wilders (PVV)",0.910792893131795,0.520342205323194,0
"<anonymized_userid>",1,51520,5475,"Geert Wilders (PVV)",0.910810571908424,0.520437262357414,0
"<anonymized_userid>",1,51521,5476,"Geert Wilders (PVV)",0.910828250685053,0.520532319391635,0
"<anonymized_userid>",1,51522,5477,"Geert Wilders (PVV)",0.910845929461681,0.520627376425856,0
"<anonymized_userid>",1,51523,5478,"Geert Wilders (PVV)",0.91086360823831,0.520722433460076,0
"<anonymized_userid>",1,51524,5479,"Geert Wilders (PVV)",0.910881287014939,0.520817490494297,0
"<anonymized_userid>",1,51525,5480,"Geert Wilders (PVV)",0.910898965791567,0.520912547528517,0
"<anonymized_userid>",1,51526,5481,"Geert Wilders (PVV)",0.910916644568196,0.521007604562738,0
"<anonymized_userid>",1,51527,5482,"Geert Wilders (PVV)",0.910934323344824,0.521102661596958,0
"<anonymized_userid>",1,51528,5483,"Geert Wilders (PVV)",0.910952002121453,0.521197718631179,0
"<anonymized_userid>",1,51529,5484,"Geert Wilders (PVV)",0.910969680898082,0.521292775665399,0
"<anonymized_userid>",1,51530,5485,"Geert Wilders (PVV)",0.910987359674711,0.52138783269962,0
"<anonymized_userid>",1,51531,5486,"Geert Wilders (PVV)",0.911005038451339,0.52148288973384,0
"<anonymized_userid>",1,51532,5487,"Geert Wilders (PVV)",0.911022717227968,0.521577946768061,0
"<anonymized_userid>",1,51533,5488,"Geert Wilders (PVV)",0.911040396004597,0.521673003802281,0
"<anonymized_userid>",1,51534,5489,"Geert Wilders (PVV)",0.911058074781225,0.521768060836502,0
"<anonymized_userid>",1,51535,5490,"Geert Wilders (PVV)",0.911075753557854,0.521863117870722,0
"<anonymized_userid>",1,51536,5491,"Geert Wilders (PVV)",0.911093432334482,0.521958174904943,0
"<anonymized_userid>",1,51537,5492,"Geert Wilders (PVV)",0.911111111111111,0.522053231939164,0
"<anonymized_userid>",1,51538,5493,"Geert Wilders (PVV)",0.91112878988774,0.522148288973384,0
"<anonymized_userid>",1,51539,5494,"Geert Wilders (PVV)",0.911146468664368,0.522243346007605,0
"<anonymized_userid>",1,51540,5495,"Geert Wilders (PVV)",0.911164147440997,0.522338403041825,0
"<anonymized_userid>",1,51541,5496,"Geert Wilders (PVV)",0.911181826217626,0.522433460076046,0
"<anonymized_userid>",1,51542,5497,"Geert Wilders (PVV)",0.911199504994254,0.522528517110266,0
"<anonymized_userid>",1,51543,5498,"Geert Wilders (PVV)",0.911217183770883,0.522623574144487,0
"<anonymized_userid>",1,51544,5499,"Geert Wilders (PVV)",0.911234862547512,0.522718631178707,0
"<anonymized_userid>",1,51545,5500,"Geert Wilders (PVV)",0.91125254132414,0.522813688212928,0
"<anonymized_userid>",1,51546,5501,"Geert Wilders (PVV)",0.911270220100769,0.522908745247148,0
"<anonymized_userid>",1,51547,5502,"Geert Wilders (PVV)",0.911287898877398,0.523003802281369,0
"<anonymized_userid>",1,51548,5503,"Geert Wilders (PVV)",0.911305577654026,0.523098859315589,0
"<anonymized_userid>",1,51549,5504,"Geert Wilders (PVV)",0.911323256430655,0.52319391634981,0
"<anonymized_userid>",1,51550,5505,"Geert Wilders (PVV)",0.911340935207284,0.52328897338403,0
"<anonymized_userid>",1,51551,5506,"Geert Wilders (PVV)",0.911358613983912,0.523384030418251,0
"<anonymized_userid>",1,51552,5507,"Geert Wilders (PVV)",0.911376292760541,0.523479087452472,0
"<anonymized_userid>",1,51553,5508,"Geert Wilders (PVV)",0.91139397153717,0.523574144486692,0
"<anonymized_userid>",1,51554,5509,"Geert Wilders (PVV)",0.911411650313798,0.523669201520913,0
"<anonymized_userid>",1,51555,5510,"Geert Wilders (PVV)",0.911429329090427,0.523764258555133,0
"<anonymized_userid>",1,51556,5511,"Geert Wilders (PVV)",0.911447007867056,0.523859315589354,0
"<anonymized_userid>",1,51557,5512,"Geert Wilders (PVV)",0.911464686643684,0.523954372623574,0
"<anonymized_userid>",1,51558,5513,"Geert Wilders (PVV)",0.911482365420313,0.524049429657795,0
"<anonymized_userid>",1,51559,5514,"Geert Wilders (PVV)",0.911500044196942,0.524144486692015,0
"<anonymized_userid>",1,51560,5515,"Geert Wilders (PVV)",0.91151772297357,0.524239543726236,0
"<anonymized_userid>",1,51561,5516,"Geert Wilders (PVV)",0.911535401750199,0.524334600760456,0
"<anonymized_userid>",1,51562,5517,"Geert Wilders (PVV)",0.911553080526828,0.524429657794677,0
"<anonymized_userid>",1,51563,5518,"Geert Wilders (PVV)",0.911570759303456,0.524524714828897,0
"<anonymized_userid>",1,51564,5519,"Geert Wilders (PVV)",0.911588438080085,0.524619771863118,0
"<anonymized_userid>",1,51565,5520,"Geert Wilders (PVV)",0.911606116856714,0.524714828897338,0
"<anonymized_userid>",1,51566,5521,"Geert Wilders (PVV)",0.911623795633342,0.524809885931559,0
"<anonymized_userid>",1,51567,5522,"Geert Wilders (PVV)",0.911641474409971,0.524904942965779,0
"<anonymized_userid>",1,51568,5523,"Geert Wilders (PVV)",0.9116591531866,0.525,0
"<anonymized_userid>",1,51569,5524,"Geert Wilders (PVV)",0.911676831963228,0.525095057034221,0
"<anonymized_userid>",1,51570,5525,"Geert Wilders (PVV)",0.911694510739857,0.525190114068441,0
"<anonymized_userid>",1,51571,5526,"Geert Wilders (PVV)",0.911712189516485,0.525285171102662,0
"<anonymized_userid>",1,51572,5527,"Geert Wilders (PVV)",0.911729868293114,0.525380228136882,0
"<anonymized_userid>",1,51573,5528,"Geert Wilders (PVV)",0.911747547069743,0.525475285171103,0
"<anonymized_userid>",1,51574,5529,"Geert Wilders (PVV)",0.911765225846371,0.525570342205323,0
"<anonymized_userid>",1,51575,5530,"Geert Wilders (PVV)",0.911782904623,0.525665399239544,0
"<anonymized_userid>",1,51576,5531,"Geert Wilders (PVV)",0.911800583399629,0.525760456273764,0
"<anonymized_userid>",1,51577,5532,"Geert Wilders (PVV)",0.911818262176257,0.525855513307985,0
"<anonymized_userid>",1,51578,5533,"Geert Wilders (PVV)",0.911835940952886,0.525950570342205,0
"<anonymized_userid>",1,51579,5534,"Geert Wilders (PVV)",0.911853619729515,0.526045627376426,0
"<anonymized_userid>",1,51580,5535,"Geert Wilders (PVV)",0.911871298506143,0.526140684410646,0
"<anonymized_userid>",1,51581,5536,"Geert Wilders (PVV)",0.911888977282772,0.526235741444867,0
"<anonymized_userid>",1,51582,5537,"Geert Wilders (PVV)",0.911906656059401,0.526330798479087,0
"<anonymized_userid>",1,51583,5538,"Geert Wilders (PVV)",0.911924334836029,0.526425855513308,0
"<anonymized_userid>",1,51584,5539,"Geert Wilders (PVV)",0.911942013612658,0.526520912547529,0
"<anonymized_userid>",1,51585,5540,"Geert Wilders (PVV)",0.911959692389287,0.526615969581749,0
"<anonymized_userid>",1,51586,5541,"Geert Wilders (PVV)",0.911977371165915,0.52671102661597,0
"<anonymized_userid>",1,51587,5542,"Geert Wilders (PVV)",0.911995049942544,0.52680608365019,0
"<anonymized_userid>",1,51588,5543,"Geert Wilders (PVV)",0.912012728719173,0.526901140684411,0
"<anonymized_userid>",1,51589,5544,"Geert Wilders (PVV)",0.912030407495801,0.526996197718631,0
"<anonymized_userid>",1,51590,5545,"Geert Wilders (PVV)",0.91204808627243,0.527091254752852,0
"<anonymized_userid>",1,51591,5546,"Geert Wilders (PVV)",0.912065765049059,0.527186311787072,0
"<anonymized_userid>",1,51592,5547,"Geert Wilders (PVV)",0.912083443825687,0.527281368821293,0
"<anonymized_userid>",1,51593,5548,"Geert Wilders (PVV)",0.912101122602316,0.527376425855513,0
"<anonymized_userid>",1,51594,5549,"Geert Wilders (PVV)",0.912118801378945,0.527471482889734,0
"<anonymized_userid>",1,51595,5550,"Geert Wilders (PVV)",0.912136480155573,0.527566539923954,0
"<anonymized_userid>",1,51596,5551,"Geert Wilders (PVV)",0.912154158932202,0.527661596958175,0
"<anonymized_userid>",1,51597,5552,"Geert Wilders (PVV)",0.912171837708831,0.527756653992395,0
"<anonymized_userid>",1,51598,5553,"Geert Wilders (PVV)",0.912189516485459,0.527851711026616,0
"<anonymized_userid>",1,51599,5554,"Geert Wilders (PVV)",0.912207195262088,0.527946768060837,0
"<anonymized_userid>",1,51600,5555,"Geert Wilders (PVV)",0.912224874038717,0.528041825095057,0
"<anonymized_userid>",1,51601,5556,"Geert Wilders (PVV)",0.912242552815345,0.528136882129278,0
"<anonymized_userid>",1,51602,5557,"Geert Wilders (PVV)",0.912260231591974,0.528231939163498,0
"<anonymized_userid>",1,51603,5558,"Geert Wilders (PVV)",0.912277910368603,0.528326996197719,0
"<anonymized_userid>",1,51604,5559,"Geert Wilders (PVV)",0.912295589145231,0.528422053231939,0
"<anonymized_userid>",1,51605,5560,"Geert Wilders (PVV)",0.91231326792186,0.52851711026616,0
"<anonymized_userid>",1,51606,5561,"Geert Wilders (PVV)",0.912330946698488,0.52861216730038,0
"<anonymized_userid>",1,51607,5562,"Geert Wilders (PVV)",0.912348625475117,0.528707224334601,0
"<anonymized_userid>",1,51608,5563,"Geert Wilders (PVV)",0.912366304251746,0.528802281368821,0
"<anonymized_userid>",1,51609,5564,"Geert Wilders (PVV)",0.912383983028374,0.528897338403042,0
"<anonymized_userid>",1,51610,5565,"Geert Wilders (PVV)",0.912401661805003,0.528992395437262,0
"<anonymized_userid>",1,51611,5566,"Geert Wilders (PVV)",0.912419340581632,0.529087452471483,0
"<anonymized_userid>",1,51612,5567,"Geert Wilders (PVV)",0.91243701935826,0.529182509505703,0
"<anonymized_userid>",1,51613,5568,"Geert Wilders (PVV)",0.912454698134889,0.529277566539924,0
"<anonymized_userid>",1,51614,5569,"Geert Wilders (PVV)",0.912472376911518,0.529372623574144,0
"<anonymized_userid>",1,51615,5570,"Geert Wilders (PVV)",0.912490055688146,0.529467680608365,0
"<anonymized_userid>",1,51616,5571,"Geert Wilders (PVV)",0.912507734464775,0.529562737642586,0
"<anonymized_userid>",1,51617,5572,"Geert Wilders (PVV)",0.912525413241404,0.529657794676806,0
"<anonymized_userid>",1,51618,5573,"Geert Wilders (PVV)",0.912543092018032,0.529752851711027,0
"<anonymized_userid>",1,51619,5574,"Geert Wilders (PVV)",0.912560770794661,0.529847908745247,0
"<anonymized_userid>",1,51620,5575,"Geert Wilders (PVV)",0.91257844957129,0.529942965779468,0
"<anonymized_userid>",1,51621,5576,"Geert Wilders (PVV)",0.912596128347918,0.530038022813688,0
"<anonymized_userid>",1,51622,5577,"Geert Wilders (PVV)",0.912613807124547,0.530133079847909,0
"<anonymized_userid>",1,51623,5578,"Geert Wilders (PVV)",0.912631485901176,0.530228136882129,0
"<anonymized_userid>",1,51624,5579,"Geert Wilders (PVV)",0.912649164677804,0.53032319391635,0
"<anonymized_userid>",1,51625,5580,"Geert Wilders (PVV)",0.912666843454433,0.53041825095057,0
"<anonymized_userid>",1,51626,5581,"Geert Wilders (PVV)",0.912684522231062,0.530513307984791,0
"<anonymized_userid>",1,51627,5582,"Geert Wilders (PVV)",0.91270220100769,0.530608365019011,0
"<anonymized_userid>",1,51628,5583,"Geert Wilders (PVV)",0.912719879784319,0.530703422053232,0
"<anonymized_userid>",1,51629,5584,"Geert Wilders (PVV)",0.912737558560948,0.530798479087452,0
"<anonymized_userid>",1,51630,5585,"Geert Wilders (PVV)",0.912755237337576,0.530893536121673,0
"<anonymized_userid>",1,51631,5586,"Geert Wilders (PVV)",0.912772916114205,0.530988593155894,0
"<anonymized_userid>",1,51632,5587,"Geert Wilders (PVV)",0.912790594890834,0.531083650190114,0
"<anonymized_userid>",1,51633,5588,"Geert Wilders (PVV)",0.912808273667462,0.531178707224335,0
"<anonymized_userid>",1,51634,5589,"Geert Wilders (PVV)",0.912825952444091,0.531273764258555,0
"<anonymized_userid>",1,51635,5590,"Geert Wilders (PVV)",0.91284363122072,0.531368821292776,0
"<anonymized_userid>",1,51636,5591,"Geert Wilders (PVV)",0.912861309997348,0.531463878326996,0
"<anonymized_userid>",1,51637,5592,"Geert Wilders (PVV)",0.912878988773977,0.531558935361217,0
"<anonymized_userid>",1,51638,5593,"Geert Wilders (PVV)",0.912896667550606,0.531653992395437,0
"<anonymized_userid>",1,51639,5594,"Geert Wilders (PVV)",0.912914346327234,0.531749049429658,0
"<anonymized_userid>",1,51640,5595,"Geert Wilders (PVV)",0.912932025103863,0.531844106463878,0
"<anonymized_userid>",1,51641,5596,"Geert Wilders (PVV)",0.912949703880491,0.531939163498099,0
"<anonymized_userid>",1,51642,5597,"Geert Wilders (PVV)",0.91296738265712,0.532034220532319,0
"<anonymized_userid>",1,51643,5598,"Geert Wilders (PVV)",0.912985061433749,0.53212927756654,0
"<anonymized_userid>",1,51644,5599,"Geert Wilders (PVV)",0.913002740210377,0.53222433460076,0
"<anonymized_userid>",1,51645,5600,"Geert Wilders (PVV)",0.913020418987006,0.532319391634981,0
"<anonymized_userid>",1,51646,5601,"Geert Wilders (PVV)",0.913038097763635,0.532414448669202,0
"<anonymized_userid>",1,51647,5602,"Geert Wilders (PVV)",0.913055776540263,0.532509505703422,0
"<anonymized_userid>",1,51648,5603,"Geert Wilders (PVV)",0.913073455316892,0.532604562737643,0
"<anonymized_userid>",1,51649,5604,"Geert Wilders (PVV)",0.913091134093521,0.532699619771863,0
"<anonymized_userid>",1,51650,5605,"Geert Wilders (PVV)",0.913108812870149,0.532794676806084,0
"<anonymized_userid>",1,51651,5606,"Geert Wilders (PVV)",0.913126491646778,0.532889733840304,0
"<anonymized_userid>",1,51652,5607,"Geert Wilders (PVV)",0.913144170423407,0.532984790874525,0
"<anonymized_userid>",1,51653,5608,"Geert Wilders (PVV)",0.913161849200035,0.533079847908745,0
"<anonymized_userid>",1,51654,5609,"Geert Wilders (PVV)",0.913179527976664,0.533174904942966,0
"<anonymized_userid>",1,51655,5610,"Geert Wilders (PVV)",0.913197206753293,0.533269961977186,0
"<anonymized_userid>",1,51656,5611,"Geert Wilders (PVV)",0.913214885529921,0.533365019011407,0
"<anonymized_userid>",1,51657,5612,"Geert Wilders (PVV)",0.91323256430655,0.533460076045627,0
"<anonymized_userid>",1,51658,5613,"Geert Wilders (PVV)",0.913250243083179,0.533555133079848,0
"<anonymized_userid>",1,51659,5614,"Geert Wilders (PVV)",0.913267921859807,0.533650190114068,0
"<anonymized_userid>",1,51660,5615,"Geert Wilders (PVV)",0.913285600636436,0.533745247148289,0
"<anonymized_userid>",1,51661,5616,"Geert Wilders (PVV)",0.913303279413065,0.533840304182509,0
"<anonymized_userid>",1,51662,5617,"Geert Wilders (PVV)",0.913320958189693,0.53393536121673,0
"<anonymized_userid>",1,51663,5618,"Geert Wilders (PVV)",0.913338636966322,0.534030418250951,0
"<anonymized_userid>",1,51664,5619,"Geert Wilders (PVV)",0.913356315742951,0.534125475285171,0
"<anonymized_userid>",1,51665,5620,"Geert Wilders (PVV)",0.913373994519579,0.534220532319392,0
"<anonymized_userid>",1,51666,5621,"Geert Wilders (PVV)",0.913391673296208,0.534315589353612,0
"<anonymized_userid>",1,51667,5622,"Geert Wilders (PVV)",0.913409352072837,0.534410646387833,0
"<anonymized_userid>",1,51668,5623,"Geert Wilders (PVV)",0.913427030849465,0.534505703422053,0
"<anonymized_userid>",1,51669,5624,"Geert Wilders (PVV)",0.913444709626094,0.534600760456274,0
"<anonymized_userid>",1,51670,5625,"Geert Wilders (PVV)",0.913462388402723,0.534695817490494,0
"<anonymized_userid>",1,51671,5626,"Geert Wilders (PVV)",0.913480067179351,0.534790874524715,0
"<anonymized_userid>",1,51672,5627,"Geert Wilders (PVV)",0.91349774595598,0.534885931558935,0
"<anonymized_userid>",1,51673,5628,"Geert Wilders (PVV)",0.913515424732608,0.534980988593156,0
"<anonymized_userid>",1,51674,5629,"Geert Wilders (PVV)",0.913533103509237,0.535076045627376,0
"<anonymized_userid>",1,51675,5630,"Geert Wilders (PVV)",0.913550782285866,0.535171102661597,0
"<anonymized_userid>",1,51676,5631,"Geert Wilders (PVV)",0.913568461062494,0.535266159695817,0
"<anonymized_userid>",1,51677,5632,"Geert Wilders (PVV)",0.913586139839123,0.535361216730038,0
"<anonymized_userid>",1,51678,5633,"Geert Wilders (PVV)",0.913603818615752,0.535456273764259,0
"<anonymized_userid>",1,51679,5634,"Geert Wilders (PVV)",0.91362149739238,0.535551330798479,0
"<anonymized_userid>",1,51680,5635,"Geert Wilders (PVV)",0.913639176169009,0.5356463878327,0
"<anonymized_userid>",1,51681,5636,"Geert Wilders (PVV)",0.913656854945638,0.53574144486692,0
"<anonymized_userid>",1,51682,5637,"Geert Wilders (PVV)",0.913674533722266,0.535836501901141,0
"<anonymized_userid>",1,51683,5638,"Geert Wilders (PVV)",0.913692212498895,0.535931558935361,0
"<anonymized_userid>",1,51684,5639,"Geert Wilders (PVV)",0.913709891275524,0.536026615969582,0
"<anonymized_userid>",1,51685,5640,"Geert Wilders (PVV)",0.913727570052152,0.536121673003802,0
"<anonymized_userid>",1,51686,5641,"Geert Wilders (PVV)",0.913745248828781,0.536216730038023,0
"<anonymized_userid>",1,51687,5642,"Geert Wilders (PVV)",0.91376292760541,0.536311787072243,0
"<anonymized_userid>",1,51688,5643,"Geert Wilders (PVV)",0.913780606382038,0.536406844106464,0
"<anonymized_userid>",1,51689,5644,"Geert Wilders (PVV)",0.913798285158667,0.536501901140684,0
"<anonymized_userid>",1,51690,5645,"Geert Wilders (PVV)",0.913815963935296,0.536596958174905,0
"<anonymized_userid>",1,51691,5646,"Geert Wilders (PVV)",0.913833642711924,0.536692015209125,0
"<anonymized_userid>",1,51692,5647,"Geert Wilders (PVV)",0.913851321488553,0.536787072243346,0
"<anonymized_userid>",1,51693,5648,"Geert Wilders (PVV)",0.913869000265182,0.536882129277567,0
"<anonymized_userid>",1,51694,5649,"Geert Wilders (PVV)",0.91388667904181,0.536977186311787,0
"<anonymized_userid>",1,51695,5650,"Geert Wilders (PVV)",0.913904357818439,0.537072243346008,0
"<anonymized_userid>",1,51696,5651,"Geert Wilders (PVV)",0.913922036595068,0.537167300380228,0
"<anonymized_userid>",1,51697,5652,"Geert Wilders (PVV)",0.913939715371696,0.537262357414449,0
"<anonymized_userid>",1,51698,5653,"Geert Wilders (PVV)",0.913957394148325,0.537357414448669,0
"<anonymized_userid>",1,51699,5654,"Geert Wilders (PVV)",0.913975072924954,0.53745247148289,0
"<anonymized_userid>",1,51700,5655,"Geert Wilders (PVV)",0.913992751701582,0.53754752851711,0
"<anonymized_userid>",1,51701,5656,"Geert Wilders (PVV)",0.914010430478211,0.537642585551331,0
"<anonymized_userid>",1,51702,5657,"Geert Wilders (PVV)",0.91402810925484,0.537737642585551,0
"<anonymized_userid>",1,51703,5658,"Geert Wilders (PVV)",0.914045788031468,0.537832699619772,0
"<anonymized_userid>",1,51704,5659,"Geert Wilders (PVV)",0.914063466808097,0.537927756653992,0
"<anonymized_userid>",1,51705,5660,"Geert Wilders (PVV)",0.914081145584726,0.538022813688213,0
"<anonymized_userid>",1,51706,5661,"Geert Wilders (PVV)",0.914098824361354,0.538117870722433,0
"<anonymized_userid>",1,51707,5662,"Geert Wilders (PVV)",0.914116503137983,0.538212927756654,0
"<anonymized_userid>",1,51708,5663,"Geert Wilders (PVV)",0.914134181914611,0.538307984790874,0
"<anonymized_userid>",1,51709,5664,"Geert Wilders (PVV)",0.91415186069124,0.538403041825095,0
"<anonymized_userid>",1,51710,5665,"Geert Wilders (PVV)",0.914169539467869,0.538498098859316,0
"<anonymized_userid>",1,51711,5666,"Geert Wilders (PVV)",0.914187218244497,0.538593155893536,0
"<anonymized_userid>",1,51712,5667,"Geert Wilders (PVV)",0.914204897021126,0.538688212927757,0
"<anonymized_userid>",1,51713,5668,"Geert Wilders (PVV)",0.914222575797755,0.538783269961977,0
"<anonymized_userid>",1,51714,5669,"Geert Wilders (PVV)",0.914240254574383,0.538878326996198,0
"<anonymized_userid>",1,51715,5670,"Geert Wilders (PVV)",0.914257933351012,0.538973384030418,0
"<anonymized_userid>",1,51716,5671,"Geert Wilders (PVV)",0.914275612127641,0.539068441064639,0
"<anonymized_userid>",1,51717,5672,"Geert Wilders (PVV)",0.914293290904269,0.539163498098859,0
"<anonymized_userid>",1,51718,5673,"Geert Wilders (PVV)",0.914310969680898,0.53925855513308,0
"<anonymized_userid>",1,51719,5674,"Geert Wilders (PVV)",0.914328648457527,0.5393536121673,0
"<anonymized_userid>",1,51720,5675,"Geert Wilders (PVV)",0.914346327234155,0.539448669201521,0
"<anonymized_userid>",1,51721,5676,"Geert Wilders (PVV)",0.914364006010784,0.539543726235741,0
"<anonymized_userid>",1,51722,5677,"Geert Wilders (PVV)",0.914381684787413,0.539638783269962,0
"<anonymized_userid>",1,51723,5678,"Geert Wilders (PVV)",0.914399363564041,0.539733840304182,0
"<anonymized_userid>",1,51724,5679,"Geert Wilders (PVV)",0.91441704234067,0.539828897338403,0
"<anonymized_userid>",1,51725,5680,"Geert Wilders (PVV)",0.914434721117299,0.539923954372624,0
"<anonymized_userid>",1,51726,5681,"Geert Wilders (PVV)",0.914452399893927,0.540019011406844,0
"<anonymized_userid>",1,51727,5682,"Geert Wilders (PVV)",0.914470078670556,0.540114068441065,0
"<anonymized_userid>",1,51728,5683,"Geert Wilders (PVV)",0.914487757447185,0.540209125475285,0
"<anonymized_userid>",1,51729,5684,"Geert Wilders (PVV)",0.914505436223813,0.540304182509506,0
"<anonymized_userid>",1,51730,5685,"Geert Wilders (PVV)",0.914523115000442,0.540399239543726,0
"<anonymized_userid>",1,51731,5686,"Geert Wilders (PVV)",0.914540793777071,0.540494296577947,0
"<anonymized_userid>",1,51732,5687,"Geert Wilders (PVV)",0.914558472553699,0.540589353612167,0
"<anonymized_userid>",1,51733,5688,"Geert Wilders (PVV)",0.914576151330328,0.540684410646388,0
"<anonymized_userid>",1,51734,5689,"Geert Wilders (PVV)",0.914593830106957,0.540779467680608,0
"<anonymized_userid>",1,51735,5690,"Geert Wilders (PVV)",0.914611508883585,0.540874524714829,0
"<anonymized_userid>",1,51736,5691,"Geert Wilders (PVV)",0.914629187660214,0.540969581749049,0
"<anonymized_userid>",1,51737,5692,"Geert Wilders (PVV)",0.914646866436843,0.54106463878327,0
"<anonymized_userid>",1,51738,5693,"Geert Wilders (PVV)",0.914664545213471,0.54115969581749,0
"<anonymized_userid>",1,51739,5694,"Geert Wilders (PVV)",0.9146822239901,0.541254752851711,0
"<anonymized_userid>",1,51740,5695,"Geert Wilders (PVV)",0.914699902766729,0.541349809885932,0
"<anonymized_userid>",1,51741,5696,"Geert Wilders (PVV)",0.914717581543357,0.541444866920152,0
"<anonymized_userid>",1,51742,5697,"Geert Wilders (PVV)",0.914735260319986,0.541539923954373,0
"<anonymized_userid>",1,51743,5698,"Geert Wilders (PVV)",0.914752939096614,0.541634980988593,0
"<anonymized_userid>",1,51744,5699,"Geert Wilders (PVV)",0.914770617873243,0.541730038022814,0
"<anonymized_userid>",1,51745,5700,"Geert Wilders (PVV)",0.914788296649872,0.541825095057034,0
"<anonymized_userid>",1,51746,5701,"Geert Wilders (PVV)",0.9148059754265,0.541920152091255,0
"<anonymized_userid>",1,51747,5702,"Geert Wilders (PVV)",0.914823654203129,0.542015209125475,0
"<anonymized_userid>",1,51748,5703,"Geert Wilders (PVV)",0.914841332979758,0.542110266159696,0
"<anonymized_userid>",1,51749,5704,"Geert Wilders (PVV)",0.914859011756387,0.542205323193916,0
"<anonymized_userid>",1,51750,5705,"Geert Wilders (PVV)",0.914876690533015,0.542300380228137,0
"<anonymized_userid>",1,51751,5706,"Geert Wilders (PVV)",0.914894369309644,0.542395437262357,0
"<anonymized_userid>",1,51752,5707,"Geert Wilders (PVV)",0.914912048086272,0.542490494296578,0
"<anonymized_userid>",1,51753,5708,"Geert Wilders (PVV)",0.914929726862901,0.542585551330798,0
"<anonymized_userid>",1,51754,5709,"Geert Wilders (PVV)",0.91494740563953,0.542680608365019,0
"<anonymized_userid>",1,51755,5710,"Geert Wilders (PVV)",0.914965084416158,0.542775665399239,0
"<anonymized_userid>",1,51756,5711,"Geert Wilders (PVV)",0.914982763192787,0.54287072243346,0
"<anonymized_userid>",1,51757,5712,"Geert Wilders (PVV)",0.915000441969416,0.542965779467681,0
"<anonymized_userid>",1,51758,5713,"Geert Wilders (PVV)",0.915018120746044,0.543060836501901,0
"<anonymized_userid>",1,51759,5714,"Geert Wilders (PVV)",0.915035799522673,0.543155893536122,0
"<anonymized_userid>",1,51760,5715,"Geert Wilders (PVV)",0.915053478299302,0.543250950570342,0
"<anonymized_userid>",1,51761,5716,"Geert Wilders (PVV)",0.91507115707593,0.543346007604563,0
"<anonymized_userid>",1,51762,5717,"Geert Wilders (PVV)",0.915088835852559,0.543441064638783,0
"<anonymized_userid>",1,51763,5718,"Geert Wilders (PVV)",0.915106514629188,0.543536121673004,0
"<anonymized_userid>",1,51764,5719,"Geert Wilders (PVV)",0.915124193405816,0.543631178707224,0
"<anonymized_userid>",1,51765,5720,"Geert Wilders (PVV)",0.915141872182445,0.543726235741445,0
"<anonymized_userid>",1,51766,5721,"Geert Wilders (PVV)",0.915159550959074,0.543821292775665,0
"<anonymized_userid>",1,51767,5722,"Geert Wilders (PVV)",0.915177229735702,0.543916349809886,0
"<anonymized_userid>",1,51768,5723,"Geert Wilders (PVV)",0.915194908512331,0.544011406844106,0
"<anonymized_userid>",1,51769,5724,"Geert Wilders (PVV)",0.91521258728896,0.544106463878327,0
"<anonymized_userid>",1,51770,5725,"Geert Wilders (PVV)",0.915230266065588,0.544201520912547,0
"<anonymized_userid>",1,51771,5726,"Geert Wilders (PVV)",0.915247944842217,0.544296577946768,0
"<anonymized_userid>",1,51772,5727,"Geert Wilders (PVV)",0.915265623618846,0.544391634980989,0
"<anonymized_userid>",1,51773,5728,"Geert Wilders (PVV)",0.915283302395474,0.544486692015209,0
"<anonymized_userid>",1,51774,5729,"Geert Wilders (PVV)",0.915300981172103,0.54458174904943,0
"<anonymized_userid>",1,51775,5730,"Geert Wilders (PVV)",0.915318659948732,0.54467680608365,0
"<anonymized_userid>",1,51776,5731,"Geert Wilders (PVV)",0.91533633872536,0.544771863117871,0
"<anonymized_userid>",1,51777,5732,"Geert Wilders (PVV)",0.915354017501989,0.544866920152091,0
"<anonymized_userid>",1,51778,5733,"Geert Wilders (PVV)",0.915371696278617,0.544961977186312,0
"<anonymized_userid>",1,51779,5734,"Geert Wilders (PVV)",0.915389375055246,0.545057034220532,0
"<anonymized_userid>",1,51780,5735,"Geert Wilders (PVV)",0.915407053831875,0.545152091254753,0
"<anonymized_userid>",1,51781,5736,"Geert Wilders (PVV)",0.915424732608504,0.545247148288973,0
"<anonymized_userid>",1,51782,5737,"Geert Wilders (PVV)",0.915442411385132,0.545342205323194,0
"<anonymized_userid>",1,51783,5738,"Geert Wilders (PVV)",0.915460090161761,0.545437262357414,0
"<anonymized_userid>",1,51784,5739,"Geert Wilders (PVV)",0.91547776893839,0.545532319391635,0
"<anonymized_userid>",1,51785,5740,"Geert Wilders (PVV)",0.915495447715018,0.545627376425855,0
"<anonymized_userid>",1,51786,5741,"Geert Wilders (PVV)",0.915513126491647,0.545722433460076,0
"<anonymized_userid>",1,51787,5742,"Geert Wilders (PVV)",0.915530805268275,0.545817490494297,0
"<anonymized_userid>",1,51788,5743,"Geert Wilders (PVV)",0.915548484044904,0.545912547528517,0
"<anonymized_userid>",1,51789,5744,"Geert Wilders (PVV)",0.915566162821533,0.546007604562738,0
"<anonymized_userid>",1,51790,5745,"Geert Wilders (PVV)",0.915583841598161,0.546102661596958,0
"<anonymized_userid>",1,51791,5746,"Geert Wilders (PVV)",0.91560152037479,0.546197718631179,0
"<anonymized_userid>",1,51792,5747,"Geert Wilders (PVV)",0.915619199151419,0.546292775665399,0
"<anonymized_userid>",1,51793,5748,"Geert Wilders (PVV)",0.915636877928047,0.54638783269962,0
"<anonymized_userid>",1,51794,5749,"Geert Wilders (PVV)",0.915654556704676,0.54648288973384,0
"<anonymized_userid>",1,51795,5750,"Geert Wilders (PVV)",0.915672235481305,0.546577946768061,0
"<anonymized_userid>",1,51796,5751,"Geert Wilders (PVV)",0.915689914257933,0.546673003802281,0
"<anonymized_userid>",1,51797,5752,"Geert Wilders (PVV)",0.915707593034562,0.546768060836502,0
"<anonymized_userid>",1,51798,5753,"Geert Wilders (PVV)",0.915725271811191,0.546863117870722,0
"<anonymized_userid>",1,51799,5754,"Geert Wilders (PVV)",0.915742950587819,0.546958174904943,0
"<anonymized_userid>",1,51800,5755,"Geert Wilders (PVV)",0.915760629364448,0.547053231939164,0
"<anonymized_userid>",1,51801,5756,"Geert Wilders (PVV)",0.915778308141077,0.547148288973384,0
"<anonymized_userid>",1,51802,5757,"Geert Wilders (PVV)",0.915795986917705,0.547243346007605,0
"<anonymized_userid>",1,51803,5758,"Geert Wilders (PVV)",0.915813665694334,0.547338403041825,0
"<anonymized_userid>",1,51804,5759,"Geert Wilders (PVV)",0.915831344470963,0.547433460076046,0
"<anonymized_userid>",1,51805,5760,"Geert Wilders (PVV)",0.915849023247591,0.547528517110266,0
"<anonymized_userid>",1,51806,5761,"Geert Wilders (PVV)",0.91586670202422,0.547623574144487,0
"<anonymized_userid>",1,51807,5762,"Geert Wilders (PVV)",0.915884380800849,0.547718631178707,0
"<anonymized_userid>",1,51808,5763,"Geert Wilders (PVV)",0.915902059577477,0.547813688212928,0
"<anonymized_userid>",1,51809,5764,"Geert Wilders (PVV)",0.915919738354106,0.547908745247148,0
"<anonymized_userid>",1,51810,5765,"Geert Wilders (PVV)",0.915937417130735,0.548003802281369,0
"<anonymized_userid>",1,51811,5766,"Geert Wilders (PVV)",0.915955095907363,0.548098859315589,0
"<anonymized_userid>",1,51812,5767,"Geert Wilders (PVV)",0.915972774683992,0.54819391634981,0
"<anonymized_userid>",1,51813,5768,"Geert Wilders (PVV)",0.915990453460621,0.54828897338403,0
"<anonymized_userid>",1,51814,5769,"Geert Wilders (PVV)",0.916008132237249,0.548384030418251,0
"<anonymized_userid>",1,51815,5770,"Geert Wilders (PVV)",0.916025811013878,0.548479087452472,0
"<anonymized_userid>",1,51816,5771,"Geert Wilders (PVV)",0.916043489790507,0.548574144486692,0
"<anonymized_userid>",1,51817,5772,"Geert Wilders (PVV)",0.916061168567135,0.548669201520913,0
"<anonymized_userid>",1,51818,5773,"Geert Wilders (PVV)",0.916078847343764,0.548764258555133,0
"<anonymized_userid>",1,51819,5774,"Geert Wilders (PVV)",0.916096526120392,0.548859315589354,0
"<anonymized_userid>",1,51820,5775,"Geert Wilders (PVV)",0.916114204897021,0.548954372623574,0
"<anonymized_userid>",1,51821,5776,"Geert Wilders (PVV)",0.91613188367365,0.549049429657795,0
"<anonymized_userid>",1,51822,5777,"Geert Wilders (PVV)",0.916149562450278,0.549144486692015,0
"<anonymized_userid>",1,51823,5778,"Geert Wilders (PVV)",0.916167241226907,0.549239543726236,0
"<anonymized_userid>",1,51824,5779,"Geert Wilders (PVV)",0.916184920003536,0.549334600760456,0
"<anonymized_userid>",1,51825,5780,"Geert Wilders (PVV)",0.916202598780164,0.549429657794677,0
"<anonymized_userid>",1,51826,5781,"Geert Wilders (PVV)",0.916220277556793,0.549524714828897,0
"<anonymized_userid>",1,51827,5782,"Geert Wilders (PVV)",0.916237956333422,0.549619771863118,0
"<anonymized_userid>",1,51828,5783,"Geert Wilders (PVV)",0.91625563511005,0.549714828897338,0
"<anonymized_userid>",1,51829,5784,"Geert Wilders (PVV)",0.916273313886679,0.549809885931559,0
"<anonymized_userid>",1,51830,5785,"Geert Wilders (PVV)",0.916290992663308,0.54990494296578,0
"<anonymized_userid>",1,51831,5786,"Geert Wilders (PVV)",0.916308671439936,0.55,0
"<anonymized_userid>",1,51832,5787,"Geert Wilders (PVV)",0.916326350216565,0.550095057034221,0
"<anonymized_userid>",1,51833,5788,"Geert Wilders (PVV)",0.916344028993194,0.550190114068441,0
"<anonymized_userid>",1,51834,5789,"Geert Wilders (PVV)",0.916361707769822,0.550285171102662,0
"<anonymized_userid>",1,51835,5790,"Geert Wilders (PVV)",0.916379386546451,0.550380228136882,0
"<anonymized_userid>",1,51836,5791,"Geert Wilders (PVV)",0.91639706532308,0.550475285171103,0
"<anonymized_userid>",1,51837,5792,"Geert Wilders (PVV)",0.916414744099708,0.550570342205323,0
"<anonymized_userid>",1,51838,5793,"Geert Wilders (PVV)",0.916432422876337,0.550665399239544,0
"<anonymized_userid>",1,51839,5794,"Geert Wilders (PVV)",0.916450101652966,0.550760456273764,0
"<anonymized_userid>",1,51840,5795,"Geert Wilders (PVV)",0.916467780429594,0.550855513307985,0
"<anonymized_userid>",1,51841,5796,"Geert Wilders (PVV)",0.916485459206223,0.550950570342205,0
"<anonymized_userid>",1,51842,5797,"Geert Wilders (PVV)",0.916503137982852,0.551045627376426,0
"<anonymized_userid>",1,51843,5798,"Geert Wilders (PVV)",0.91652081675948,0.551140684410646,0
"<anonymized_userid>",1,51844,5799,"Geert Wilders (PVV)",0.916538495536109,0.551235741444867,0
"<anonymized_userid>",1,51845,5800,"Geert Wilders (PVV)",0.916556174312738,0.551330798479088,0
"<anonymized_userid>",1,51846,5801,"Geert Wilders (PVV)",0.916573853089366,0.551425855513308,0
"<anonymized_userid>",1,51847,5802,"Geert Wilders (PVV)",0.916591531865995,0.551520912547529,0
"<anonymized_userid>",1,51848,5803,"Geert Wilders (PVV)",0.916609210642624,0.551615969581749,0
"<anonymized_userid>",1,51849,5804,"Geert Wilders (PVV)",0.916626889419252,0.55171102661597,0
"<anonymized_userid>",1,51850,5805,"Geert Wilders (PVV)",0.916644568195881,0.55180608365019,0
"<anonymized_userid>",1,51851,5806,"Geert Wilders (PVV)",0.91666224697251,0.551901140684411,0
"<anonymized_userid>",1,51852,5807,"Geert Wilders (PVV)",0.916679925749138,0.551996197718631,0
"<anonymized_userid>",1,51853,5808,"Geert Wilders (PVV)",0.916697604525767,0.552091254752852,0
"<anonymized_userid>",1,51854,5809,"Geert Wilders (PVV)",0.916715283302395,0.552186311787072,0
"<anonymized_userid>",1,51855,5810,"Geert Wilders (PVV)",0.916732962079024,0.552281368821293,0
"<anonymized_userid>",1,51856,5811,"Geert Wilders (PVV)",0.916750640855653,0.552376425855513,0
"<anonymized_userid>",1,51857,5812,"Geert Wilders (PVV)",0.916768319632281,0.552471482889734,0
"<anonymized_userid>",1,51858,5813,"Geert Wilders (PVV)",0.91678599840891,0.552566539923954,0
"<anonymized_userid>",1,51859,5814,"Geert Wilders (PVV)",0.916803677185539,0.552661596958175,0
"<anonymized_userid>",1,51860,5815,"Geert Wilders (PVV)",0.916821355962167,0.552756653992395,0
"<anonymized_userid>",1,51861,5816,"Geert Wilders (PVV)",0.916839034738796,0.552851711026616,0
"<anonymized_userid>",1,51862,5817,"Geert Wilders (PVV)",0.916856713515425,0.552946768060837,0
"<anonymized_userid>",1,51863,5818,"Geert Wilders (PVV)",0.916874392292053,0.553041825095057,0
"<anonymized_userid>",1,51864,5819,"Geert Wilders (PVV)",0.916892071068682,0.553136882129278,0
"<anonymized_userid>",1,51865,5820,"Geert Wilders (PVV)",0.916909749845311,0.553231939163498,0
"<anonymized_userid>",1,51866,5821,"Geert Wilders (PVV)",0.916927428621939,0.553326996197719,0
"<anonymized_userid>",1,51867,5822,"Geert Wilders (PVV)",0.916945107398568,0.553422053231939,0
"<anonymized_userid>",1,51868,5823,"Geert Wilders (PVV)",0.916962786175197,0.55351711026616,0
"<anonymized_userid>",1,51869,5824,"Geert Wilders (PVV)",0.916980464951825,0.55361216730038,0
"<anonymized_userid>",1,51870,5825,"Geert Wilders (PVV)",0.916998143728454,0.553707224334601,0
"<anonymized_userid>",1,51871,5826,"Geert Wilders (PVV)",0.917015822505083,0.553802281368821,0
"<anonymized_userid>",1,51872,5827,"Geert Wilders (PVV)",0.917033501281711,0.553897338403042,0
"<anonymized_userid>",1,51873,5828,"Geert Wilders (PVV)",0.91705118005834,0.553992395437262,0
"<anonymized_userid>",1,51874,5829,"Geert Wilders (PVV)",0.917068858834969,0.554087452471483,0
"<anonymized_userid>",1,51875,5830,"Geert Wilders (PVV)",0.917086537611597,0.554182509505703,0
"<anonymized_userid>",1,51876,5831,"Geert Wilders (PVV)",0.917104216388226,0.554277566539924,0
"<anonymized_userid>",1,51877,5832,"Geert Wilders (PVV)",0.917121895164855,0.554372623574145,0
"<anonymized_userid>",1,51878,5833,"Geert Wilders (PVV)",0.917139573941483,0.554467680608365,0
"<anonymized_userid>",1,51879,5834,"Geert Wilders (PVV)",0.917157252718112,0.554562737642586,0
"<anonymized_userid>",1,51880,5835,"Geert Wilders (PVV)",0.917174931494741,0.554657794676806,0
"<anonymized_userid>",1,51881,5836,"Geert Wilders (PVV)",0.917192610271369,0.554752851711027,0
"<anonymized_userid>",1,51882,5837,"Geert Wilders (PVV)",0.917210289047998,0.554847908745247,0
"<anonymized_userid>",1,51883,5838,"Geert Wilders (PVV)",0.917227967824627,0.554942965779468,0
"<anonymized_userid>",1,51884,5839,"Geert Wilders (PVV)",0.917245646601255,0.555038022813688,0
"<anonymized_userid>",1,51885,5840,"Geert Wilders (PVV)",0.917263325377884,0.555133079847909,0
"<anonymized_userid>",1,51886,5841,"Geert Wilders (PVV)",0.917281004154513,0.555228136882129,0
"<anonymized_userid>",1,51887,5842,"Geert Wilders (PVV)",0.917298682931141,0.55532319391635,0
"<anonymized_userid>",1,51888,5843,"Geert Wilders (PVV)",0.91731636170777,0.55541825095057,0
"<anonymized_userid>",1,51889,5844,"Geert Wilders (PVV)",0.917334040484398,0.555513307984791,0
"<anonymized_userid>",1,51890,5845,"Geert Wilders (PVV)",0.917351719261027,0.555608365019011,0
"<anonymized_userid>",1,51891,5846,"Geert Wilders (PVV)",0.917369398037656,0.555703422053232,0
"<anonymized_userid>",1,51892,5847,"Geert Wilders (PVV)",0.917387076814284,0.555798479087453,0
"<anonymized_userid>",1,51893,5848,"Geert Wilders (PVV)",0.917404755590913,0.555893536121673,0
"<anonymized_userid>",1,51894,5849,"Geert Wilders (PVV)",0.917422434367542,0.555988593155894,0
"<anonymized_userid>",1,51895,5850,"Geert Wilders (PVV)",0.91744011314417,0.556083650190114,0
"<anonymized_userid>",1,51896,5851,"Geert Wilders (PVV)",0.917457791920799,0.556178707224335,0
"<anonymized_userid>",1,51897,5852,"Geert Wilders (PVV)",0.917475470697428,0.556273764258555,0
"<anonymized_userid>",1,51898,5853,"Geert Wilders (PVV)",0.917493149474056,0.556368821292776,0
"<anonymized_userid>",1,51899,5854,"Geert Wilders (PVV)",0.917510828250685,0.556463878326996,0
"<anonymized_userid>",1,51900,5855,"Geert Wilders (PVV)",0.917528507027314,0.556558935361217,0
"<anonymized_userid>",1,51901,5856,"Geert Wilders (PVV)",0.917546185803942,0.556653992395437,0
"<anonymized_userid>",1,51902,5857,"Geert Wilders (PVV)",0.917563864580571,0.556749049429658,0
"<anonymized_userid>",1,51903,5858,"Geert Wilders (PVV)",0.9175815433572,0.556844106463878,0
"<anonymized_userid>",1,51904,5859,"Geert Wilders (PVV)",0.917599222133828,0.556939163498099,0
"<anonymized_userid>",1,51905,5860,"Geert Wilders (PVV)",0.917616900910457,0.557034220532319,0
"<anonymized_userid>",1,51906,5861,"Geert Wilders (PVV)",0.917634579687086,0.55712927756654,0
"<anonymized_userid>",1,51907,5862,"Geert Wilders (PVV)",0.917652258463714,0.55722433460076,0
"<anonymized_userid>",1,51908,5863,"Geert Wilders (PVV)",0.917669937240343,0.557319391634981,0
"<anonymized_userid>",1,51909,5864,"Geert Wilders (PVV)",0.917687616016972,0.557414448669202,0
"<anonymized_userid>",1,51910,5865,"Geert Wilders (PVV)",0.9177052947936,0.557509505703422,0
"<anonymized_userid>",1,51911,5866,"Geert Wilders (PVV)",0.917722973570229,0.557604562737643,0
"<anonymized_userid>",1,51912,5867,"Geert Wilders (PVV)",0.917740652346858,0.557699619771863,0
"<anonymized_userid>",1,51913,5868,"Geert Wilders (PVV)",0.917758331123486,0.557794676806084,0
"<anonymized_userid>",1,51914,5869,"Geert Wilders (PVV)",0.917776009900115,0.557889733840304,0
"<anonymized_userid>",1,51915,5870,"Geert Wilders (PVV)",0.917793688676744,0.557984790874525,0
"<anonymized_userid>",1,51916,5871,"Geert Wilders (PVV)",0.917811367453372,0.558079847908745,0
"<anonymized_userid>",1,51917,5872,"Geert Wilders (PVV)",0.917829046230001,0.558174904942966,0
"<anonymized_userid>",1,51918,5873,"Geert Wilders (PVV)",0.91784672500663,0.558269961977186,0
"<anonymized_userid>",1,51919,5874,"Geert Wilders (PVV)",0.917864403783258,0.558365019011407,0
"<anonymized_userid>",1,51920,5875,"Geert Wilders (PVV)",0.917882082559887,0.558460076045627,0
"<anonymized_userid>",1,51921,5876,"Geert Wilders (PVV)",0.917899761336516,0.558555133079848,0
"<anonymized_userid>",1,51922,5877,"Geert Wilders (PVV)",0.917917440113144,0.558650190114068,0
"<anonymized_userid>",1,51923,5878,"Geert Wilders (PVV)",0.917935118889773,0.558745247148289,0
"<anonymized_userid>",1,51924,5879,"Geert Wilders (PVV)",0.917952797666401,0.55884030418251,0
"<anonymized_userid>",1,51925,5880,"Geert Wilders (PVV)",0.91797047644303,0.55893536121673,0
"<anonymized_userid>",1,51926,5881,"Geert Wilders (PVV)",0.917988155219659,0.559030418250951,0
"<anonymized_userid>",1,51927,5882,"Geert Wilders (PVV)",0.918005833996287,0.559125475285171,0
"<anonymized_userid>",1,51928,5883,"Geert Wilders (PVV)",0.918023512772916,0.559220532319392,0
"<anonymized_userid>",1,51929,5884,"Geert Wilders (PVV)",0.918041191549545,0.559315589353612,0
"<anonymized_userid>",1,51930,5885,"Geert Wilders (PVV)",0.918058870326173,0.559410646387833,0
"<anonymized_userid>",1,51931,5886,"Geert Wilders (PVV)",0.918076549102802,0.559505703422053,0
"<anonymized_userid>",1,51932,5887,"Geert Wilders (PVV)",0.918094227879431,0.559600760456274,0
"<anonymized_userid>",1,51933,5888,"Geert Wilders (PVV)",0.918111906656059,0.559695817490494,0
"<anonymized_userid>",1,51934,5889,"Geert Wilders (PVV)",0.918129585432688,0.559790874524715,0
"<anonymized_userid>",1,51935,5890,"Geert Wilders (PVV)",0.918147264209317,0.559885931558935,0
"<anonymized_userid>",1,51936,5891,"Geert Wilders (PVV)",0.918164942985945,0.559980988593156,0
"<anonymized_userid>",1,51937,5892,"Geert Wilders (PVV)",0.918182621762574,0.560076045627376,0
"<anonymized_userid>",1,51938,5893,"Geert Wilders (PVV)",0.918200300539203,0.560171102661597,0
"<anonymized_userid>",1,51939,5894,"Geert Wilders (PVV)",0.918217979315831,0.560266159695818,0
"<anonymized_userid>",1,51940,5895,"Geert Wilders (PVV)",0.91823565809246,0.560361216730038,0
"<anonymized_userid>",1,51941,5896,"Geert Wilders (PVV)",0.918253336869089,0.560456273764259,0
"<anonymized_userid>",1,51942,5897,"Geert Wilders (PVV)",0.918271015645717,0.560551330798479,0
"<anonymized_userid>",1,51943,5898,"Geert Wilders (PVV)",0.918288694422346,0.5606463878327,0
"<anonymized_userid>",1,51944,5899,"Geert Wilders (PVV)",0.918306373198975,0.56074144486692,0
"<anonymized_userid>",1,51945,5900,"Geert Wilders (PVV)",0.918324051975603,0.560836501901141,0
"<anonymized_userid>",1,51946,5901,"Geert Wilders (PVV)",0.918341730752232,0.560931558935361,0
"<anonymized_userid>",1,51947,5902,"Geert Wilders (PVV)",0.918359409528861,0.561026615969582,0
"<anonymized_userid>",1,51948,5903,"Geert Wilders (PVV)",0.918377088305489,0.561121673003802,0
"<anonymized_userid>",1,51949,5904,"Geert Wilders (PVV)",0.918394767082118,0.561216730038023,0
"<anonymized_userid>",1,51950,5905,"Geert Wilders (PVV)",0.918412445858747,0.561311787072243,0
"<anonymized_userid>",1,51951,5906,"Geert Wilders (PVV)",0.918430124635375,0.561406844106464,0
"<anonymized_userid>",1,51952,5907,"Geert Wilders (PVV)",0.918447803412004,0.561501901140684,0
"<anonymized_userid>",1,51953,5908,"Geert Wilders (PVV)",0.918465482188633,0.561596958174905,0
"<anonymized_userid>",1,51954,5909,"Geert Wilders (PVV)",0.918483160965261,0.561692015209125,0
"<anonymized_userid>",1,51955,5910,"Geert Wilders (PVV)",0.91850083974189,0.561787072243346,0
"<anonymized_userid>",1,51956,5911,"Geert Wilders (PVV)",0.918518518518519,0.561882129277567,0
"<anonymized_userid>",1,51957,5912,"Geert Wilders (PVV)",0.918536197295147,0.561977186311787,0
"<anonymized_userid>",1,51958,5913,"Geert Wilders (PVV)",0.918553876071776,0.562072243346008,0
"<anonymized_userid>",1,51959,5914,"Geert Wilders (PVV)",0.918571554848404,0.562167300380228,0
"<anonymized_userid>",1,51960,5915,"Geert Wilders (PVV)",0.918589233625033,0.562262357414449,0
"<anonymized_userid>",1,51961,5916,"Geert Wilders (PVV)",0.918606912401662,0.562357414448669,0
"<anonymized_userid>",1,51962,5917,"Geert Wilders (PVV)",0.91862459117829,0.56245247148289,0
"<anonymized_userid>",1,51963,5918,"Geert Wilders (PVV)",0.918642269954919,0.56254752851711,0
"<anonymized_userid>",1,51964,5919,"Geert Wilders (PVV)",0.918659948731548,0.562642585551331,0
"<anonymized_userid>",1,51965,5920,"Geert Wilders (PVV)",0.918677627508176,0.562737642585551,0
"<anonymized_userid>",1,51966,5921,"Geert Wilders (PVV)",0.918695306284805,0.562832699619772,0
"<anonymized_userid>",1,51967,5922,"Geert Wilders (PVV)",0.918712985061434,0.562927756653992,0
"<anonymized_userid>",1,51968,5923,"Geert Wilders (PVV)",0.918730663838062,0.563022813688213,0
"<anonymized_userid>",1,51969,5924,"Geert Wilders (PVV)",0.918748342614691,0.563117870722433,0
"<anonymized_userid>",1,51970,5925,"Geert Wilders (PVV)",0.91876602139132,0.563212927756654,0
"<anonymized_userid>",1,51971,5926,"Geert Wilders (PVV)",0.918783700167948,0.563307984790875,0
"<anonymized_userid>",1,51972,5927,"Geert Wilders (PVV)",0.918801378944577,0.563403041825095,0
"<anonymized_userid>",1,51973,5928,"Geert Wilders (PVV)",0.918819057721206,0.563498098859316,0
"<anonymized_userid>",1,51974,5929,"Geert Wilders (PVV)",0.918836736497834,0.563593155893536,0
"<anonymized_userid>",1,51975,5930,"Geert Wilders (PVV)",0.918854415274463,0.563688212927757,0
"<anonymized_userid>",1,51976,5931,"Geert Wilders (PVV)",0.918872094051092,0.563783269961977,0
"<anonymized_userid>",1,51977,5932,"Geert Wilders (PVV)",0.91888977282772,0.563878326996198,0
"<anonymized_userid>",1,51978,5933,"Geert Wilders (PVV)",0.918907451604349,0.563973384030418,0
"<anonymized_userid>",1,51979,5934,"Geert Wilders (PVV)",0.918925130380978,0.564068441064639,0
"<anonymized_userid>",1,51980,5935,"Geert Wilders (PVV)",0.918942809157606,0.564163498098859,0
"<anonymized_userid>",1,51981,5936,"Geert Wilders (PVV)",0.918960487934235,0.56425855513308,0
"<anonymized_userid>",1,51982,5937,"Geert Wilders (PVV)",0.918978166710864,0.5643536121673,0
"<anonymized_userid>",1,51983,5938,"Geert Wilders (PVV)",0.918995845487492,0.564448669201521,0
"<anonymized_userid>",1,51984,5939,"Geert Wilders (PVV)",0.919013524264121,0.564543726235741,0
"<anonymized_userid>",1,51985,5940,"Geert Wilders (PVV)",0.91903120304075,0.564638783269962,0
"<anonymized_userid>",1,51986,5941,"Geert Wilders (PVV)",0.919048881817378,0.564733840304182,0
"<anonymized_userid>",1,51987,5942,"Geert Wilders (PVV)",0.919066560594007,0.564828897338403,0
"<anonymized_userid>",1,51988,5943,"Geert Wilders (PVV)",0.919084239370636,0.564923954372624,0
"<anonymized_userid>",1,51989,5944,"Geert Wilders (PVV)",0.919101918147264,0.565019011406844,0
"<anonymized_userid>",1,51990,5945,"Geert Wilders (PVV)",0.919119596923893,0.565114068441065,0
"<anonymized_userid>",1,51991,5946,"Geert Wilders (PVV)",0.919137275700522,0.565209125475285,0
"<anonymized_userid>",1,51992,5947,"Geert Wilders (PVV)",0.91915495447715,0.565304182509506,0
"<anonymized_userid>",1,51993,5948,"Geert Wilders (PVV)",0.919172633253779,0.565399239543726,0
"<anonymized_userid>",1,51994,5949,"Geert Wilders (PVV)",0.919190312030407,0.565494296577947,0
"<anonymized_userid>",1,51995,5950,"Geert Wilders (PVV)",0.919207990807036,0.565589353612167,0
"<anonymized_userid>",1,51996,5951,"Geert Wilders (PVV)",0.919225669583665,0.565684410646388,0
"<anonymized_userid>",1,51997,5952,"Geert Wilders (PVV)",0.919243348360293,0.565779467680608,0
"<anonymized_userid>",1,51998,5953,"Geert Wilders (PVV)",0.919261027136922,0.565874524714829,0
"<anonymized_userid>",1,51999,5954,"Geert Wilders (PVV)",0.919278705913551,0.565969581749049,0
"<anonymized_userid>",1,52000,5955,"Geert Wilders (PVV)",0.919296384690179,0.56606463878327,0
"<anonymized_userid>",1,52001,5956,"Geert Wilders (PVV)",0.919314063466808,0.56615969581749,0
"<anonymized_userid>",1,52002,5957,"Geert Wilders (PVV)",0.919331742243437,0.566254752851711,0
"<anonymized_userid>",1,52003,5958,"Geert Wilders (PVV)",0.919349421020065,0.566349809885932,0
"<anonymized_userid>",1,52004,5959,"Geert Wilders (PVV)",0.919367099796694,0.566444866920152,0
"<anonymized_userid>",1,52005,5960,"Geert Wilders (PVV)",0.919384778573323,0.566539923954373,0
"<anonymized_userid>",1,52006,5961,"Geert Wilders (PVV)",0.919402457349951,0.566634980988593,0
"<anonymized_userid>",1,52007,5962,"Geert Wilders (PVV)",0.91942013612658,0.566730038022814,0
"<anonymized_userid>",1,52008,5963,"Geert Wilders (PVV)",0.919437814903209,0.566825095057034,0
"<anonymized_userid>",1,52009,5964,"Geert Wilders (PVV)",0.919455493679837,0.566920152091255,0
"<anonymized_userid>",1,52010,5965,"Geert Wilders (PVV)",0.919473172456466,0.567015209125475,0
"<anonymized_userid>",1,52011,5966,"Geert Wilders (PVV)",0.919490851233095,0.567110266159696,0
"<anonymized_userid>",1,52012,5967,"Geert Wilders (PVV)",0.919508530009723,0.567205323193916,0
"<anonymized_userid>",1,52013,5968,"Geert Wilders (PVV)",0.919526208786352,0.567300380228137,0
"<anonymized_userid>",1,52014,5969,"Geert Wilders (PVV)",0.919543887562981,0.567395437262357,0
"<anonymized_userid>",1,52015,5970,"Geert Wilders (PVV)",0.919561566339609,0.567490494296578,0
"<anonymized_userid>",1,52016,5971,"Geert Wilders (PVV)",0.919579245116238,0.567585551330798,0
"<anonymized_userid>",1,52017,5972,"Geert Wilders (PVV)",0.919596923892867,0.567680608365019,0
"<anonymized_userid>",1,52018,5973,"Geert Wilders (PVV)",0.919614602669495,0.56777566539924,0
"<anonymized_userid>",1,52019,5974,"Geert Wilders (PVV)",0.919632281446124,0.56787072243346,0
"<anonymized_userid>",1,52020,5975,"Geert Wilders (PVV)",0.919649960222753,0.567965779467681,0
"<anonymized_userid>",1,52021,5976,"Geert Wilders (PVV)",0.919667638999381,0.568060836501901,0
"<anonymized_userid>",1,52022,5977,"Geert Wilders (PVV)",0.91968531777601,0.568155893536122,0
"<anonymized_userid>",1,52023,5978,"Geert Wilders (PVV)",0.919702996552639,0.568250950570342,0
"<anonymized_userid>",1,52024,5979,"Geert Wilders (PVV)",0.919720675329267,0.568346007604563,0
"<anonymized_userid>",1,52025,5980,"Geert Wilders (PVV)",0.919738354105896,0.568441064638783,0
"<anonymized_userid>",1,52026,5981,"Geert Wilders (PVV)",0.919756032882524,0.568536121673004,0
"<anonymized_userid>",1,52027,5982,"Geert Wilders (PVV)",0.919773711659153,0.568631178707224,0
"<anonymized_userid>",1,52028,5983,"Geert Wilders (PVV)",0.919791390435782,0.568726235741445,0
"<anonymized_userid>",1,52029,5984,"Geert Wilders (PVV)",0.91980906921241,0.568821292775665,0
"<anonymized_userid>",1,52030,5985,"Geert Wilders (PVV)",0.919826747989039,0.568916349809886,0
"<anonymized_userid>",1,52031,5986,"Geert Wilders (PVV)",0.919844426765668,0.569011406844106,0
"<anonymized_userid>",1,52032,5987,"Geert Wilders (PVV)",0.919862105542297,0.569106463878327,0
"<anonymized_userid>",1,52033,5988,"Geert Wilders (PVV)",0.919879784318925,0.569201520912547,0
"<anonymized_userid>",1,52034,5989,"Geert Wilders (PVV)",0.919897463095554,0.569296577946768,0
"<anonymized_userid>",1,52035,5990,"Geert Wilders (PVV)",0.919915141872182,0.569391634980989,0
"<anonymized_userid>",1,52036,5991,"Geert Wilders (PVV)",0.919932820648811,0.569486692015209,0
"<anonymized_userid>",1,52037,5992,"Geert Wilders (PVV)",0.91995049942544,0.56958174904943,0
"<anonymized_userid>",1,52038,5993,"Geert Wilders (PVV)",0.919968178202068,0.56967680608365,0
"<anonymized_userid>",1,52039,5994,"Geert Wilders (PVV)",0.919985856978697,0.569771863117871,0
"<anonymized_userid>",1,52040,5995,"Geert Wilders (PVV)",0.920003535755326,0.569866920152091,0
"<anonymized_userid>",1,52041,5996,"Geert Wilders (PVV)",0.920021214531954,0.569961977186312,0
"<anonymized_userid>",1,52042,5997,"Geert Wilders (PVV)",0.920038893308583,0.570057034220532,0
"<anonymized_userid>",1,52043,5998,"Geert Wilders (PVV)",0.920056572085212,0.570152091254753,0
"<anonymized_userid>",1,52044,5999,"Geert Wilders (PVV)",0.92007425086184,0.570247148288973,0
"<anonymized_userid>",1,52045,6000,"Geert Wilders (PVV)",0.920091929638469,0.570342205323194,0
"<anonymized_userid>",1,52046,6001,"Geert Wilders (PVV)",0.920109608415098,0.570437262357414,0
"<anonymized_userid>",1,52047,6002,"Geert Wilders (PVV)",0.920127287191726,0.570532319391635,0
"<anonymized_userid>",1,52048,6003,"Geert Wilders (PVV)",0.920144965968355,0.570627376425855,0
"<anonymized_userid>",1,52049,6004,"Geert Wilders (PVV)",0.920162644744984,0.570722433460076,0
"<anonymized_userid>",1,52050,6005,"Geert Wilders (PVV)",0.920180323521612,0.570817490494297,0
"<anonymized_userid>",1,52051,6006,"Geert Wilders (PVV)",0.920198002298241,0.570912547528517,0
"<anonymized_userid>",1,52052,6007,"Geert Wilders (PVV)",0.92021568107487,0.571007604562738,0
"<anonymized_userid>",1,52053,6008,"Geert Wilders (PVV)",0.920233359851498,0.571102661596958,0
"<anonymized_userid>",1,52054,6009,"Geert Wilders (PVV)",0.920251038628127,0.571197718631179,0
"<anonymized_userid>",1,52055,6010,"Geert Wilders (PVV)",0.920268717404756,0.571292775665399,0
"<anonymized_userid>",1,52056,6011,"Geert Wilders (PVV)",0.920286396181384,0.57138783269962,0
"<anonymized_userid>",1,52057,6012,"Geert Wilders (PVV)",0.920304074958013,0.57148288973384,0
"<anonymized_userid>",1,52058,6013,"Geert Wilders (PVV)",0.920321753734642,0.571577946768061,0
"<anonymized_userid>",1,52059,6014,"Geert Wilders (PVV)",0.92033943251127,0.571673003802281,0
"<anonymized_userid>",1,52060,6015,"Geert Wilders (PVV)",0.920357111287899,0.571768060836502,0
"<anonymized_userid>",1,52061,6016,"Geert Wilders (PVV)",0.920374790064527,0.571863117870722,0
"<anonymized_userid>",1,52062,6017,"Geert Wilders (PVV)",0.920392468841156,0.571958174904943,0
"<anonymized_userid>",1,52063,6018,"Geert Wilders (PVV)",0.920410147617785,0.572053231939163,0
"<anonymized_userid>",1,52064,6019,"Geert Wilders (PVV)",0.920427826394414,0.572148288973384,0
"<anonymized_userid>",1,52065,6020,"Geert Wilders (PVV)",0.920445505171042,0.572243346007605,0
"<anonymized_userid>",1,52066,6021,"Geert Wilders (PVV)",0.920463183947671,0.572338403041825,0
"<anonymized_userid>",1,52067,6022,"Geert Wilders (PVV)",0.9204808627243,0.572433460076046,0
"<anonymized_userid>",1,52068,6023,"Geert Wilders (PVV)",0.920498541500928,0.572528517110266,0
"<anonymized_userid>",1,52069,6024,"Geert Wilders (PVV)",0.920516220277557,0.572623574144487,0
"<anonymized_userid>",1,52070,6025,"Geert Wilders (PVV)",0.920533899054185,0.572718631178707,0
"<anonymized_userid>",1,52071,6026,"Geert Wilders (PVV)",0.920551577830814,0.572813688212928,0
"<anonymized_userid>",1,52072,6027,"Geert Wilders (PVV)",0.920569256607443,0.572908745247148,0
"<anonymized_userid>",1,52073,6028,"Geert Wilders (PVV)",0.920586935384071,0.573003802281369,0
"<anonymized_userid>",1,52074,6029,"Geert Wilders (PVV)",0.9206046141607,0.573098859315589,0
"<anonymized_userid>",1,52075,6030,"Geert Wilders (PVV)",0.920622292937329,0.57319391634981,0
"<anonymized_userid>",1,52076,6031,"Geert Wilders (PVV)",0.920639971713957,0.57328897338403,0
"<anonymized_userid>",1,52077,6032,"Geert Wilders (PVV)",0.920657650490586,0.573384030418251,0
"<anonymized_userid>",1,52078,6033,"Geert Wilders (PVV)",0.920675329267215,0.573479087452471,0
"<anonymized_userid>",1,52079,6034,"Geert Wilders (PVV)",0.920693008043843,0.573574144486692,0
"<anonymized_userid>",1,52080,6035,"Geert Wilders (PVV)",0.920710686820472,0.573669201520912,0
"<anonymized_userid>",1,52081,6036,"Geert Wilders (PVV)",0.920728365597101,0.573764258555133,0
"<anonymized_userid>",1,52082,6037,"Geert Wilders (PVV)",0.920746044373729,0.573859315589354,0
"<anonymized_userid>",1,52083,6038,"Geert Wilders (PVV)",0.920763723150358,0.573954372623574,0
"<anonymized_userid>",1,52084,6039,"Geert Wilders (PVV)",0.920781401926987,0.574049429657795,0
"<anonymized_userid>",1,52085,6040,"Geert Wilders (PVV)",0.920799080703615,0.574144486692015,0
"<anonymized_userid>",1,52086,6041,"Geert Wilders (PVV)",0.920816759480244,0.574239543726236,0
"<anonymized_userid>",1,52087,6042,"Geert Wilders (PVV)",0.920834438256873,0.574334600760456,0
"<anonymized_userid>",1,52088,6043,"Geert Wilders (PVV)",0.920852117033501,0.574429657794677,0
"<anonymized_userid>",1,52089,6044,"Geert Wilders (PVV)",0.92086979581013,0.574524714828897,0
"<anonymized_userid>",1,52090,6045,"Geert Wilders (PVV)",0.920887474586759,0.574619771863118,0
"<anonymized_userid>",1,52091,6046,"Geert Wilders (PVV)",0.920905153363387,0.574714828897338,0
"<anonymized_userid>",1,52092,6047,"Geert Wilders (PVV)",0.920922832140016,0.574809885931559,0
"<anonymized_userid>",1,52093,6048,"Geert Wilders (PVV)",0.920940510916645,0.574904942965779,0
"<anonymized_userid>",1,52094,6049,"Geert Wilders (PVV)",0.920958189693273,0.575,0
"<anonymized_userid>",1,52095,6050,"Geert Wilders (PVV)",0.920975868469902,0.57509505703422,0
"<anonymized_userid>",1,52096,6051,"Geert Wilders (PVV)",0.92099354724653,0.575190114068441,0
"<anonymized_userid>",1,52097,6052,"Geert Wilders (PVV)",0.921011226023159,0.575285171102662,0
"<anonymized_userid>",1,52098,6053,"Geert Wilders (PVV)",0.921028904799788,0.575380228136882,0
"<anonymized_userid>",1,52099,6054,"Geert Wilders (PVV)",0.921046583576417,0.575475285171103,0
"<anonymized_userid>",1,52100,6055,"Geert Wilders (PVV)",0.921064262353045,0.575570342205323,0
"<anonymized_userid>",1,52101,6056,"Geert Wilders (PVV)",0.921081941129674,0.575665399239544,0
"<anonymized_userid>",1,52102,6057,"Geert Wilders (PVV)",0.921099619906303,0.575760456273764,0
"<anonymized_userid>",1,52103,6058,"Geert Wilders (PVV)",0.921117298682931,0.575855513307985,0
"<anonymized_userid>",1,52104,6059,"Geert Wilders (PVV)",0.92113497745956,0.575950570342205,0
"<anonymized_userid>",1,52105,6060,"Geert Wilders (PVV)",0.921152656236188,0.576045627376426,0
"<anonymized_userid>",1,52106,6061,"Geert Wilders (PVV)",0.921170335012817,0.576140684410646,0
"<anonymized_userid>",1,52107,6062,"Geert Wilders (PVV)",0.921188013789446,0.576235741444867,0
"<anonymized_userid>",1,52108,6063,"Geert Wilders (PVV)",0.921205692566074,0.576330798479087,0
"<anonymized_userid>",1,52109,6064,"Geert Wilders (PVV)",0.921223371342703,0.576425855513308,0
"<anonymized_userid>",1,52110,6065,"Geert Wilders (PVV)",0.921241050119332,0.576520912547528,0
"<anonymized_userid>",1,52111,6066,"Geert Wilders (PVV)",0.92125872889596,0.576615969581749,0
"<anonymized_userid>",1,52112,6067,"Geert Wilders (PVV)",0.921276407672589,0.57671102661597,0
"<anonymized_userid>",1,52113,6068,"Geert Wilders (PVV)",0.921294086449218,0.57680608365019,0
"<anonymized_userid>",1,52114,6069,"Geert Wilders (PVV)",0.921311765225846,0.576901140684411,0
"<anonymized_userid>",1,52115,6070,"Geert Wilders (PVV)",0.921329444002475,0.576996197718631,0
"<anonymized_userid>",1,52116,6071,"Geert Wilders (PVV)",0.921347122779104,0.577091254752852,0
"<anonymized_userid>",1,52117,6072,"Geert Wilders (PVV)",0.921364801555732,0.577186311787072,0
"<anonymized_userid>",1,52118,6073,"Geert Wilders (PVV)",0.921382480332361,0.577281368821293,0
"<anonymized_userid>",1,52119,6074,"Geert Wilders (PVV)",0.92140015910899,0.577376425855513,0
"<anonymized_userid>",1,52120,6075,"Geert Wilders (PVV)",0.921417837885618,0.577471482889734,0
"<anonymized_userid>",1,52121,6076,"Geert Wilders (PVV)",0.921435516662247,0.577566539923954,0
"<anonymized_userid>",1,52122,6077,"Geert Wilders (PVV)",0.921453195438876,0.577661596958175,0
"<anonymized_userid>",1,52123,6078,"Geert Wilders (PVV)",0.921470874215504,0.577756653992395,0
"<anonymized_userid>",1,52124,6079,"Geert Wilders (PVV)",0.921488552992133,0.577851711026616,0
"<anonymized_userid>",1,52125,6080,"Geert Wilders (PVV)",0.921506231768762,0.577946768060836,0
"<anonymized_userid>",1,52126,6081,"Geert Wilders (PVV)",0.92152391054539,0.578041825095057,0
"<anonymized_userid>",1,52127,6082,"Geert Wilders (PVV)",0.921541589322019,0.578136882129278,0
"<anonymized_userid>",1,52128,6083,"Geert Wilders (PVV)",0.921559268098648,0.578231939163498,0
"<anonymized_userid>",1,52129,6084,"Geert Wilders (PVV)",0.921576946875276,0.578326996197719,0
"<anonymized_userid>",1,52130,6085,"Geert Wilders (PVV)",0.921594625651905,0.578422053231939,0
"<anonymized_userid>",1,52131,6086,"Geert Wilders (PVV)",0.921612304428534,0.57851711026616,0
"<anonymized_userid>",1,52132,6087,"Geert Wilders (PVV)",0.921629983205162,0.57861216730038,0
"<anonymized_userid>",1,52133,6088,"Geert Wilders (PVV)",0.921647661981791,0.578707224334601,0
"<anonymized_userid>",1,52134,6089,"Geert Wilders (PVV)",0.92166534075842,0.578802281368821,0
"<anonymized_userid>",1,52135,6090,"Geert Wilders (PVV)",0.921683019535048,0.578897338403042,0
"<anonymized_userid>",1,52136,6091,"Geert Wilders (PVV)",0.921700698311677,0.578992395437262,0
"<anonymized_userid>",1,52137,6092,"Geert Wilders (PVV)",0.921718377088306,0.579087452471483,0
"<anonymized_userid>",1,52138,6093,"Geert Wilders (PVV)",0.921736055864934,0.579182509505703,0
"<anonymized_userid>",1,52139,6094,"Geert Wilders (PVV)",0.921753734641563,0.579277566539924,0
"<anonymized_userid>",1,52140,6095,"Geert Wilders (PVV)",0.921771413418191,0.579372623574145,0
"<anonymized_userid>",1,52141,6096,"Geert Wilders (PVV)",0.92178909219482,0.579467680608365,0
"<anonymized_userid>",1,52142,6097,"Geert Wilders (PVV)",0.921806770971449,0.579562737642586,0
"<anonymized_userid>",1,52143,6098,"Geert Wilders (PVV)",0.921824449748077,0.579657794676806,0
"<anonymized_userid>",1,52144,6099,"Geert Wilders (PVV)",0.921842128524706,0.579752851711027,0
"<anonymized_userid>",1,52145,6100,"Geert Wilders (PVV)",0.921859807301335,0.579847908745247,0
"<anonymized_userid>",1,52146,6101,"Geert Wilders (PVV)",0.921877486077963,0.579942965779468,0
"<anonymized_userid>",1,52147,6102,"Geert Wilders (PVV)",0.921895164854592,0.580038022813688,0
"<anonymized_userid>",1,52148,6103,"Geert Wilders (PVV)",0.921912843631221,0.580133079847909,0
"<anonymized_userid>",1,52149,6104,"Geert Wilders (PVV)",0.921930522407849,0.580228136882129,0
"<anonymized_userid>",1,52150,6105,"Geert Wilders (PVV)",0.921948201184478,0.58032319391635,0
"<anonymized_userid>",1,52151,6106,"Geert Wilders (PVV)",0.921965879961107,0.58041825095057,0
"<anonymized_userid>",1,52152,6107,"Geert Wilders (PVV)",0.921983558737735,0.580513307984791,0
"<anonymized_userid>",1,52153,6108,"Geert Wilders (PVV)",0.922001237514364,0.580608365019011,0
"<anonymized_userid>",1,52154,6109,"Geert Wilders (PVV)",0.922018916290993,0.580703422053232,0
"<anonymized_userid>",1,52155,6110,"Geert Wilders (PVV)",0.922036595067621,0.580798479087453,0
"<anonymized_userid>",1,52156,6111,"Geert Wilders (PVV)",0.92205427384425,0.580893536121673,0
"<anonymized_userid>",1,52157,6112,"Geert Wilders (PVV)",0.922071952620879,0.580988593155894,0
"<anonymized_userid>",1,52158,6113,"Geert Wilders (PVV)",0.922089631397507,0.581083650190114,0
"<anonymized_userid>",1,52159,6114,"Geert Wilders (PVV)",0.922107310174136,0.581178707224335,0
"<anonymized_userid>",1,52160,6115,"Geert Wilders (PVV)",0.922124988950765,0.581273764258555,0
"<anonymized_userid>",1,52161,6116,"Geert Wilders (PVV)",0.922142667727393,0.581368821292776,0
"<anonymized_userid>",1,52162,6117,"Geert Wilders (PVV)",0.922160346504022,0.581463878326996,0
"<anonymized_userid>",1,52163,6118,"Geert Wilders (PVV)",0.922178025280651,0.581558935361217,0
"<anonymized_userid>",1,52164,6119,"Geert Wilders (PVV)",0.922195704057279,0.581653992395437,0
"<anonymized_userid>",1,52165,6120,"Geert Wilders (PVV)",0.922213382833908,0.581749049429658,0
"<anonymized_userid>",1,52166,6121,"Geert Wilders (PVV)",0.922231061610537,0.581844106463878,0
"<anonymized_userid>",1,52167,6122,"Geert Wilders (PVV)",0.922248740387165,0.581939163498099,0
"<anonymized_userid>",1,52168,6123,"Geert Wilders (PVV)",0.922266419163794,0.582034220532319,0
"<anonymized_userid>",1,52169,6124,"Geert Wilders (PVV)",0.922284097940423,0.58212927756654,0
"<anonymized_userid>",1,52170,6125,"Geert Wilders (PVV)",0.922301776717051,0.582224334600761,0
"<anonymized_userid>",1,52171,6126,"Geert Wilders (PVV)",0.92231945549368,0.582319391634981,0
"<anonymized_userid>",1,52172,6127,"Geert Wilders (PVV)",0.922337134270309,0.582414448669202,0
"<anonymized_userid>",1,52173,6128,"Geert Wilders (PVV)",0.922354813046937,0.582509505703422,0
"<anonymized_userid>",1,52174,6129,"Geert Wilders (PVV)",0.922372491823566,0.582604562737643,0
"<anonymized_userid>",1,52175,6130,"Geert Wilders (PVV)",0.922390170600194,0.582699619771863,0
"<anonymized_userid>",1,52176,6131,"Geert Wilders (PVV)",0.922407849376823,0.582794676806084,0
"<anonymized_userid>",1,52177,6132,"Geert Wilders (PVV)",0.922425528153452,0.582889733840304,0
"<anonymized_userid>",1,52178,6133,"Geert Wilders (PVV)",0.92244320693008,0.582984790874525,0
"<anonymized_userid>",1,52179,6134,"Geert Wilders (PVV)",0.922460885706709,0.583079847908745,0
"<anonymized_userid>",1,52180,6135,"Geert Wilders (PVV)",0.922478564483338,0.583174904942966,0
"<anonymized_userid>",1,52181,6136,"Geert Wilders (PVV)",0.922496243259966,0.583269961977186,0
"<anonymized_userid>",1,52182,6137,"Geert Wilders (PVV)",0.922513922036595,0.583365019011407,0
"<anonymized_userid>",1,52183,6138,"Geert Wilders (PVV)",0.922531600813224,0.583460076045627,0
"<anonymized_userid>",1,52184,6139,"Geert Wilders (PVV)",0.922549279589852,0.583555133079848,0
"<anonymized_userid>",1,52185,6140,"Geert Wilders (PVV)",0.922566958366481,0.583650190114068,0
"<anonymized_userid>",1,52186,6141,"Geert Wilders (PVV)",0.92258463714311,0.583745247148289,0
"<anonymized_userid>",1,52187,6142,"Geert Wilders (PVV)",0.922602315919738,0.58384030418251,0
"<anonymized_userid>",1,52188,6143,"Geert Wilders (PVV)",0.922619994696367,0.58393536121673,0
"<anonymized_userid>",1,52189,6144,"Geert Wilders (PVV)",0.922637673472996,0.584030418250951,0
"<anonymized_userid>",1,52190,6145,"Geert Wilders (PVV)",0.922655352249624,0.584125475285171,0
"<anonymized_userid>",1,52191,6146,"Geert Wilders (PVV)",0.922673031026253,0.584220532319392,0
"<anonymized_userid>",1,52192,6147,"Geert Wilders (PVV)",0.922690709802882,0.584315589353612,0
"<anonymized_userid>",1,52193,6148,"Geert Wilders (PVV)",0.92270838857951,0.584410646387833,0
"<anonymized_userid>",1,52194,6149,"Geert Wilders (PVV)",0.922726067356139,0.584505703422053,0
"<anonymized_userid>",1,52195,6150,"Geert Wilders (PVV)",0.922743746132768,0.584600760456274,0
"<anonymized_userid>",1,52196,6151,"Geert Wilders (PVV)",0.922761424909396,0.584695817490494,0
"<anonymized_userid>",1,52197,6152,"Geert Wilders (PVV)",0.922779103686025,0.584790874524715,0
"<anonymized_userid>",1,52198,6153,"Geert Wilders (PVV)",0.922796782462654,0.584885931558935,0
"<anonymized_userid>",1,52199,6154,"Geert Wilders (PVV)",0.922814461239282,0.584980988593156,0
"<anonymized_userid>",1,52200,6155,"Geert Wilders (PVV)",0.922832140015911,0.585076045627376,0
"<anonymized_userid>",1,52201,6156,"Geert Wilders (PVV)",0.92284981879254,0.585171102661597,0
"<anonymized_userid>",1,52202,6157,"Geert Wilders (PVV)",0.922867497569168,0.585266159695818,0
"<anonymized_userid>",1,52203,6158,"Geert Wilders (PVV)",0.922885176345797,0.585361216730038,0
"<anonymized_userid>",1,52204,6159,"Geert Wilders (PVV)",0.922902855122426,0.585456273764259,0
"<anonymized_userid>",1,52205,6160,"Geert Wilders (PVV)",0.922920533899054,0.585551330798479,0
"<anonymized_userid>",1,52206,6161,"Geert Wilders (PVV)",0.922938212675683,0.5856463878327,0
"<anonymized_userid>",1,52207,6162,"Geert Wilders (PVV)",0.922955891452311,0.58574144486692,0
"<anonymized_userid>",1,52208,6163,"Geert Wilders (PVV)",0.92297357022894,0.585836501901141,0
"<anonymized_userid>",1,52209,6164,"Geert Wilders (PVV)",0.922991249005569,0.585931558935361,0
"<anonymized_userid>",1,52210,6165,"Geert Wilders (PVV)",0.923008927782197,0.586026615969582,0
"<anonymized_userid>",1,52211,6166,"Geert Wilders (PVV)",0.923026606558826,0.586121673003802,0
"<anonymized_userid>",1,52212,6167,"Geert Wilders (PVV)",0.923044285335455,0.586216730038023,0
"<anonymized_userid>",1,52213,6168,"Geert Wilders (PVV)",0.923061964112083,0.586311787072243,0
"<anonymized_userid>",1,52214,6169,"Geert Wilders (PVV)",0.923079642888712,0.586406844106464,0
"<anonymized_userid>",1,52215,6170,"Geert Wilders (PVV)",0.923097321665341,0.586501901140684,0
"<anonymized_userid>",1,52216,6171,"Geert Wilders (PVV)",0.923115000441969,0.586596958174905,0
"<anonymized_userid>",1,52217,6172,"Geert Wilders (PVV)",0.923132679218598,0.586692015209126,0
"<anonymized_userid>",1,52218,6173,"Geert Wilders (PVV)",0.923150357995227,0.586787072243346,0
"<anonymized_userid>",1,52219,6174,"Geert Wilders (PVV)",0.923168036771855,0.586882129277567,0
"<anonymized_userid>",1,52220,6175,"Geert Wilders (PVV)",0.923185715548484,0.586977186311787,0
"<anonymized_userid>",1,52221,6176,"Geert Wilders (PVV)",0.923203394325113,0.587072243346008,0
"<anonymized_userid>",1,52222,6177,"Geert Wilders (PVV)",0.923221073101741,0.587167300380228,0
"<anonymized_userid>",1,52223,6178,"Geert Wilders (PVV)",0.92323875187837,0.587262357414449,0
"<anonymized_userid>",1,52224,6179,"Geert Wilders (PVV)",0.923256430654999,0.587357414448669,0
"<anonymized_userid>",1,52225,6180,"Geert Wilders (PVV)",0.923274109431627,0.58745247148289,0
"<anonymized_userid>",1,52226,6181,"Geert Wilders (PVV)",0.923291788208256,0.58754752851711,0
"<anonymized_userid>",1,52227,6182,"Geert Wilders (PVV)",0.923309466984885,0.587642585551331,0
"<anonymized_userid>",1,52228,6183,"Geert Wilders (PVV)",0.923327145761513,0.587737642585551,0
"<anonymized_userid>",1,52229,6184,"Geert Wilders (PVV)",0.923344824538142,0.587832699619772,0
"<anonymized_userid>",1,52230,6185,"Geert Wilders (PVV)",0.923362503314771,0.587927756653992,0
"<anonymized_userid>",1,52231,6186,"Geert Wilders (PVV)",0.923380182091399,0.588022813688213,0
"<anonymized_userid>",1,52232,6187,"Geert Wilders (PVV)",0.923397860868028,0.588117870722433,0
"<anonymized_userid>",1,52233,6188,"Geert Wilders (PVV)",0.923415539644657,0.588212927756654,0
"<anonymized_userid>",1,52234,6189,"Geert Wilders (PVV)",0.923433218421285,0.588307984790875,0
"<anonymized_userid>",1,52235,6190,"Geert Wilders (PVV)",0.923450897197914,0.588403041825095,0
"<anonymized_userid>",1,52236,6191,"Geert Wilders (PVV)",0.923468575974543,0.588498098859316,0
"<anonymized_userid>",1,52237,6192,"Geert Wilders (PVV)",0.923486254751171,0.588593155893536,0
"<anonymized_userid>",1,52238,6193,"Geert Wilders (PVV)",0.9235039335278,0.588688212927757,0
"<anonymized_userid>",1,52239,6194,"Geert Wilders (PVV)",0.923521612304429,0.588783269961977,0
"<anonymized_userid>",1,52240,6195,"Geert Wilders (PVV)",0.923539291081057,0.588878326996198,0
"<anonymized_userid>",1,52241,6196,"Geert Wilders (PVV)",0.923556969857686,0.588973384030418,0
"<anonymized_userid>",1,52242,6197,"Geert Wilders (PVV)",0.923574648634314,0.589068441064639,0
"<anonymized_userid>",1,52243,6198,"Geert Wilders (PVV)",0.923592327410943,0.589163498098859,0
"<anonymized_userid>",1,52244,6199,"Geert Wilders (PVV)",0.923610006187572,0.58925855513308,0
"<anonymized_userid>",1,52245,6200,"Geert Wilders (PVV)",0.9236276849642,0.5893536121673,0
"<anonymized_userid>",1,52246,6201,"Geert Wilders (PVV)",0.923645363740829,0.589448669201521,0
"<anonymized_userid>",1,52247,6202,"Geert Wilders (PVV)",0.923663042517458,0.589543726235741,0
"<anonymized_userid>",1,52248,6203,"Geert Wilders (PVV)",0.923680721294086,0.589638783269962,0
"<anonymized_userid>",1,52249,6204,"Geert Wilders (PVV)",0.923698400070715,0.589733840304183,0
"<anonymized_userid>",1,52250,6205,"Geert Wilders (PVV)",0.923716078847344,0.589828897338403,0
"<anonymized_userid>",1,52251,6206,"Geert Wilders (PVV)",0.923733757623972,0.589923954372624,0
"<anonymized_userid>",1,52252,6207,"Geert Wilders (PVV)",0.923751436400601,0.590019011406844,0
"<anonymized_userid>",1,52253,6208,"Geert Wilders (PVV)",0.92376911517723,0.590114068441065,0
"<anonymized_userid>",1,52254,6209,"Geert Wilders (PVV)",0.923786793953858,0.590209125475285,0
"<anonymized_userid>",1,52255,6210,"Geert Wilders (PVV)",0.923804472730487,0.590304182509506,0
"<anonymized_userid>",1,52256,6211,"Geert Wilders (PVV)",0.923822151507116,0.590399239543726,0
"<anonymized_userid>",1,52257,6212,"Geert Wilders (PVV)",0.923839830283744,0.590494296577947,0
"<anonymized_userid>",1,52258,6213,"Geert Wilders (PVV)",0.923857509060373,0.590589353612167,0
"<anonymized_userid>",1,52259,6214,"Geert Wilders (PVV)",0.923875187837002,0.590684410646388,0
"<anonymized_userid>",1,52260,6215,"Geert Wilders (PVV)",0.92389286661363,0.590779467680608,0
"<anonymized_userid>",1,52261,6216,"Geert Wilders (PVV)",0.923910545390259,0.590874524714829,0
"<anonymized_userid>",1,52262,6217,"Geert Wilders (PVV)",0.923928224166888,0.590969581749049,0
"<anonymized_userid>",1,52263,6218,"Geert Wilders (PVV)",0.923945902943516,0.59106463878327,0
"<anonymized_userid>",1,52264,6219,"Geert Wilders (PVV)",0.923963581720145,0.591159695817491,0
"<anonymized_userid>",1,52265,6220,"Geert Wilders (PVV)",0.923981260496774,0.591254752851711,0
"<anonymized_userid>",1,52266,6221,"Geert Wilders (PVV)",0.923998939273402,0.591349809885932,0
"<anonymized_userid>",1,52267,6222,"Geert Wilders (PVV)",0.924016618050031,0.591444866920152,0
"<anonymized_userid>",1,52268,6223,"Geert Wilders (PVV)",0.92403429682666,0.591539923954373,0
"<anonymized_userid>",1,52269,6224,"Geert Wilders (PVV)",0.924051975603288,0.591634980988593,0
"<anonymized_userid>",1,52270,6225,"Geert Wilders (PVV)",0.924069654379917,0.591730038022814,0
"<anonymized_userid>",1,52271,6226,"Geert Wilders (PVV)",0.924087333156546,0.591825095057034,0
"<anonymized_userid>",1,52272,6227,"Geert Wilders (PVV)",0.924105011933174,0.591920152091255,0
"<anonymized_userid>",1,52273,6228,"Geert Wilders (PVV)",0.924122690709803,0.592015209125475,0
"<anonymized_userid>",1,52274,6229,"Geert Wilders (PVV)",0.924140369486432,0.592110266159696,0
"<anonymized_userid>",1,52275,6230,"Geert Wilders (PVV)",0.92415804826306,0.592205323193916,0
"<anonymized_userid>",1,52276,6231,"Geert Wilders (PVV)",0.924175727039689,0.592300380228137,0
"<anonymized_userid>",1,52277,6232,"Geert Wilders (PVV)",0.924193405816317,0.592395437262357,0
"<anonymized_userid>",1,52278,6233,"Geert Wilders (PVV)",0.924211084592946,0.592490494296578,0
"<anonymized_userid>",1,52279,6234,"Geert Wilders (PVV)",0.924228763369575,0.592585551330798,0
"<anonymized_userid>",1,52280,6235,"Geert Wilders (PVV)",0.924246442146203,0.592680608365019,0
"<anonymized_userid>",1,52281,6236,"Geert Wilders (PVV)",0.924264120922832,0.59277566539924,0
"<anonymized_userid>",1,52282,6237,"Geert Wilders (PVV)",0.924281799699461,0.59287072243346,0
"<anonymized_userid>",1,52283,6238,"Geert Wilders (PVV)",0.92429947847609,0.592965779467681,0
"<anonymized_userid>",1,52284,6239,"Geert Wilders (PVV)",0.924317157252718,0.593060836501901,0
"<anonymized_userid>",1,52285,6240,"Geert Wilders (PVV)",0.924334836029347,0.593155893536122,0
"<anonymized_userid>",1,52286,6241,"Geert Wilders (PVV)",0.924352514805975,0.593250950570342,0
"<anonymized_userid>",1,52287,6242,"Geert Wilders (PVV)",0.924370193582604,0.593346007604563,0
"<anonymized_userid>",1,52288,6243,"Geert Wilders (PVV)",0.924387872359233,0.593441064638783,0
"<anonymized_userid>",1,52289,6244,"Geert Wilders (PVV)",0.924405551135861,0.593536121673004,0
"<anonymized_userid>",1,52290,6245,"Geert Wilders (PVV)",0.92442322991249,0.593631178707224,0
"<anonymized_userid>",1,52291,6246,"Geert Wilders (PVV)",0.924440908689119,0.593726235741445,0
"<anonymized_userid>",1,52292,6247,"Geert Wilders (PVV)",0.924458587465747,0.593821292775665,0
"<anonymized_userid>",1,52293,6248,"Geert Wilders (PVV)",0.924476266242376,0.593916349809886,0
"<anonymized_userid>",1,52294,6249,"Geert Wilders (PVV)",0.924493945019005,0.594011406844106,0
"<anonymized_userid>",1,52295,6250,"Geert Wilders (PVV)",0.924511623795633,0.594106463878327,0
"<anonymized_userid>",1,52296,6251,"Geert Wilders (PVV)",0.924529302572262,0.594201520912548,0
"<anonymized_userid>",1,52297,6252,"Geert Wilders (PVV)",0.924546981348891,0.594296577946768,0
"<anonymized_userid>",1,52298,6253,"Geert Wilders (PVV)",0.924564660125519,0.594391634980989,0
"<anonymized_userid>",1,52299,6254,"Geert Wilders (PVV)",0.924582338902148,0.594486692015209,0
"<anonymized_userid>",1,52300,6255,"Geert Wilders (PVV)",0.924600017678777,0.59458174904943,0
"<anonymized_userid>",1,52301,6256,"Geert Wilders (PVV)",0.924617696455405,0.59467680608365,0
"<anonymized_userid>",1,52302,6257,"Geert Wilders (PVV)",0.924635375232034,0.594771863117871,0
"<anonymized_userid>",1,52303,6258,"Geert Wilders (PVV)",0.924653054008663,0.594866920152091,0
"<anonymized_userid>",1,52304,6259,"Geert Wilders (PVV)",0.924670732785291,0.594961977186312,0
"<anonymized_userid>",1,52305,6260,"Geert Wilders (PVV)",0.92468841156192,0.595057034220532,0
"<anonymized_userid>",1,52306,6261,"Geert Wilders (PVV)",0.924706090338549,0.595152091254753,0
"<anonymized_userid>",1,52307,6262,"Geert Wilders (PVV)",0.924723769115177,0.595247148288973,0
"<anonymized_userid>",1,52308,6263,"Geert Wilders (PVV)",0.924741447891806,0.595342205323194,0
"<anonymized_userid>",1,52309,6264,"Geert Wilders (PVV)",0.924759126668435,0.595437262357414,0
"<anonymized_userid>",1,52310,6265,"Geert Wilders (PVV)",0.924776805445063,0.595532319391635,0
"<anonymized_userid>",1,52311,6266,"Geert Wilders (PVV)",0.924794484221692,0.595627376425856,0
"<anonymized_userid>",1,52312,6267,"Geert Wilders (PVV)",0.92481216299832,0.595722433460076,0
"<anonymized_userid>",1,52313,6268,"Geert Wilders (PVV)",0.924829841774949,0.595817490494297,0
"<anonymized_userid>",1,52314,6269,"Geert Wilders (PVV)",0.924847520551578,0.595912547528517,0
"<anonymized_userid>",1,52315,6270,"Geert Wilders (PVV)",0.924865199328206,0.596007604562738,0
"<anonymized_userid>",1,52316,6271,"Geert Wilders (PVV)",0.924882878104835,0.596102661596958,0
"<anonymized_userid>",1,52317,6272,"Geert Wilders (PVV)",0.924900556881464,0.596197718631179,0
"<anonymized_userid>",1,52318,6273,"Geert Wilders (PVV)",0.924918235658093,0.596292775665399,0
"<anonymized_userid>",1,52319,6274,"Geert Wilders (PVV)",0.924935914434721,0.59638783269962,0
"<anonymized_userid>",1,52320,6275,"Geert Wilders (PVV)",0.92495359321135,0.59648288973384,0
"<anonymized_userid>",1,52321,6276,"Geert Wilders (PVV)",0.924971271987978,0.596577946768061,0
"<anonymized_userid>",1,52322,6277,"Geert Wilders (PVV)",0.924988950764607,0.596673003802281,0
"<anonymized_userid>",1,52323,6278,"Geert Wilders (PVV)",0.925006629541236,0.596768060836502,0
"<anonymized_userid>",1,52324,6279,"Geert Wilders (PVV)",0.925024308317864,0.596863117870722,0
"<anonymized_userid>",1,52325,6280,"Geert Wilders (PVV)",0.925041987094493,0.596958174904943,0
"<anonymized_userid>",1,52326,6281,"Geert Wilders (PVV)",0.925059665871122,0.597053231939163,0
"<anonymized_userid>",1,52327,6282,"Geert Wilders (PVV)",0.92507734464775,0.597148288973384,0
"<anonymized_userid>",1,52328,6283,"Geert Wilders (PVV)",0.925095023424379,0.597243346007605,0
"<anonymized_userid>",1,52329,6284,"Geert Wilders (PVV)",0.925112702201008,0.597338403041825,0
"<anonymized_userid>",1,52330,6285,"Geert Wilders (PVV)",0.925130380977636,0.597433460076046,0
"<anonymized_userid>",1,52331,6286,"Geert Wilders (PVV)",0.925148059754265,0.597528517110266,0
"<anonymized_userid>",1,52332,6287,"Geert Wilders (PVV)",0.925165738530894,0.597623574144487,0
"<anonymized_userid>",1,52333,6288,"Geert Wilders (PVV)",0.925183417307522,0.597718631178707,0
"<anonymized_userid>",1,52334,6289,"Geert Wilders (PVV)",0.925201096084151,0.597813688212928,0
"<anonymized_userid>",1,52335,6290,"Geert Wilders (PVV)",0.92521877486078,0.597908745247148,0
"<anonymized_userid>",1,52336,6291,"Geert Wilders (PVV)",0.925236453637408,0.598003802281369,0
"<anonymized_userid>",1,52337,6292,"Geert Wilders (PVV)",0.925254132414037,0.598098859315589,0
"<anonymized_userid>",1,52338,6293,"Geert Wilders (PVV)",0.925271811190666,0.59819391634981,0
"<anonymized_userid>",1,52339,6294,"Geert Wilders (PVV)",0.925289489967294,0.59828897338403,0
"<anonymized_userid>",1,52340,6295,"Geert Wilders (PVV)",0.925307168743923,0.598384030418251,0
"<anonymized_userid>",1,52341,6296,"Geert Wilders (PVV)",0.925324847520552,0.598479087452471,0
"<anonymized_userid>",1,52342,6297,"Geert Wilders (PVV)",0.92534252629718,0.598574144486692,0
"<anonymized_userid>",1,52343,6298,"Geert Wilders (PVV)",0.925360205073809,0.598669201520913,0
"<anonymized_userid>",1,52344,6299,"Geert Wilders (PVV)",0.925377883850438,0.598764258555133,0
"<anonymized_userid>",1,52345,6300,"Geert Wilders (PVV)",0.925395562627066,0.598859315589354,0
"<anonymized_userid>",1,52346,6301,"Geert Wilders (PVV)",0.925413241403695,0.598954372623574,0
"<anonymized_userid>",1,52347,6302,"Geert Wilders (PVV)",0.925430920180323,0.599049429657795,0
"<anonymized_userid>",1,52348,6303,"Geert Wilders (PVV)",0.925448598956952,0.599144486692015,0
"<anonymized_userid>",1,52349,6304,"Geert Wilders (PVV)",0.925466277733581,0.599239543726236,0
"<anonymized_userid>",1,52350,6305,"Geert Wilders (PVV)",0.92548395651021,0.599334600760456,0
"<anonymized_userid>",1,52351,6306,"Geert Wilders (PVV)",0.925501635286838,0.599429657794677,0
"<anonymized_userid>",1,52352,6307,"Geert Wilders (PVV)",0.925519314063467,0.599524714828897,0
"<anonymized_userid>",1,52353,6308,"Geert Wilders (PVV)",0.925536992840095,0.599619771863118,0
"<anonymized_userid>",1,52354,6309,"Geert Wilders (PVV)",0.925554671616724,0.599714828897338,0
"<anonymized_userid>",1,52355,6310,"Geert Wilders (PVV)",0.925572350393353,0.599809885931559,0
"<anonymized_userid>",1,52356,6311,"Geert Wilders (PVV)",0.925590029169981,0.599904942965779,0
"<anonymized_userid>",1,52357,6312,"Geert Wilders (PVV)",0.92560770794661,0.6,0
"<anonymized_userid>",1,52358,6313,"Geert Wilders (PVV)",0.925625386723239,0.600095057034221,0
"<anonymized_userid>",1,52359,6314,"Geert Wilders (PVV)",0.925643065499867,0.600190114068441,0
"<anonymized_userid>",1,52360,6315,"Geert Wilders (PVV)",0.925660744276496,0.600285171102662,0
"<anonymized_userid>",1,52361,6316,"Geert Wilders (PVV)",0.925678423053125,0.600380228136882,0
"<anonymized_userid>",1,52362,6317,"Geert Wilders (PVV)",0.925696101829753,0.600475285171103,0
"<anonymized_userid>",1,52363,6318,"Geert Wilders (PVV)",0.925713780606382,0.600570342205323,0
"<anonymized_userid>",1,52364,6319,"Geert Wilders (PVV)",0.925731459383011,0.600665399239544,0
"<anonymized_userid>",1,52365,6320,"Geert Wilders (PVV)",0.925749138159639,0.600760456273764,0
"<anonymized_userid>",1,52366,6321,"Geert Wilders (PVV)",0.925766816936268,0.600855513307985,0
"<anonymized_userid>",1,52367,6322,"Geert Wilders (PVV)",0.925784495712897,0.600950570342205,0
"<anonymized_userid>",1,52368,6323,"Geert Wilders (PVV)",0.925802174489525,0.601045627376426,0
"<anonymized_userid>",1,52369,6324,"Geert Wilders (PVV)",0.925819853266154,0.601140684410646,0
"<anonymized_userid>",1,52370,6325,"Geert Wilders (PVV)",0.925837532042783,0.601235741444867,0
"<anonymized_userid>",1,52371,6326,"Geert Wilders (PVV)",0.925855210819411,0.601330798479087,0
"<anonymized_userid>",1,52372,6327,"Geert Wilders (PVV)",0.92587288959604,0.601425855513308,0
"<anonymized_userid>",1,52373,6328,"Geert Wilders (PVV)",0.925890568372669,0.601520912547528,0
"<anonymized_userid>",1,52374,6329,"Geert Wilders (PVV)",0.925908247149297,0.601615969581749,0
"<anonymized_userid>",1,52375,6330,"Geert Wilders (PVV)",0.925925925925926,0.60171102661597,0
"<anonymized_userid>",1,52376,6331,"Geert Wilders (PVV)",0.925943604702555,0.60180608365019,0
"<anonymized_userid>",1,52377,6332,"Geert Wilders (PVV)",0.925961283479183,0.601901140684411,0
"<anonymized_userid>",1,52378,6333,"Geert Wilders (PVV)",0.925978962255812,0.601996197718631,0
"<anonymized_userid>",1,52379,6334,"Geert Wilders (PVV)",0.925996641032441,0.602091254752852,0
"<anonymized_userid>",1,52380,6335,"Geert Wilders (PVV)",0.926014319809069,0.602186311787072,0
"<anonymized_userid>",1,52381,6336,"Geert Wilders (PVV)",0.926031998585698,0.602281368821293,0
"<anonymized_userid>",1,52382,6337,"Geert Wilders (PVV)",0.926049677362327,0.602376425855513,0
"<anonymized_userid>",1,52383,6338,"Geert Wilders (PVV)",0.926067356138955,0.602471482889734,0
"<anonymized_userid>",1,52384,6339,"Geert Wilders (PVV)",0.926085034915584,0.602566539923954,0
"<anonymized_userid>",1,52385,6340,"Geert Wilders (PVV)",0.926102713692213,0.602661596958175,0
"<anonymized_userid>",1,52386,6341,"Geert Wilders (PVV)",0.926120392468841,0.602756653992395,0
"<anonymized_userid>",1,52387,6342,"Geert Wilders (PVV)",0.92613807124547,0.602851711026616,0
"<anonymized_userid>",1,52388,6343,"Geert Wilders (PVV)",0.926155750022098,0.602946768060836,0
"<anonymized_userid>",1,52389,6344,"Geert Wilders (PVV)",0.926173428798727,0.603041825095057,0
"<anonymized_userid>",1,52390,6345,"Geert Wilders (PVV)",0.926191107575356,0.603136882129278,0
"<anonymized_userid>",1,52391,6346,"Geert Wilders (PVV)",0.926208786351984,0.603231939163498,0
"<anonymized_userid>",1,52392,6347,"Geert Wilders (PVV)",0.926226465128613,0.603326996197719,0
"<anonymized_userid>",1,52393,6348,"Geert Wilders (PVV)",0.926244143905242,0.603422053231939,0
"<anonymized_userid>",1,52394,6349,"Geert Wilders (PVV)",0.92626182268187,0.60351711026616,0
"<anonymized_userid>",1,52395,6350,"Geert Wilders (PVV)",0.926279501458499,0.60361216730038,0
"<anonymized_userid>",1,52396,6351,"Geert Wilders (PVV)",0.926297180235128,0.603707224334601,0
"<anonymized_userid>",1,52397,6352,"Geert Wilders (PVV)",0.926314859011756,0.603802281368821,0
"<anonymized_userid>",1,52398,6353,"Geert Wilders (PVV)",0.926332537788385,0.603897338403042,0
"<anonymized_userid>",1,52399,6354,"Geert Wilders (PVV)",0.926350216565014,0.603992395437262,0
"<anonymized_userid>",1,52400,6355,"Geert Wilders (PVV)",0.926367895341642,0.604087452471483,0
"<anonymized_userid>",1,52401,6356,"Geert Wilders (PVV)",0.926385574118271,0.604182509505703,0
"<anonymized_userid>",1,52402,6357,"Geert Wilders (PVV)",0.9264032528949,0.604277566539924,0
"<anonymized_userid>",1,52403,6358,"Geert Wilders (PVV)",0.926420931671528,0.604372623574144,0
"<anonymized_userid>",1,52404,6359,"Geert Wilders (PVV)",0.926438610448157,0.604467680608365,0
"<anonymized_userid>",1,52405,6360,"Geert Wilders (PVV)",0.926456289224786,0.604562737642586,0
"<anonymized_userid>",1,52406,6361,"Geert Wilders (PVV)",0.926473968001414,0.604657794676806,0
"<anonymized_userid>",1,52407,6362,"Geert Wilders (PVV)",0.926491646778043,0.604752851711027,0
"<anonymized_userid>",1,52408,6363,"Geert Wilders (PVV)",0.926509325554672,0.604847908745247,0
"<anonymized_userid>",1,52409,6364,"Geert Wilders (PVV)",0.9265270043313,0.604942965779468,0
"<anonymized_userid>",1,52410,6365,"Geert Wilders (PVV)",0.926544683107929,0.605038022813688,0
"<anonymized_userid>",1,52411,6366,"Geert Wilders (PVV)",0.926562361884558,0.605133079847909,0
"<anonymized_userid>",1,52412,6367,"Geert Wilders (PVV)",0.926580040661186,0.605228136882129,0
"<anonymized_userid>",1,52413,6368,"Geert Wilders (PVV)",0.926597719437815,0.60532319391635,0
"<anonymized_userid>",1,52414,6369,"Geert Wilders (PVV)",0.926615398214444,0.60541825095057,0
"<anonymized_userid>",1,52415,6370,"Geert Wilders (PVV)",0.926633076991072,0.605513307984791,0
"<anonymized_userid>",1,52416,6371,"Geert Wilders (PVV)",0.926650755767701,0.605608365019011,0
"<anonymized_userid>",1,52417,6372,"Geert Wilders (PVV)",0.92666843454433,0.605703422053232,0
"<anonymized_userid>",1,52418,6373,"Geert Wilders (PVV)",0.926686113320958,0.605798479087452,0
"<anonymized_userid>",1,52419,6374,"Geert Wilders (PVV)",0.926703792097587,0.605893536121673,0
"<anonymized_userid>",1,52420,6375,"Geert Wilders (PVV)",0.926721470874216,0.605988593155893,0
"<anonymized_userid>",1,52421,6376,"Geert Wilders (PVV)",0.926739149650844,0.606083650190114,0
"<anonymized_userid>",1,52422,6377,"Geert Wilders (PVV)",0.926756828427473,0.606178707224335,0
"<anonymized_userid>",1,52423,6378,"Geert Wilders (PVV)",0.926774507204101,0.606273764258555,0
"<anonymized_userid>",1,52424,6379,"Geert Wilders (PVV)",0.92679218598073,0.606368821292776,0
"<anonymized_userid>",1,52425,6380,"Geert Wilders (PVV)",0.926809864757359,0.606463878326996,0
"<anonymized_userid>",1,52426,6381,"Geert Wilders (PVV)",0.926827543533987,0.606558935361217,0
"<anonymized_userid>",1,52427,6382,"Geert Wilders (PVV)",0.926845222310616,0.606653992395437,0
"<anonymized_userid>",1,52428,6383,"Geert Wilders (PVV)",0.926862901087245,0.606749049429658,0
"<anonymized_userid>",1,52429,6384,"Geert Wilders (PVV)",0.926880579863873,0.606844106463878,0
"<anonymized_userid>",1,52430,6385,"Geert Wilders (PVV)",0.926898258640502,0.606939163498099,0
"<anonymized_userid>",1,52431,6386,"Geert Wilders (PVV)",0.926915937417131,0.607034220532319,0
"<anonymized_userid>",1,52432,6387,"Geert Wilders (PVV)",0.926933616193759,0.60712927756654,0
"<anonymized_userid>",1,52433,6388,"Geert Wilders (PVV)",0.926951294970388,0.60722433460076,0
"<anonymized_userid>",1,52434,6389,"Geert Wilders (PVV)",0.926968973747017,0.607319391634981,0
"<anonymized_userid>",1,52435,6390,"Geert Wilders (PVV)",0.926986652523645,0.607414448669201,0
"<anonymized_userid>",1,52436,6391,"Geert Wilders (PVV)",0.927004331300274,0.607509505703422,0
"<anonymized_userid>",1,52437,6392,"Geert Wilders (PVV)",0.927022010076903,0.607604562737643,0
"<anonymized_userid>",1,52438,6393,"Geert Wilders (PVV)",0.927039688853531,0.607699619771863,0
"<anonymized_userid>",1,52439,6394,"Geert Wilders (PVV)",0.92705736763016,0.607794676806084,0
"<anonymized_userid>",1,52440,6395,"Geert Wilders (PVV)",0.927075046406789,0.607889733840304,0
"<anonymized_userid>",1,52441,6396,"Geert Wilders (PVV)",0.927092725183417,0.607984790874525,0
"<anonymized_userid>",1,52442,6397,"Geert Wilders (PVV)",0.927110403960046,0.608079847908745,0
"<anonymized_userid>",1,52443,6398,"Geert Wilders (PVV)",0.927128082736675,0.608174904942966,0
"<anonymized_userid>",1,52444,6399,"Geert Wilders (PVV)",0.927145761513303,0.608269961977186,0
"<anonymized_userid>",1,52445,6400,"Geert Wilders (PVV)",0.927163440289932,0.608365019011407,0
"<anonymized_userid>",1,52446,6401,"Geert Wilders (PVV)",0.927181119066561,0.608460076045627,0
"<anonymized_userid>",1,52447,6402,"Geert Wilders (PVV)",0.927198797843189,0.608555133079848,0
"<anonymized_userid>",1,52448,6403,"Geert Wilders (PVV)",0.927216476619818,0.608650190114068,0
"<anonymized_userid>",1,52449,6404,"Geert Wilders (PVV)",0.927234155396447,0.608745247148289,0
"<anonymized_userid>",1,52450,6405,"Geert Wilders (PVV)",0.927251834173075,0.608840304182509,0
"<anonymized_userid>",1,52451,6406,"Geert Wilders (PVV)",0.927269512949704,0.60893536121673,0
"<anonymized_userid>",1,52452,6407,"Geert Wilders (PVV)",0.927287191726333,0.609030418250951,0
"<anonymized_userid>",1,52453,6408,"Geert Wilders (PVV)",0.927304870502961,0.609125475285171,0
"<anonymized_userid>",1,52454,6409,"Geert Wilders (PVV)",0.92732254927959,0.609220532319392,0
"<anonymized_userid>",1,52455,6410,"Geert Wilders (PVV)",0.927340228056219,0.609315589353612,0
"<anonymized_userid>",1,52456,6411,"Geert Wilders (PVV)",0.927357906832847,0.609410646387833,0
"<anonymized_userid>",1,52457,6412,"Geert Wilders (PVV)",0.927375585609476,0.609505703422053,0
"<anonymized_userid>",1,52458,6413,"Geert Wilders (PVV)",0.927393264386104,0.609600760456274,0
"<anonymized_userid>",1,52459,6414,"Geert Wilders (PVV)",0.927410943162733,0.609695817490494,0
"<anonymized_userid>",1,52460,6415,"Geert Wilders (PVV)",0.927428621939362,0.609790874524715,0
"<anonymized_userid>",1,52461,6416,"Geert Wilders (PVV)",0.92744630071599,0.609885931558935,0
"<anonymized_userid>",1,52462,6417,"Geert Wilders (PVV)",0.927463979492619,0.609980988593156,0
"<anonymized_userid>",1,52463,6418,"Geert Wilders (PVV)",0.927481658269248,0.610076045627376,0
"<anonymized_userid>",1,52464,6419,"Geert Wilders (PVV)",0.927499337045876,0.610171102661597,0
"<anonymized_userid>",1,52465,6420,"Geert Wilders (PVV)",0.927517015822505,0.610266159695818,0
"<anonymized_userid>",1,52466,6421,"Geert Wilders (PVV)",0.927534694599134,0.610361216730038,0
"<anonymized_userid>",1,52467,6422,"Geert Wilders (PVV)",0.927552373375762,0.610456273764259,0
"<anonymized_userid>",1,52468,6423,"Geert Wilders (PVV)",0.927570052152391,0.610551330798479,0
"<anonymized_userid>",1,52469,6424,"Geert Wilders (PVV)",0.92758773092902,0.6106463878327,0
"<anonymized_userid>",1,52470,6425,"Geert Wilders (PVV)",0.927605409705648,0.61074144486692,0
"<anonymized_userid>",1,52471,6426,"Geert Wilders (PVV)",0.927623088482277,0.610836501901141,0
"<anonymized_userid>",1,52472,6427,"Geert Wilders (PVV)",0.927640767258906,0.610931558935361,0
"<anonymized_userid>",1,52473,6428,"Geert Wilders (PVV)",0.927658446035534,0.611026615969582,0
"<anonymized_userid>",1,52474,6429,"Geert Wilders (PVV)",0.927676124812163,0.611121673003802,0
"<anonymized_userid>",1,52475,6430,"Geert Wilders (PVV)",0.927693803588792,0.611216730038023,0
"<anonymized_userid>",1,52476,6431,"Geert Wilders (PVV)",0.92771148236542,0.611311787072243,0
"<anonymized_userid>",1,52477,6432,"Geert Wilders (PVV)",0.927729161142049,0.611406844106464,0
"<anonymized_userid>",1,52478,6433,"Geert Wilders (PVV)",0.927746839918678,0.611501901140684,0
"<anonymized_userid>",1,52479,6434,"Geert Wilders (PVV)",0.927764518695306,0.611596958174905,0
"<anonymized_userid>",1,52480,6435,"Geert Wilders (PVV)",0.927782197471935,0.611692015209126,0
"<anonymized_userid>",1,52481,6436,"Geert Wilders (PVV)",0.927799876248564,0.611787072243346,0
"<anonymized_userid>",1,52482,6437,"Geert Wilders (PVV)",0.927817555025192,0.611882129277567,0
"<anonymized_userid>",1,52483,6438,"Geert Wilders (PVV)",0.927835233801821,0.611977186311787,0
"<anonymized_userid>",1,52484,6439,"Geert Wilders (PVV)",0.92785291257845,0.612072243346008,0
"<anonymized_userid>",1,52485,6440,"Geert Wilders (PVV)",0.927870591355078,0.612167300380228,0
"<anonymized_userid>",1,52486,6441,"Geert Wilders (PVV)",0.927888270131707,0.612262357414449,0
"<anonymized_userid>",1,52487,6442,"Geert Wilders (PVV)",0.927905948908336,0.612357414448669,0
"<anonymized_userid>",1,52488,6443,"Geert Wilders (PVV)",0.927923627684964,0.61245247148289,0
"<anonymized_userid>",1,52489,6444,"Geert Wilders (PVV)",0.927941306461593,0.61254752851711,0
"<anonymized_userid>",1,52490,6445,"Geert Wilders (PVV)",0.927958985238222,0.612642585551331,0
"<anonymized_userid>",1,52491,6446,"Geert Wilders (PVV)",0.92797666401485,0.612737642585551,0
"<anonymized_userid>",1,52492,6447,"Geert Wilders (PVV)",0.927994342791479,0.612832699619772,0
"<anonymized_userid>",1,52493,6448,"Geert Wilders (PVV)",0.928012021568107,0.612927756653992,0
"<anonymized_userid>",1,52494,6449,"Geert Wilders (PVV)",0.928029700344736,0.613022813688213,0
"<anonymized_userid>",1,52495,6450,"Geert Wilders (PVV)",0.928047379121365,0.613117870722434,0
"<anonymized_userid>",1,52496,6451,"Geert Wilders (PVV)",0.928065057897993,0.613212927756654,0
"<anonymized_userid>",1,52497,6452,"Geert Wilders (PVV)",0.928082736674622,0.613307984790875,0
"<anonymized_userid>",1,52498,6453,"Geert Wilders (PVV)",0.928100415451251,0.613403041825095,0
"<anonymized_userid>",1,52499,6454,"Geert Wilders (PVV)",0.928118094227879,0.613498098859316,0
"<anonymized_userid>",1,52500,6455,"Geert Wilders (PVV)",0.928135773004508,0.613593155893536,0
"<anonymized_userid>",1,52501,6456,"Geert Wilders (PVV)",0.928153451781137,0.613688212927757,0
"<anonymized_userid>",1,52502,6457,"Geert Wilders (PVV)",0.928171130557765,0.613783269961977,0
"<anonymized_userid>",1,52503,6458,"Geert Wilders (PVV)",0.928188809334394,0.613878326996198,0
"<anonymized_userid>",1,52504,6459,"Geert Wilders (PVV)",0.928206488111023,0.613973384030418,0
"<anonymized_userid>",1,52505,6460,"Geert Wilders (PVV)",0.928224166887651,0.614068441064639,0
"<anonymized_userid>",1,52506,6461,"Geert Wilders (PVV)",0.92824184566428,0.614163498098859,0
"<anonymized_userid>",1,52507,6462,"Geert Wilders (PVV)",0.928259524440909,0.61425855513308,0
"<anonymized_userid>",1,52508,6463,"Geert Wilders (PVV)",0.928277203217537,0.6143536121673,0
"<anonymized_userid>",1,52509,6464,"Geert Wilders (PVV)",0.928294881994166,0.614448669201521,0
"<anonymized_userid>",1,52510,6465,"Geert Wilders (PVV)",0.928312560770795,0.614543726235741,0
"<anonymized_userid>",1,52511,6466,"Geert Wilders (PVV)",0.928330239547423,0.614638783269962,0
"<anonymized_userid>",1,52512,6467,"Geert Wilders (PVV)",0.928347918324052,0.614733840304183,0
"<anonymized_userid>",1,52513,6468,"Geert Wilders (PVV)",0.928365597100681,0.614828897338403,0
"<anonymized_userid>",1,52514,6469,"Geert Wilders (PVV)",0.928383275877309,0.614923954372624,0
"<anonymized_userid>",1,52515,6470,"Geert Wilders (PVV)",0.928400954653938,0.615019011406844,0
"<anonymized_userid>",1,52516,6471,"Geert Wilders (PVV)",0.928418633430567,0.615114068441065,0
"<anonymized_userid>",1,52517,6472,"Geert Wilders (PVV)",0.928436312207195,0.615209125475285,0
"<anonymized_userid>",1,52518,6473,"Geert Wilders (PVV)",0.928453990983824,0.615304182509506,0
"<anonymized_userid>",1,52519,6474,"Geert Wilders (PVV)",0.928471669760453,0.615399239543726,0
"<anonymized_userid>",1,52520,6475,"Geert Wilders (PVV)",0.928489348537081,0.615494296577947,0
"<anonymized_userid>",1,52521,6476,"Geert Wilders (PVV)",0.92850702731371,0.615589353612167,0
"<anonymized_userid>",1,52522,6477,"Geert Wilders (PVV)",0.928524706090339,0.615684410646388,0
"<anonymized_userid>",1,52523,6478,"Geert Wilders (PVV)",0.928542384866967,0.615779467680608,0
"<anonymized_userid>",1,52524,6479,"Geert Wilders (PVV)",0.928560063643596,0.615874524714829,0
"<anonymized_userid>",1,52525,6480,"Geert Wilders (PVV)",0.928577742420225,0.615969581749049,0
"<anonymized_userid>",1,52526,6481,"Geert Wilders (PVV)",0.928595421196853,0.61606463878327,0
"<anonymized_userid>",1,52527,6482,"Geert Wilders (PVV)",0.928613099973482,0.616159695817491,0
"<anonymized_userid>",1,52528,6483,"Geert Wilders (PVV)",0.92863077875011,0.616254752851711,0
"<anonymized_userid>",1,52529,6484,"Geert Wilders (PVV)",0.928648457526739,0.616349809885932,0
"<anonymized_userid>",1,52530,6485,"Geert Wilders (PVV)",0.928666136303368,0.616444866920152,0
"<anonymized_userid>",1,52531,6486,"Geert Wilders (PVV)",0.928683815079996,0.616539923954373,0
"<anonymized_userid>",1,52532,6487,"Geert Wilders (PVV)",0.928701493856625,0.616634980988593,0
"<anonymized_userid>",1,52533,6488,"Geert Wilders (PVV)",0.928719172633254,0.616730038022814,0
"<anonymized_userid>",1,52534,6489,"Geert Wilders (PVV)",0.928736851409882,0.616825095057034,0
"<anonymized_userid>",1,52535,6490,"Geert Wilders (PVV)",0.928754530186511,0.616920152091255,0
"<anonymized_userid>",1,52536,6491,"Geert Wilders (PVV)",0.92877220896314,0.617015209125475,0
"<anonymized_userid>",1,52537,6492,"Geert Wilders (PVV)",0.928789887739768,0.617110266159696,0
"<anonymized_userid>",1,52538,6493,"Geert Wilders (PVV)",0.928807566516397,0.617205323193916,0
"<anonymized_userid>",1,52539,6494,"Geert Wilders (PVV)",0.928825245293026,0.617300380228137,0
"<anonymized_userid>",1,52540,6495,"Geert Wilders (PVV)",0.928842924069654,0.617395437262357,0
"<anonymized_userid>",1,52541,6496,"Geert Wilders (PVV)",0.928860602846283,0.617490494296578,0
"<anonymized_userid>",1,52542,6497,"Geert Wilders (PVV)",0.928878281622912,0.617585551330799,0
"<anonymized_userid>",1,52543,6498,"Geert Wilders (PVV)",0.92889596039954,0.617680608365019,0
"<anonymized_userid>",1,52544,6499,"Geert Wilders (PVV)",0.928913639176169,0.61777566539924,0
"<anonymized_userid>",1,52545,6500,"Geert Wilders (PVV)",0.928931317952798,0.61787072243346,0
"<anonymized_userid>",1,52546,6501,"Geert Wilders (PVV)",0.928948996729426,0.617965779467681,0
"<anonymized_userid>",1,52547,6502,"Geert Wilders (PVV)",0.928966675506055,0.618060836501901,0
"<anonymized_userid>",1,52548,6503,"Geert Wilders (PVV)",0.928984354282684,0.618155893536122,0
"<anonymized_userid>",1,52549,6504,"Geert Wilders (PVV)",0.929002033059312,0.618250950570342,0
"<anonymized_userid>",1,52550,6505,"Geert Wilders (PVV)",0.929019711835941,0.618346007604563,0
"<anonymized_userid>",1,52551,6506,"Geert Wilders (PVV)",0.92903739061257,0.618441064638783,0
"<anonymized_userid>",1,52552,6507,"Geert Wilders (PVV)",0.929055069389198,0.618536121673004,0
"<anonymized_userid>",1,52553,6508,"Geert Wilders (PVV)",0.929072748165827,0.618631178707224,0
"<anonymized_userid>",1,52554,6509,"Geert Wilders (PVV)",0.929090426942456,0.618726235741445,0
"<anonymized_userid>",1,52555,6510,"Geert Wilders (PVV)",0.929108105719084,0.618821292775665,0
"<anonymized_userid>",1,52556,6511,"Geert Wilders (PVV)",0.929125784495713,0.618916349809886,0
"<anonymized_userid>",1,52557,6512,"Geert Wilders (PVV)",0.929143463272342,0.619011406844106,0
"<anonymized_userid>",1,52558,6513,"Geert Wilders (PVV)",0.92916114204897,0.619106463878327,0
"<anonymized_userid>",1,52559,6514,"Geert Wilders (PVV)",0.929178820825599,0.619201520912548,0
"<anonymized_userid>",1,52560,6515,"Geert Wilders (PVV)",0.929196499602227,0.619296577946768,0
"<anonymized_userid>",1,52561,6516,"Geert Wilders (PVV)",0.929214178378856,0.619391634980989,0
"<anonymized_userid>",1,52562,6517,"Geert Wilders (PVV)",0.929231857155485,0.619486692015209,0
"<anonymized_userid>",1,52563,6518,"Geert Wilders (PVV)",0.929249535932113,0.61958174904943,0
"<anonymized_userid>",1,52564,6519,"Geert Wilders (PVV)",0.929267214708742,0.61967680608365,0
"<anonymized_userid>",1,52565,6520,"Geert Wilders (PVV)",0.929284893485371,0.619771863117871,0
"<anonymized_userid>",1,52566,6521,"Geert Wilders (PVV)",0.929302572261999,0.619866920152091,0
"<anonymized_userid>",1,52567,6522,"Geert Wilders (PVV)",0.929320251038628,0.619961977186312,0
"<anonymized_userid>",1,52568,6523,"Geert Wilders (PVV)",0.929337929815257,0.620057034220532,0
"<anonymized_userid>",1,52569,6524,"Geert Wilders (PVV)",0.929355608591885,0.620152091254753,0
"<anonymized_userid>",1,52570,6525,"Geert Wilders (PVV)",0.929373287368514,0.620247148288973,0
"<anonymized_userid>",1,52571,6526,"Geert Wilders (PVV)",0.929390966145143,0.620342205323194,0
"<anonymized_userid>",1,52572,6527,"Geert Wilders (PVV)",0.929408644921771,0.620437262357414,0
"<anonymized_userid>",1,52573,6528,"Geert Wilders (PVV)",0.9294263236984,0.620532319391635,0
"<anonymized_userid>",1,52574,6529,"Geert Wilders (PVV)",0.929444002475029,0.620627376425856,0
"<anonymized_userid>",1,52575,6530,"Geert Wilders (PVV)",0.929461681251657,0.620722433460076,0
"<anonymized_userid>",1,52576,6531,"Geert Wilders (PVV)",0.929479360028286,0.620817490494297,0
"<anonymized_userid>",1,52577,6532,"Geert Wilders (PVV)",0.929497038804915,0.620912547528517,0
"<anonymized_userid>",1,52578,6533,"Geert Wilders (PVV)",0.929514717581543,0.621007604562738,0
"<anonymized_userid>",1,52579,6534,"Geert Wilders (PVV)",0.929532396358172,0.621102661596958,0
"<anonymized_userid>",1,52580,6535,"Geert Wilders (PVV)",0.929550075134801,0.621197718631179,0
"<anonymized_userid>",1,52581,6536,"Geert Wilders (PVV)",0.929567753911429,0.621292775665399,0
"<anonymized_userid>",1,52582,6537,"Geert Wilders (PVV)",0.929585432688058,0.62138783269962,0
"<anonymized_userid>",1,52583,6538,"Geert Wilders (PVV)",0.929603111464687,0.62148288973384,0
"<anonymized_userid>",1,52584,6539,"Geert Wilders (PVV)",0.929620790241315,0.621577946768061,0
"<anonymized_userid>",1,52585,6540,"Geert Wilders (PVV)",0.929638469017944,0.621673003802281,0
"<anonymized_userid>",1,52586,6541,"Geert Wilders (PVV)",0.929656147794573,0.621768060836502,0
"<anonymized_userid>",1,52587,6542,"Geert Wilders (PVV)",0.929673826571201,0.621863117870722,0
"<anonymized_userid>",1,52588,6543,"Geert Wilders (PVV)",0.92969150534783,0.621958174904943,0
"<anonymized_userid>",1,52589,6544,"Geert Wilders (PVV)",0.929709184124459,0.622053231939164,0
"<anonymized_userid>",1,52590,6545,"Geert Wilders (PVV)",0.929726862901087,0.622148288973384,0
"<anonymized_userid>",1,52591,6546,"Geert Wilders (PVV)",0.929744541677716,0.622243346007605,0
"<anonymized_userid>",1,52592,6547,"Geert Wilders (PVV)",0.929762220454345,0.622338403041825,0
"<anonymized_userid>",1,52593,6548,"Geert Wilders (PVV)",0.929779899230973,0.622433460076046,0
"<anonymized_userid>",1,52594,6549,"Geert Wilders (PVV)",0.929797578007602,0.622528517110266,0
"<anonymized_userid>",1,52595,6550,"Geert Wilders (PVV)",0.92981525678423,0.622623574144487,0
"<anonymized_userid>",1,52596,6551,"Geert Wilders (PVV)",0.929832935560859,0.622718631178707,0
"<anonymized_userid>",1,52597,6552,"Geert Wilders (PVV)",0.929850614337488,0.622813688212928,0
"<anonymized_userid>",1,52598,6553,"Geert Wilders (PVV)",0.929868293114116,0.622908745247148,0
"<anonymized_userid>",1,52599,6554,"Geert Wilders (PVV)",0.929885971890745,0.623003802281369,0
"<anonymized_userid>",1,52600,6555,"Geert Wilders (PVV)",0.929903650667374,0.623098859315589,0
"<anonymized_userid>",1,52601,6556,"Geert Wilders (PVV)",0.929921329444003,0.62319391634981,0
"<anonymized_userid>",1,52602,6557,"Geert Wilders (PVV)",0.929939008220631,0.62328897338403,0
"<anonymized_userid>",1,52603,6558,"Geert Wilders (PVV)",0.92995668699726,0.623384030418251,0
"<anonymized_userid>",1,52604,6559,"Geert Wilders (PVV)",0.929974365773888,0.623479087452471,0
"<anonymized_userid>",1,52605,6560,"Geert Wilders (PVV)",0.929992044550517,0.623574144486692,0
"<anonymized_userid>",1,52606,6561,"Geert Wilders (PVV)",0.930009723327146,0.623669201520913,0
"<anonymized_userid>",1,52607,6562,"Geert Wilders (PVV)",0.930027402103774,0.623764258555133,0
"<anonymized_userid>",1,52608,6563,"Geert Wilders (PVV)",0.930045080880403,0.623859315589354,0
"<anonymized_userid>",1,52609,6564,"Geert Wilders (PVV)",0.930062759657032,0.623954372623574,0
"<anonymized_userid>",1,52610,6565,"Geert Wilders (PVV)",0.93008043843366,0.624049429657795,0
"<anonymized_userid>",1,52611,6566,"Geert Wilders (PVV)",0.930098117210289,0.624144486692015,0
"<anonymized_userid>",1,52612,6567,"Geert Wilders (PVV)",0.930115795986918,0.624239543726236,0
"<anonymized_userid>",1,52613,6568,"Geert Wilders (PVV)",0.930133474763546,0.624334600760456,0
"<anonymized_userid>",1,52614,6569,"Geert Wilders (PVV)",0.930151153540175,0.624429657794677,0
"<anonymized_userid>",1,52615,6570,"Geert Wilders (PVV)",0.930168832316804,0.624524714828897,0
"<anonymized_userid>",1,52616,6571,"Geert Wilders (PVV)",0.930186511093432,0.624619771863118,0
"<anonymized_userid>",1,52617,6572,"Geert Wilders (PVV)",0.930204189870061,0.624714828897338,0
"<anonymized_userid>",1,52618,6573,"Geert Wilders (PVV)",0.93022186864669,0.624809885931559,0
"<anonymized_userid>",1,52619,6574,"Geert Wilders (PVV)",0.930239547423318,0.624904942965779,0
"<anonymized_userid>",1,52620,6575,"Geert Wilders (PVV)",0.930257226199947,0.625,0
"<anonymized_userid>",1,52621,6576,"Geert Wilders (PVV)",0.930274904976576,0.625095057034221,0
"<anonymized_userid>",1,52622,6577,"Geert Wilders (PVV)",0.930292583753204,0.625190114068441,0
"<anonymized_userid>",1,52623,6578,"Geert Wilders (PVV)",0.930310262529833,0.625285171102662,0
"<anonymized_userid>",1,52624,6579,"Geert Wilders (PVV)",0.930327941306462,0.625380228136882,0
"<anonymized_userid>",1,52625,6580,"Geert Wilders (PVV)",0.93034562008309,0.625475285171103,0
"<anonymized_userid>",1,52626,6581,"Geert Wilders (PVV)",0.930363298859719,0.625570342205323,0
"<anonymized_userid>",1,52627,6582,"Geert Wilders (PVV)",0.930380977636348,0.625665399239544,0
"<anonymized_userid>",1,52628,6583,"Geert Wilders (PVV)",0.930398656412976,0.625760456273764,0
"<anonymized_userid>",1,52629,6584,"Geert Wilders (PVV)",0.930416335189605,0.625855513307985,0
"<anonymized_userid>",1,52630,6585,"Geert Wilders (PVV)",0.930434013966233,0.625950570342205,0
"<anonymized_userid>",1,52631,6586,"Geert Wilders (PVV)",0.930451692742862,0.626045627376426,0
"<anonymized_userid>",1,52632,6587,"Geert Wilders (PVV)",0.930469371519491,0.626140684410646,0
"<anonymized_userid>",1,52633,6588,"Geert Wilders (PVV)",0.93048705029612,0.626235741444867,0
"<anonymized_userid>",1,52634,6589,"Geert Wilders (PVV)",0.930504729072748,0.626330798479087,0
"<anonymized_userid>",1,52635,6590,"Geert Wilders (PVV)",0.930522407849377,0.626425855513308,0
"<anonymized_userid>",1,52636,6591,"Geert Wilders (PVV)",0.930540086626006,0.626520912547529,0
"<anonymized_userid>",1,52637,6592,"Geert Wilders (PVV)",0.930557765402634,0.626615969581749,0
"<anonymized_userid>",1,52638,6593,"Geert Wilders (PVV)",0.930575444179263,0.62671102661597,0
"<anonymized_userid>",1,52639,6594,"Geert Wilders (PVV)",0.930593122955891,0.62680608365019,0
"<anonymized_userid>",1,52640,6595,"Geert Wilders (PVV)",0.93061080173252,0.626901140684411,0
"<anonymized_userid>",1,52641,6596,"Geert Wilders (PVV)",0.930628480509149,0.626996197718631,0
"<anonymized_userid>",1,52642,6597,"Geert Wilders (PVV)",0.930646159285777,0.627091254752852,0
"<anonymized_userid>",1,52643,6598,"Geert Wilders (PVV)",0.930663838062406,0.627186311787072,0
"<anonymized_userid>",1,52644,6599,"Geert Wilders (PVV)",0.930681516839035,0.627281368821293,0
"<anonymized_userid>",1,52645,6600,"Geert Wilders (PVV)",0.930699195615663,0.627376425855513,0
"<anonymized_userid>",1,52646,6601,"Geert Wilders (PVV)",0.930716874392292,0.627471482889734,0
"<anonymized_userid>",1,52647,6602,"Geert Wilders (PVV)",0.930734553168921,0.627566539923954,0
"<anonymized_userid>",1,52648,6603,"Geert Wilders (PVV)",0.930752231945549,0.627661596958175,0
"<anonymized_userid>",1,52649,6604,"Geert Wilders (PVV)",0.930769910722178,0.627756653992395,0
"<anonymized_userid>",1,52650,6605,"Geert Wilders (PVV)",0.930787589498807,0.627851711026616,0
"<anonymized_userid>",1,52651,6606,"Geert Wilders (PVV)",0.930805268275435,0.627946768060836,0
"<anonymized_userid>",1,52652,6607,"Geert Wilders (PVV)",0.930822947052064,0.628041825095057,0
"<anonymized_userid>",1,52653,6608,"Geert Wilders (PVV)",0.930840625828693,0.628136882129278,0
"<anonymized_userid>",1,52654,6609,"Geert Wilders (PVV)",0.930858304605321,0.628231939163498,0
"<anonymized_userid>",1,52655,6610,"Geert Wilders (PVV)",0.93087598338195,0.628326996197719,0
"<anonymized_userid>",1,52656,6611,"Geert Wilders (PVV)",0.930893662158579,0.628422053231939,0
"<anonymized_userid>",1,52657,6612,"Geert Wilders (PVV)",0.930911340935207,0.62851711026616,0
"<anonymized_userid>",1,52658,6613,"Geert Wilders (PVV)",0.930929019711836,0.62861216730038,0
"<anonymized_userid>",1,52659,6614,"Geert Wilders (PVV)",0.930946698488465,0.628707224334601,0
"<anonymized_userid>",1,52660,6615,"Geert Wilders (PVV)",0.930964377265093,0.628802281368821,0
"<anonymized_userid>",1,52661,6616,"Geert Wilders (PVV)",0.930982056041722,0.628897338403042,0
"<anonymized_userid>",1,52662,6617,"Geert Wilders (PVV)",0.930999734818351,0.628992395437262,0
"<anonymized_userid>",1,52663,6618,"Geert Wilders (PVV)",0.931017413594979,0.629087452471483,0
"<anonymized_userid>",1,52664,6619,"Geert Wilders (PVV)",0.931035092371608,0.629182509505703,0
"<anonymized_userid>",1,52665,6620,"Geert Wilders (PVV)",0.931052771148237,0.629277566539924,0
"<anonymized_userid>",1,52666,6621,"Geert Wilders (PVV)",0.931070449924865,0.629372623574144,0
"<anonymized_userid>",1,52667,6622,"Geert Wilders (PVV)",0.931088128701494,0.629467680608365,0
"<anonymized_userid>",1,52668,6623,"Geert Wilders (PVV)",0.931105807478123,0.629562737642586,0
"<anonymized_userid>",1,52669,6624,"Geert Wilders (PVV)",0.931123486254751,0.629657794676806,0
"<anonymized_userid>",1,52670,6625,"Geert Wilders (PVV)",0.93114116503138,0.629752851711027,0
"<anonymized_userid>",1,52671,6626,"Geert Wilders (PVV)",0.931158843808009,0.629847908745247,0
"<anonymized_userid>",1,52672,6627,"Geert Wilders (PVV)",0.931176522584637,0.629942965779468,0
"<anonymized_userid>",1,52673,6628,"Geert Wilders (PVV)",0.931194201361266,0.630038022813688,0
"<anonymized_userid>",1,52674,6629,"Geert Wilders (PVV)",0.931211880137894,0.630133079847909,0
"<anonymized_userid>",1,52675,6630,"Geert Wilders (PVV)",0.931229558914523,0.630228136882129,0
"<anonymized_userid>",1,52676,6631,"Geert Wilders (PVV)",0.931247237691152,0.63032319391635,0
"<anonymized_userid>",1,52677,6632,"Geert Wilders (PVV)",0.93126491646778,0.63041825095057,0
"<anonymized_userid>",1,52678,6633,"Geert Wilders (PVV)",0.931282595244409,0.630513307984791,0
"<anonymized_userid>",1,52679,6634,"Geert Wilders (PVV)",0.931300274021038,0.630608365019011,0
"<anonymized_userid>",1,52680,6635,"Geert Wilders (PVV)",0.931317952797666,0.630703422053232,0
"<anonymized_userid>",1,52681,6636,"Geert Wilders (PVV)",0.931335631574295,0.630798479087452,0
"<anonymized_userid>",1,52682,6637,"Geert Wilders (PVV)",0.931353310350924,0.630893536121673,0
"<anonymized_userid>",1,52683,6638,"Geert Wilders (PVV)",0.931370989127552,0.630988593155894,0
"<anonymized_userid>",1,52684,6639,"Geert Wilders (PVV)",0.931388667904181,0.631083650190114,0
"<anonymized_userid>",1,52685,6640,"Geert Wilders (PVV)",0.93140634668081,0.631178707224335,0
"<anonymized_userid>",1,52686,6641,"Geert Wilders (PVV)",0.931424025457438,0.631273764258555,0
"<anonymized_userid>",1,52687,6642,"Geert Wilders (PVV)",0.931441704234067,0.631368821292776,0
"<anonymized_userid>",1,52688,6643,"Geert Wilders (PVV)",0.931459383010696,0.631463878326996,0
"<anonymized_userid>",1,52689,6644,"Geert Wilders (PVV)",0.931477061787324,0.631558935361217,0
"<anonymized_userid>",1,52690,6645,"Geert Wilders (PVV)",0.931494740563953,0.631653992395437,0
"<anonymized_userid>",1,52691,6646,"Geert Wilders (PVV)",0.931512419340582,0.631749049429658,0
"<anonymized_userid>",1,52692,6647,"Geert Wilders (PVV)",0.93153009811721,0.631844106463878,0
"<anonymized_userid>",1,52693,6648,"Geert Wilders (PVV)",0.931547776893839,0.631939163498099,0
"<anonymized_userid>",1,52694,6649,"Geert Wilders (PVV)",0.931565455670468,0.632034220532319,0
"<anonymized_userid>",1,52695,6650,"Geert Wilders (PVV)",0.931583134447096,0.63212927756654,0
"<anonymized_userid>",1,52696,6651,"Geert Wilders (PVV)",0.931600813223725,0.63222433460076,0
"<anonymized_userid>",1,52697,6652,"Geert Wilders (PVV)",0.931618492000354,0.632319391634981,0
"<anonymized_userid>",1,52698,6653,"Geert Wilders (PVV)",0.931636170776982,0.632414448669201,0
"<anonymized_userid>",1,52699,6654,"Geert Wilders (PVV)",0.931653849553611,0.632509505703422,0
"<anonymized_userid>",1,52700,6655,"Geert Wilders (PVV)",0.93167152833024,0.632604562737643,0
"<anonymized_userid>",1,52701,6656,"Geert Wilders (PVV)",0.931689207106868,0.632699619771863,0
"<anonymized_userid>",1,52702,6657,"Geert Wilders (PVV)",0.931706885883497,0.632794676806084,0
"<anonymized_userid>",1,52703,6658,"Geert Wilders (PVV)",0.931724564660126,0.632889733840304,0
"<anonymized_userid>",1,52704,6659,"Geert Wilders (PVV)",0.931742243436754,0.632984790874525,0
"<anonymized_userid>",1,52705,6660,"Geert Wilders (PVV)",0.931759922213383,0.633079847908745,0
"<anonymized_userid>",1,52706,6661,"Geert Wilders (PVV)",0.931777600990012,0.633174904942966,0
"<anonymized_userid>",1,52707,6662,"Geert Wilders (PVV)",0.93179527976664,0.633269961977186,0
"<anonymized_userid>",1,52708,6663,"Geert Wilders (PVV)",0.931812958543269,0.633365019011407,0
"<anonymized_userid>",1,52709,6664,"Geert Wilders (PVV)",0.931830637319897,0.633460076045627,0
"<anonymized_userid>",1,52710,6665,"Geert Wilders (PVV)",0.931848316096526,0.633555133079848,0
"<anonymized_userid>",1,52711,6666,"Geert Wilders (PVV)",0.931865994873155,0.633650190114068,0
"<anonymized_userid>",1,52712,6667,"Geert Wilders (PVV)",0.931883673649783,0.633745247148289,0
"<anonymized_userid>",1,52713,6668,"Geert Wilders (PVV)",0.931901352426412,0.633840304182509,0
"<anonymized_userid>",1,52714,6669,"Geert Wilders (PVV)",0.931919031203041,0.63393536121673,0
"<anonymized_userid>",1,52715,6670,"Geert Wilders (PVV)",0.931936709979669,0.634030418250951,0
"<anonymized_userid>",1,52716,6671,"Geert Wilders (PVV)",0.931954388756298,0.634125475285171,0
"<anonymized_userid>",1,52717,6672,"Geert Wilders (PVV)",0.931972067532927,0.634220532319392,0
"<anonymized_userid>",1,52718,6673,"Geert Wilders (PVV)",0.931989746309555,0.634315589353612,0
"<anonymized_userid>",1,52719,6674,"Geert Wilders (PVV)",0.932007425086184,0.634410646387833,0
"<anonymized_userid>",1,52720,6675,"Geert Wilders (PVV)",0.932025103862813,0.634505703422053,0
"<anonymized_userid>",1,52721,6676,"Geert Wilders (PVV)",0.932042782639441,0.634600760456274,0
"<anonymized_userid>",1,52722,6677,"Geert Wilders (PVV)",0.93206046141607,0.634695817490494,0
"<anonymized_userid>",1,52723,6678,"Geert Wilders (PVV)",0.932078140192699,0.634790874524715,0
"<anonymized_userid>",1,52724,6679,"Geert Wilders (PVV)",0.932095818969327,0.634885931558935,0
"<anonymized_userid>",1,52725,6680,"Geert Wilders (PVV)",0.932113497745956,0.634980988593156,0
"<anonymized_userid>",1,52726,6681,"Geert Wilders (PVV)",0.932131176522585,0.635076045627376,0
"<anonymized_userid>",1,52727,6682,"Geert Wilders (PVV)",0.932148855299213,0.635171102661597,0
"<anonymized_userid>",1,52728,6683,"Geert Wilders (PVV)",0.932166534075842,0.635266159695817,0
"<anonymized_userid>",1,52729,6684,"Geert Wilders (PVV)",0.932184212852471,0.635361216730038,0
"<anonymized_userid>",1,52730,6685,"Geert Wilders (PVV)",0.932201891629099,0.635456273764259,0
"<anonymized_userid>",1,52731,6686,"Geert Wilders (PVV)",0.932219570405728,0.635551330798479,0
"<anonymized_userid>",1,52732,6687,"Geert Wilders (PVV)",0.932237249182357,0.6356463878327,0
"<anonymized_userid>",1,52733,6688,"Geert Wilders (PVV)",0.932254927958985,0.63574144486692,0
"<anonymized_userid>",1,52734,6689,"Geert Wilders (PVV)",0.932272606735614,0.635836501901141,0
"<anonymized_userid>",1,52735,6690,"Geert Wilders (PVV)",0.932290285512243,0.635931558935361,0
"<anonymized_userid>",1,52736,6691,"Geert Wilders (PVV)",0.932307964288871,0.636026615969582,0
"<anonymized_userid>",1,52737,6692,"Geert Wilders (PVV)",0.9323256430655,0.636121673003802,0
"<anonymized_userid>",1,52738,6693,"Geert Wilders (PVV)",0.932343321842129,0.636216730038023,0
"<anonymized_userid>",1,52739,6694,"Geert Wilders (PVV)",0.932361000618757,0.636311787072243,0
"<anonymized_userid>",1,52740,6695,"Geert Wilders (PVV)",0.932378679395386,0.636406844106464,0
"<anonymized_userid>",1,52741,6696,"Geert Wilders (PVV)",0.932396358172014,0.636501901140684,0
"<anonymized_userid>",1,52742,6697,"Geert Wilders (PVV)",0.932414036948643,0.636596958174905,0
"<anonymized_userid>",1,52743,6698,"Geert Wilders (PVV)",0.932431715725272,0.636692015209125,0
"<anonymized_userid>",1,52744,6699,"Geert Wilders (PVV)",0.9324493945019,0.636787072243346,0
"<anonymized_userid>",1,52745,6700,"Geert Wilders (PVV)",0.932467073278529,0.636882129277566,0
"<anonymized_userid>",1,52746,6701,"Geert Wilders (PVV)",0.932484752055158,0.636977186311787,0
"<anonymized_userid>",1,52747,6702,"Geert Wilders (PVV)",0.932502430831786,0.637072243346008,0
"<anonymized_userid>",1,52748,6703,"Geert Wilders (PVV)",0.932520109608415,0.637167300380228,0
"<anonymized_userid>",1,52749,6704,"Geert Wilders (PVV)",0.932537788385044,0.637262357414449,0
"<anonymized_userid>",1,52750,6705,"Geert Wilders (PVV)",0.932555467161672,0.637357414448669,0
"<anonymized_userid>",1,52751,6706,"Geert Wilders (PVV)",0.932573145938301,0.63745247148289,0
"<anonymized_userid>",1,52752,6707,"Geert Wilders (PVV)",0.93259082471493,0.63754752851711,0
"<anonymized_userid>",1,52753,6708,"Geert Wilders (PVV)",0.932608503491558,0.637642585551331,0
"<anonymized_userid>",1,52754,6709,"Geert Wilders (PVV)",0.932626182268187,0.637737642585551,0
"<anonymized_userid>",1,52755,6710,"Geert Wilders (PVV)",0.932643861044816,0.637832699619772,0
"<anonymized_userid>",1,52756,6711,"Geert Wilders (PVV)",0.932661539821444,0.637927756653992,0
"<anonymized_userid>",1,52757,6712,"Geert Wilders (PVV)",0.932679218598073,0.638022813688213,0
"<anonymized_userid>",1,52758,6713,"Geert Wilders (PVV)",0.932696897374702,0.638117870722433,0
"<anonymized_userid>",1,52759,6714,"Geert Wilders (PVV)",0.93271457615133,0.638212927756654,0
"<anonymized_userid>",1,52760,6715,"Geert Wilders (PVV)",0.932732254927959,0.638307984790874,0
"<anonymized_userid>",1,52761,6716,"Geert Wilders (PVV)",0.932749933704588,0.638403041825095,0
"<anonymized_userid>",1,52762,6717,"Geert Wilders (PVV)",0.932767612481216,0.638498098859316,0
"<anonymized_userid>",1,52763,6718,"Geert Wilders (PVV)",0.932785291257845,0.638593155893536,0
"<anonymized_userid>",1,52764,6719,"Geert Wilders (PVV)",0.932802970034474,0.638688212927757,0
"<anonymized_userid>",1,52765,6720,"Geert Wilders (PVV)",0.932820648811102,0.638783269961977,0
"<anonymized_userid>",1,52766,6721,"Geert Wilders (PVV)",0.932838327587731,0.638878326996198,0
"<anonymized_userid>",1,52767,6722,"Geert Wilders (PVV)",0.93285600636436,0.638973384030418,0
"<anonymized_userid>",1,52768,6723,"Geert Wilders (PVV)",0.932873685140988,0.639068441064639,0
"<anonymized_userid>",1,52769,6724,"Geert Wilders (PVV)",0.932891363917617,0.639163498098859,0
"<anonymized_userid>",1,52770,6725,"Geert Wilders (PVV)",0.932909042694246,0.63925855513308,0
"<anonymized_userid>",1,52771,6726,"Geert Wilders (PVV)",0.932926721470874,0.6393536121673,0
"<anonymized_userid>",1,52772,6727,"Geert Wilders (PVV)",0.932944400247503,0.639448669201521,0
"<anonymized_userid>",1,52773,6728,"Geert Wilders (PVV)",0.932962079024132,0.639543726235741,0
"<anonymized_userid>",1,52774,6729,"Geert Wilders (PVV)",0.93297975780076,0.639638783269962,0
"<anonymized_userid>",1,52775,6730,"Geert Wilders (PVV)",0.932997436577389,0.639733840304182,0
"<anonymized_userid>",1,52776,6731,"Geert Wilders (PVV)",0.933015115354017,0.639828897338403,0
"<anonymized_userid>",1,52777,6732,"Geert Wilders (PVV)",0.933032794130646,0.639923954372624,0
"<anonymized_userid>",1,52778,6733,"Geert Wilders (PVV)",0.933050472907275,0.640019011406844,0
"<anonymized_userid>",1,52779,6734,"Geert Wilders (PVV)",0.933068151683903,0.640114068441065,0
"<anonymized_userid>",1,52780,6735,"Geert Wilders (PVV)",0.933085830460532,0.640209125475285,0
"<anonymized_userid>",1,52781,6736,"Geert Wilders (PVV)",0.933103509237161,0.640304182509506,0
"<anonymized_userid>",1,52782,6737,"Geert Wilders (PVV)",0.933121188013789,0.640399239543726,0
"<anonymized_userid>",1,52783,6738,"Geert Wilders (PVV)",0.933138866790418,0.640494296577947,0
"<anonymized_userid>",1,52784,6739,"Geert Wilders (PVV)",0.933156545567047,0.640589353612167,0
"<anonymized_userid>",1,52785,6740,"Geert Wilders (PVV)",0.933174224343675,0.640684410646388,0
"<anonymized_userid>",1,52786,6741,"Geert Wilders (PVV)",0.933191903120304,0.640779467680608,0
"<anonymized_userid>",1,52787,6742,"Geert Wilders (PVV)",0.933209581896933,0.640874524714829,0
"<anonymized_userid>",1,52788,6743,"Geert Wilders (PVV)",0.933227260673561,0.640969581749049,0
"<anonymized_userid>",1,52789,6744,"Geert Wilders (PVV)",0.93324493945019,0.64106463878327,0
"<anonymized_userid>",1,52790,6745,"Geert Wilders (PVV)",0.933262618226819,0.641159695817491,0
"<anonymized_userid>",1,52791,6746,"Geert Wilders (PVV)",0.933280297003447,0.641254752851711,0
"<anonymized_userid>",1,52792,6747,"Geert Wilders (PVV)",0.933297975780076,0.641349809885932,0
"<anonymized_userid>",1,52793,6748,"Geert Wilders (PVV)",0.933315654556705,0.641444866920152,0
"<anonymized_userid>",1,52794,6749,"Geert Wilders (PVV)",0.933333333333333,0.641539923954373,0
"<anonymized_userid>",1,52795,6750,"Geert Wilders (PVV)",0.933351012109962,0.641634980988593,0
"<anonymized_userid>",1,52796,6751,"Geert Wilders (PVV)",0.933368690886591,0.641730038022814,0
"<anonymized_userid>",1,52797,6752,"Geert Wilders (PVV)",0.933386369663219,0.641825095057034,0
"<anonymized_userid>",1,52798,6753,"Geert Wilders (PVV)",0.933404048439848,0.641920152091255,0
"<anonymized_userid>",1,52799,6754,"Geert Wilders (PVV)",0.933421727216477,0.642015209125475,0
"<anonymized_userid>",1,52800,6755,"Geert Wilders (PVV)",0.933439405993105,0.642110266159696,0
"<anonymized_userid>",1,52801,6756,"Geert Wilders (PVV)",0.933457084769734,0.642205323193916,0
"<anonymized_userid>",1,52802,6757,"Geert Wilders (PVV)",0.933474763546363,0.642300380228137,0
"<anonymized_userid>",1,52803,6758,"Geert Wilders (PVV)",0.933492442322991,0.642395437262357,0
"<anonymized_userid>",1,52804,6759,"Geert Wilders (PVV)",0.93351012109962,0.642490494296578,0
"<anonymized_userid>",1,52805,6760,"Geert Wilders (PVV)",0.933527799876249,0.642585551330799,0
"<anonymized_userid>",1,52806,6761,"Geert Wilders (PVV)",0.933545478652877,0.642680608365019,0
"<anonymized_userid>",1,52807,6762,"Geert Wilders (PVV)",0.933563157429506,0.64277566539924,0
"<anonymized_userid>",1,52808,6763,"Geert Wilders (PVV)",0.933580836206135,0.64287072243346,0
"<anonymized_userid>",1,52809,6764,"Geert Wilders (PVV)",0.933598514982763,0.642965779467681,0
"<anonymized_userid>",1,52810,6765,"Geert Wilders (PVV)",0.933616193759392,0.643060836501901,0
"<anonymized_userid>",1,52811,6766,"Geert Wilders (PVV)",0.93363387253602,0.643155893536122,0
"<anonymized_userid>",1,52812,6767,"Geert Wilders (PVV)",0.933651551312649,0.643250950570342,0
"<anonymized_userid>",1,52813,6768,"Geert Wilders (PVV)",0.933669230089278,0.643346007604563,0
"<anonymized_userid>",1,52814,6769,"Geert Wilders (PVV)",0.933686908865906,0.643441064638783,0
"<anonymized_userid>",1,52815,6770,"Geert Wilders (PVV)",0.933704587642535,0.643536121673004,0
"<anonymized_userid>",1,52816,6771,"Geert Wilders (PVV)",0.933722266419164,0.643631178707224,0
"<anonymized_userid>",1,52817,6772,"Geert Wilders (PVV)",0.933739945195792,0.643726235741445,0
"<anonymized_userid>",1,52818,6773,"Geert Wilders (PVV)",0.933757623972421,0.643821292775665,0
"<anonymized_userid>",1,52819,6774,"Geert Wilders (PVV)",0.93377530274905,0.643916349809886,0
"<anonymized_userid>",1,52820,6775,"Geert Wilders (PVV)",0.933792981525678,0.644011406844107,0
"<anonymized_userid>",1,52821,6776,"Geert Wilders (PVV)",0.933810660302307,0.644106463878327,0
"<anonymized_userid>",1,52822,6777,"Geert Wilders (PVV)",0.933828339078936,0.644201520912548,0
"<anonymized_userid>",1,52823,6778,"Geert Wilders (PVV)",0.933846017855564,0.644296577946768,0
"<anonymized_userid>",1,52824,6779,"Geert Wilders (PVV)",0.933863696632193,0.644391634980989,0
"<anonymized_userid>",1,52825,6780,"Geert Wilders (PVV)",0.933881375408822,0.644486692015209,0
"<anonymized_userid>",1,52826,6781,"Geert Wilders (PVV)",0.93389905418545,0.64458174904943,0
"<anonymized_userid>",1,52827,6782,"Geert Wilders (PVV)",0.933916732962079,0.64467680608365,0
"<anonymized_userid>",1,52828,6783,"Geert Wilders (PVV)",0.933934411738708,0.644771863117871,0
"<anonymized_userid>",1,52829,6784,"Geert Wilders (PVV)",0.933952090515336,0.644866920152091,0
"<anonymized_userid>",1,52830,6785,"Geert Wilders (PVV)",0.933969769291965,0.644961977186312,0
"<anonymized_userid>",1,52831,6786,"Geert Wilders (PVV)",0.933987448068594,0.645057034220532,0
"<anonymized_userid>",1,52832,6787,"Geert Wilders (PVV)",0.934005126845222,0.645152091254753,0
"<anonymized_userid>",1,52833,6788,"Geert Wilders (PVV)",0.934022805621851,0.645247148288973,0
"<anonymized_userid>",1,52834,6789,"Geert Wilders (PVV)",0.93404048439848,0.645342205323194,0
"<anonymized_userid>",1,52835,6790,"Geert Wilders (PVV)",0.934058163175108,0.645437262357414,0
"<anonymized_userid>",1,52836,6791,"Geert Wilders (PVV)",0.934075841951737,0.645532319391635,0
"<anonymized_userid>",1,52837,6792,"Geert Wilders (PVV)",0.934093520728366,0.645627376425856,0
"<anonymized_userid>",1,52838,6793,"Geert Wilders (PVV)",0.934111199504994,0.645722433460076,0
"<anonymized_userid>",1,52839,6794,"Geert Wilders (PVV)",0.934128878281623,0.645817490494297,0
"<anonymized_userid>",1,52840,6795,"Geert Wilders (PVV)",0.934146557058252,0.645912547528517,0
"<anonymized_userid>",1,52841,6796,"Geert Wilders (PVV)",0.93416423583488,0.646007604562738,0
"<anonymized_userid>",1,52842,6797,"Geert Wilders (PVV)",0.934181914611509,0.646102661596958,0
"<anonymized_userid>",1,52843,6798,"Geert Wilders (PVV)",0.934199593388138,0.646197718631179,0
"<anonymized_userid>",1,52844,6799,"Geert Wilders (PVV)",0.934217272164766,0.646292775665399,0
"<anonymized_userid>",1,52845,6800,"Geert Wilders (PVV)",0.934234950941395,0.64638783269962,0
"<anonymized_userid>",1,52846,6801,"Geert Wilders (PVV)",0.934252629718023,0.64648288973384,0
"<anonymized_userid>",1,52847,6802,"Geert Wilders (PVV)",0.934270308494652,0.646577946768061,0
"<anonymized_userid>",1,52848,6803,"Geert Wilders (PVV)",0.934287987271281,0.646673003802281,0
"<anonymized_userid>",1,52849,6804,"Geert Wilders (PVV)",0.934305666047909,0.646768060836502,0
"<anonymized_userid>",1,52850,6805,"Geert Wilders (PVV)",0.934323344824538,0.646863117870722,0
"<anonymized_userid>",1,52851,6806,"Geert Wilders (PVV)",0.934341023601167,0.646958174904943,0
"<anonymized_userid>",1,52852,6807,"Geert Wilders (PVV)",0.934358702377796,0.647053231939164,0
"<anonymized_userid>",1,52853,6808,"Geert Wilders (PVV)",0.934376381154424,0.647148288973384,0
"<anonymized_userid>",1,52854,6809,"Geert Wilders (PVV)",0.934394059931053,0.647243346007605,0
"<anonymized_userid>",1,52855,6810,"Geert Wilders (PVV)",0.934411738707681,0.647338403041825,0
"<anonymized_userid>",1,52856,6811,"Geert Wilders (PVV)",0.93442941748431,0.647433460076046,0
"<anonymized_userid>",1,52857,6812,"Geert Wilders (PVV)",0.934447096260939,0.647528517110266,0
"<anonymized_userid>",1,52858,6813,"Geert Wilders (PVV)",0.934464775037567,0.647623574144487,0
"<anonymized_userid>",1,52859,6814,"Geert Wilders (PVV)",0.934482453814196,0.647718631178707,0
"<anonymized_userid>",1,52860,6815,"Geert Wilders (PVV)",0.934500132590825,0.647813688212928,0
"<anonymized_userid>",1,52861,6816,"Geert Wilders (PVV)",0.934517811367453,0.647908745247148,0
"<anonymized_userid>",1,52862,6817,"Geert Wilders (PVV)",0.934535490144082,0.648003802281369,0
"<anonymized_userid>",1,52863,6818,"Geert Wilders (PVV)",0.934553168920711,0.648098859315589,0
"<anonymized_userid>",1,52864,6819,"Geert Wilders (PVV)",0.934570847697339,0.64819391634981,0
"<anonymized_userid>",1,52865,6820,"Geert Wilders (PVV)",0.934588526473968,0.64828897338403,0
"<anonymized_userid>",1,52866,6821,"Geert Wilders (PVV)",0.934606205250597,0.648384030418251,0
"<anonymized_userid>",1,52867,6822,"Geert Wilders (PVV)",0.934623884027225,0.648479087452472,0
"<anonymized_userid>",1,52868,6823,"Geert Wilders (PVV)",0.934641562803854,0.648574144486692,0
"<anonymized_userid>",1,52869,6824,"Geert Wilders (PVV)",0.934659241580483,0.648669201520913,0
"<anonymized_userid>",1,52870,6825,"Geert Wilders (PVV)",0.934676920357111,0.648764258555133,0
"<anonymized_userid>",1,52871,6826,"Geert Wilders (PVV)",0.93469459913374,0.648859315589354,0
"<anonymized_userid>",1,52872,6827,"Geert Wilders (PVV)",0.934712277910369,0.648954372623574,0
"<anonymized_userid>",1,52873,6828,"Geert Wilders (PVV)",0.934729956686997,0.649049429657795,0
"<anonymized_userid>",1,52874,6829,"Geert Wilders (PVV)",0.934747635463626,0.649144486692015,0
"<anonymized_userid>",1,52875,6830,"Geert Wilders (PVV)",0.934765314240255,0.649239543726236,0
"<anonymized_userid>",1,52876,6831,"Geert Wilders (PVV)",0.934782993016883,0.649334600760456,0
"<anonymized_userid>",1,52877,6832,"Geert Wilders (PVV)",0.934800671793512,0.649429657794677,0
"<anonymized_userid>",1,52878,6833,"Geert Wilders (PVV)",0.934818350570141,0.649524714828897,0
"<anonymized_userid>",1,52879,6834,"Geert Wilders (PVV)",0.934836029346769,0.649619771863118,0
"<anonymized_userid>",1,52880,6835,"Geert Wilders (PVV)",0.934853708123398,0.649714828897338,0
"<anonymized_userid>",1,52881,6836,"Geert Wilders (PVV)",0.934871386900026,0.649809885931559,0
"<anonymized_userid>",1,52882,6837,"Geert Wilders (PVV)",0.934889065676655,0.649904942965779,0
"<anonymized_userid>",1,52883,6838,"Geert Wilders (PVV)",0.934906744453284,0.65,0
"<anonymized_userid>",1,52884,6839,"Geert Wilders (PVV)",0.934924423229913,0.650095057034221,0
"<anonymized_userid>",1,52885,6840,"Geert Wilders (PVV)",0.934942102006541,0.650190114068441,0
"<anonymized_userid>",1,52886,6841,"Geert Wilders (PVV)",0.93495978078317,0.650285171102662,0
"<anonymized_userid>",1,52887,6842,"Geert Wilders (PVV)",0.934977459559798,0.650380228136882,0
"<anonymized_userid>",1,52888,6843,"Geert Wilders (PVV)",0.934995138336427,0.650475285171103,0
"<anonymized_userid>",1,52889,6844,"Geert Wilders (PVV)",0.935012817113056,0.650570342205323,0
"<anonymized_userid>",1,52890,6845,"Geert Wilders (PVV)",0.935030495889684,0.650665399239544,0
"<anonymized_userid>",1,52891,6846,"Geert Wilders (PVV)",0.935048174666313,0.650760456273764,0
"<anonymized_userid>",1,52892,6847,"Geert Wilders (PVV)",0.935065853442942,0.650855513307985,0
"<anonymized_userid>",1,52893,6848,"Geert Wilders (PVV)",0.93508353221957,0.650950570342205,0
"<anonymized_userid>",1,52894,6849,"Geert Wilders (PVV)",0.935101210996199,0.651045627376426,0
"<anonymized_userid>",1,52895,6850,"Geert Wilders (PVV)",0.935118889772828,0.651140684410646,0
"<anonymized_userid>",1,52896,6851,"Geert Wilders (PVV)",0.935136568549456,0.651235741444867,0
"<anonymized_userid>",1,52897,6852,"Geert Wilders (PVV)",0.935154247326085,0.651330798479087,0
"<anonymized_userid>",1,52898,6853,"Geert Wilders (PVV)",0.935171926102714,0.651425855513308,0
"<anonymized_userid>",1,52899,6854,"Geert Wilders (PVV)",0.935189604879342,0.651520912547529,0
"<anonymized_userid>",1,52900,6855,"Geert Wilders (PVV)",0.935207283655971,0.651615969581749,0
"<anonymized_userid>",1,52901,6856,"Geert Wilders (PVV)",0.9352249624326,0.65171102661597,0
"<anonymized_userid>",1,52902,6857,"Geert Wilders (PVV)",0.935242641209228,0.65180608365019,0
"<anonymized_userid>",1,52903,6858,"Geert Wilders (PVV)",0.935260319985857,0.651901140684411,0
"<anonymized_userid>",1,52904,6859,"Geert Wilders (PVV)",0.935277998762486,0.651996197718631,0
"<anonymized_userid>",1,52905,6860,"Geert Wilders (PVV)",0.935295677539114,0.652091254752852,0
"<anonymized_userid>",1,52906,6861,"Geert Wilders (PVV)",0.935313356315743,0.652186311787072,0
"<anonymized_userid>",1,52907,6862,"Geert Wilders (PVV)",0.935331035092372,0.652281368821293,0
"<anonymized_userid>",1,52908,6863,"Geert Wilders (PVV)",0.935348713869,0.652376425855513,0
"<anonymized_userid>",1,52909,6864,"Geert Wilders (PVV)",0.935366392645629,0.652471482889734,0
"<anonymized_userid>",1,52910,6865,"Geert Wilders (PVV)",0.935384071422258,0.652566539923954,0
"<anonymized_userid>",1,52911,6866,"Geert Wilders (PVV)",0.935401750198886,0.652661596958175,0
"<anonymized_userid>",1,52912,6867,"Geert Wilders (PVV)",0.935419428975515,0.652756653992395,0
"<anonymized_userid>",1,52913,6868,"Geert Wilders (PVV)",0.935437107752144,0.652851711026616,0
"<anonymized_userid>",1,52914,6869,"Geert Wilders (PVV)",0.935454786528772,0.652946768060837,0
"<anonymized_userid>",1,52915,6870,"Geert Wilders (PVV)",0.935472465305401,0.653041825095057,0
"<anonymized_userid>",1,52916,6871,"Geert Wilders (PVV)",0.93549014408203,0.653136882129278,0
"<anonymized_userid>",1,52917,6872,"Geert Wilders (PVV)",0.935507822858658,0.653231939163498,0
"<anonymized_userid>",1,52918,6873,"Geert Wilders (PVV)",0.935525501635287,0.653326996197719,0
"<anonymized_userid>",1,52919,6874,"Geert Wilders (PVV)",0.935543180411916,0.653422053231939,0
"<anonymized_userid>",1,52920,6875,"Geert Wilders (PVV)",0.935560859188544,0.65351711026616,0
"<anonymized_userid>",1,52921,6876,"Geert Wilders (PVV)",0.935578537965173,0.65361216730038,0
"<anonymized_userid>",1,52922,6877,"Geert Wilders (PVV)",0.935596216741801,0.653707224334601,0
"<anonymized_userid>",1,52923,6878,"Geert Wilders (PVV)",0.93561389551843,0.653802281368821,0
"<anonymized_userid>",1,52924,6879,"Geert Wilders (PVV)",0.935631574295059,0.653897338403042,0
"<anonymized_userid>",1,52925,6880,"Geert Wilders (PVV)",0.935649253071687,0.653992395437262,0
"<anonymized_userid>",1,52926,6881,"Geert Wilders (PVV)",0.935666931848316,0.654087452471483,0
"<anonymized_userid>",1,52927,6882,"Geert Wilders (PVV)",0.935684610624945,0.654182509505703,0
"<anonymized_userid>",1,52928,6883,"Geert Wilders (PVV)",0.935702289401573,0.654277566539924,0
"<anonymized_userid>",1,52929,6884,"Geert Wilders (PVV)",0.935719968178202,0.654372623574144,0
"<anonymized_userid>",1,52930,6885,"Geert Wilders (PVV)",0.935737646954831,0.654467680608365,0
"<anonymized_userid>",1,52931,6886,"Geert Wilders (PVV)",0.935755325731459,0.654562737642586,0
"<anonymized_userid>",1,52932,6887,"Geert Wilders (PVV)",0.935773004508088,0.654657794676806,0
"<anonymized_userid>",1,52933,6888,"Geert Wilders (PVV)",0.935790683284717,0.654752851711027,0
"<anonymized_userid>",1,52934,6889,"Geert Wilders (PVV)",0.935808362061345,0.654847908745247,0
"<anonymized_userid>",1,52935,6890,"Geert Wilders (PVV)",0.935826040837974,0.654942965779468,0
"<anonymized_userid>",1,52936,6891,"Geert Wilders (PVV)",0.935843719614603,0.655038022813688,0
"<anonymized_userid>",1,52937,6892,"Geert Wilders (PVV)",0.935861398391231,0.655133079847909,0
"<anonymized_userid>",1,52938,6893,"Geert Wilders (PVV)",0.93587907716786,0.655228136882129,0
"<anonymized_userid>",1,52939,6894,"Geert Wilders (PVV)",0.935896755944489,0.65532319391635,0
"<anonymized_userid>",1,52940,6895,"Geert Wilders (PVV)",0.935914434721117,0.65541825095057,0
"<anonymized_userid>",1,52941,6896,"Geert Wilders (PVV)",0.935932113497746,0.655513307984791,0
"<anonymized_userid>",1,52942,6897,"Geert Wilders (PVV)",0.935949792274375,0.655608365019011,0
"<anonymized_userid>",1,52943,6898,"Geert Wilders (PVV)",0.935967471051003,0.655703422053232,0
"<anonymized_userid>",1,52944,6899,"Geert Wilders (PVV)",0.935985149827632,0.655798479087452,0
"<anonymized_userid>",1,52945,6900,"Geert Wilders (PVV)",0.936002828604261,0.655893536121673,0
"<anonymized_userid>",1,52946,6901,"Geert Wilders (PVV)",0.936020507380889,0.655988593155894,0
"<anonymized_userid>",1,52947,6902,"Geert Wilders (PVV)",0.936038186157518,0.656083650190114,0
"<anonymized_userid>",1,52948,6903,"Geert Wilders (PVV)",0.936055864934147,0.656178707224335,0
"<anonymized_userid>",1,52949,6904,"Geert Wilders (PVV)",0.936073543710775,0.656273764258555,0
"<anonymized_userid>",1,52950,6905,"Geert Wilders (PVV)",0.936091222487404,0.656368821292776,0
"<anonymized_userid>",1,52951,6906,"Geert Wilders (PVV)",0.936108901264033,0.656463878326996,0
"<anonymized_userid>",1,52952,6907,"Geert Wilders (PVV)",0.936126580040661,0.656558935361217,0
"<anonymized_userid>",1,52953,6908,"Geert Wilders (PVV)",0.93614425881729,0.656653992395437,0
"<anonymized_userid>",1,52954,6909,"Geert Wilders (PVV)",0.936161937593919,0.656749049429658,0
"<anonymized_userid>",1,52955,6910,"Geert Wilders (PVV)",0.936179616370547,0.656844106463878,0
"<anonymized_userid>",1,52956,6911,"Geert Wilders (PVV)",0.936197295147176,0.656939163498099,0
"<anonymized_userid>",1,52957,6912,"Geert Wilders (PVV)",0.936214973923804,0.657034220532319,0
"<anonymized_userid>",1,52958,6913,"Geert Wilders (PVV)",0.936232652700433,0.65712927756654,0
"<anonymized_userid>",1,52959,6914,"Geert Wilders (PVV)",0.936250331477062,0.65722433460076,0
"<anonymized_userid>",1,52960,6915,"Geert Wilders (PVV)",0.93626801025369,0.657319391634981,0
"<anonymized_userid>",1,52961,6916,"Geert Wilders (PVV)",0.936285689030319,0.657414448669202,0
"<anonymized_userid>",1,52962,6917,"Geert Wilders (PVV)",0.936303367806948,0.657509505703422,0
"<anonymized_userid>",1,52963,6918,"Geert Wilders (PVV)",0.936321046583576,0.657604562737643,0
"<anonymized_userid>",1,52964,6919,"Geert Wilders (PVV)",0.936338725360205,0.657699619771863,0
"<anonymized_userid>",1,52965,6920,"Geert Wilders (PVV)",0.936356404136834,0.657794676806084,0
"<anonymized_userid>",1,52966,6921,"Geert Wilders (PVV)",0.936374082913462,0.657889733840304,0
"<anonymized_userid>",1,52967,6922,"Geert Wilders (PVV)",0.936391761690091,0.657984790874525,0
"<anonymized_userid>",1,52968,6923,"Geert Wilders (PVV)",0.93640944046672,0.658079847908745,0
"<anonymized_userid>",1,52969,6924,"Geert Wilders (PVV)",0.936427119243348,0.658174904942966,0
"<anonymized_userid>",1,52970,6925,"Geert Wilders (PVV)",0.936444798019977,0.658269961977186,0
"<anonymized_userid>",1,52971,6926,"Geert Wilders (PVV)",0.936462476796606,0.658365019011407,0
"<anonymized_userid>",1,52972,6927,"Geert Wilders (PVV)",0.936480155573234,0.658460076045627,0
"<anonymized_userid>",1,52973,6928,"Geert Wilders (PVV)",0.936497834349863,0.658555133079848,0
"<anonymized_userid>",1,52974,6929,"Geert Wilders (PVV)",0.936515513126492,0.658650190114068,0
"<anonymized_userid>",1,52975,6930,"Geert Wilders (PVV)",0.93653319190312,0.658745247148289,0
"<anonymized_userid>",1,52976,6931,"Geert Wilders (PVV)",0.936550870679749,0.658840304182509,0
"<anonymized_userid>",1,52977,6932,"Geert Wilders (PVV)",0.936568549456378,0.65893536121673,0
"<anonymized_userid>",1,52978,6933,"Geert Wilders (PVV)",0.936586228233006,0.659030418250951,0
"<anonymized_userid>",1,52979,6934,"Geert Wilders (PVV)",0.936603907009635,0.659125475285171,0
"<anonymized_userid>",1,52980,6935,"Geert Wilders (PVV)",0.936621585786264,0.659220532319392,0
"<anonymized_userid>",1,52981,6936,"Geert Wilders (PVV)",0.936639264562892,0.659315589353612,0
"<anonymized_userid>",1,52982,6937,"Geert Wilders (PVV)",0.936656943339521,0.659410646387833,0
"<anonymized_userid>",1,52983,6938,"Geert Wilders (PVV)",0.93667462211615,0.659505703422053,0
"<anonymized_userid>",1,52984,6939,"Geert Wilders (PVV)",0.936692300892778,0.659600760456274,0
"<anonymized_userid>",1,52985,6940,"Geert Wilders (PVV)",0.936709979669407,0.659695817490494,0
"<anonymized_userid>",1,52986,6941,"Geert Wilders (PVV)",0.936727658446036,0.659790874524715,0
"<anonymized_userid>",1,52987,6942,"Geert Wilders (PVV)",0.936745337222664,0.659885931558935,0
"<anonymized_userid>",1,52988,6943,"Geert Wilders (PVV)",0.936763015999293,0.659980988593156,0
"<anonymized_userid>",1,52989,6944,"Geert Wilders (PVV)",0.936780694775922,0.660076045627376,0
"<anonymized_userid>",1,52990,6945,"Geert Wilders (PVV)",0.93679837355255,0.660171102661597,0
"<anonymized_userid>",1,52991,6946,"Geert Wilders (PVV)",0.936816052329179,0.660266159695817,0
"<anonymized_userid>",1,52992,6947,"Geert Wilders (PVV)",0.936833731105807,0.660361216730038,0
"<anonymized_userid>",1,52993,6948,"Geert Wilders (PVV)",0.936851409882436,0.660456273764259,0
"<anonymized_userid>",1,52994,6949,"Geert Wilders (PVV)",0.936869088659065,0.660551330798479,0
"<anonymized_userid>",1,52995,6950,"Geert Wilders (PVV)",0.936886767435693,0.6606463878327,0
"<anonymized_userid>",1,52996,6951,"Geert Wilders (PVV)",0.936904446212322,0.66074144486692,0
"<anonymized_userid>",1,52997,6952,"Geert Wilders (PVV)",0.936922124988951,0.660836501901141,0
"<anonymized_userid>",1,52998,6953,"Geert Wilders (PVV)",0.936939803765579,0.660931558935361,0
"<anonymized_userid>",1,52999,6954,"Geert Wilders (PVV)",0.936957482542208,0.661026615969582,0
"<anonymized_userid>",1,53000,6955,"Geert Wilders (PVV)",0.936975161318837,0.661121673003802,0
"<anonymized_userid>",1,53001,6956,"Geert Wilders (PVV)",0.936992840095465,0.661216730038023,0
"<anonymized_userid>",1,53002,6957,"Geert Wilders (PVV)",0.937010518872094,0.661311787072243,0
"<anonymized_userid>",1,53003,6958,"Geert Wilders (PVV)",0.937028197648723,0.661406844106464,0
"<anonymized_userid>",1,53004,6959,"Geert Wilders (PVV)",0.937045876425351,0.661501901140684,0
"<anonymized_userid>",1,53005,6960,"Geert Wilders (PVV)",0.93706355520198,0.661596958174905,0
"<anonymized_userid>",1,53006,6961,"Geert Wilders (PVV)",0.937081233978609,0.661692015209125,0
"<anonymized_userid>",1,53007,6962,"Geert Wilders (PVV)",0.937098912755237,0.661787072243346,0
"<anonymized_userid>",1,53008,6963,"Geert Wilders (PVV)",0.937116591531866,0.661882129277567,0
"<anonymized_userid>",1,53009,6964,"Geert Wilders (PVV)",0.937134270308495,0.661977186311787,0
"<anonymized_userid>",1,53010,6965,"Geert Wilders (PVV)",0.937151949085123,0.662072243346008,0
"<anonymized_userid>",1,53011,6966,"Geert Wilders (PVV)",0.937169627861752,0.662167300380228,0
"<anonymized_userid>",1,53012,6967,"Geert Wilders (PVV)",0.937187306638381,0.662262357414449,0
"<anonymized_userid>",1,53013,6968,"Geert Wilders (PVV)",0.937204985415009,0.662357414448669,0
"<anonymized_userid>",1,53014,6969,"Geert Wilders (PVV)",0.937222664191638,0.66245247148289,0
"<anonymized_userid>",1,53015,6970,"Geert Wilders (PVV)",0.937240342968267,0.66254752851711,0
"<anonymized_userid>",1,53016,6971,"Geert Wilders (PVV)",0.937258021744895,0.662642585551331,0
"<anonymized_userid>",1,53017,6972,"Geert Wilders (PVV)",0.937275700521524,0.662737642585551,0
"<anonymized_userid>",1,53018,6973,"Geert Wilders (PVV)",0.937293379298153,0.662832699619772,0
"<anonymized_userid>",1,53019,6974,"Geert Wilders (PVV)",0.937311058074781,0.662927756653992,0
"<anonymized_userid>",1,53020,6975,"Geert Wilders (PVV)",0.93732873685141,0.663022813688213,0
"<anonymized_userid>",1,53021,6976,"Geert Wilders (PVV)",0.937346415628039,0.663117870722433,0
"<anonymized_userid>",1,53022,6977,"Geert Wilders (PVV)",0.937364094404667,0.663212927756654,0
"<anonymized_userid>",1,53023,6978,"Geert Wilders (PVV)",0.937381773181296,0.663307984790874,0
"<anonymized_userid>",1,53024,6979,"Geert Wilders (PVV)",0.937399451957925,0.663403041825095,0
"<anonymized_userid>",1,53025,6980,"Geert Wilders (PVV)",0.937417130734553,0.663498098859316,0
"<anonymized_userid>",1,53026,6981,"Geert Wilders (PVV)",0.937434809511182,0.663593155893536,0
"<anonymized_userid>",1,53027,6982,"Geert Wilders (PVV)",0.93745248828781,0.663688212927757,0
"<anonymized_userid>",1,53028,6983,"Geert Wilders (PVV)",0.937470167064439,0.663783269961977,0
"<anonymized_userid>",1,53029,6984,"Geert Wilders (PVV)",0.937487845841068,0.663878326996198,0
"<anonymized_userid>",1,53030,6985,"Geert Wilders (PVV)",0.937505524617696,0.663973384030418,0
"<anonymized_userid>",1,53031,6986,"Geert Wilders (PVV)",0.937523203394325,0.664068441064639,0
"<anonymized_userid>",1,53032,6987,"Geert Wilders (PVV)",0.937540882170954,0.664163498098859,0
"<anonymized_userid>",1,53033,6988,"Geert Wilders (PVV)",0.937558560947582,0.66425855513308,0
"<anonymized_userid>",1,53034,6989,"Geert Wilders (PVV)",0.937576239724211,0.6643536121673,0
"<anonymized_userid>",1,53035,6990,"Geert Wilders (PVV)",0.93759391850084,0.664448669201521,0
"<anonymized_userid>",1,53036,6991,"Geert Wilders (PVV)",0.937611597277468,0.664543726235741,0
"<anonymized_userid>",1,53037,6992,"Geert Wilders (PVV)",0.937629276054097,0.664638783269962,0
"<anonymized_userid>",1,53038,6993,"Geert Wilders (PVV)",0.937646954830726,0.664733840304182,0
"<anonymized_userid>",1,53039,6994,"Geert Wilders (PVV)",0.937664633607354,0.664828897338403,0
"<anonymized_userid>",1,53040,6995,"Geert Wilders (PVV)",0.937682312383983,0.664923954372624,0
"<anonymized_userid>",1,53041,6996,"Geert Wilders (PVV)",0.937699991160612,0.665019011406844,0
"<anonymized_userid>",1,53042,6997,"Geert Wilders (PVV)",0.93771766993724,0.665114068441065,0
"<anonymized_userid>",1,53043,6998,"Geert Wilders (PVV)",0.937735348713869,0.665209125475285,0
"<anonymized_userid>",1,53044,6999,"Geert Wilders (PVV)",0.937753027490498,0.665304182509506,0
"<anonymized_userid>",1,53045,7000,"Geert Wilders (PVV)",0.937770706267126,0.665399239543726,0
"<anonymized_userid>",1,53046,7001,"Geert Wilders (PVV)",0.937788385043755,0.665494296577947,0
"<anonymized_userid>",1,53047,7002,"Geert Wilders (PVV)",0.937806063820384,0.665589353612167,0
"<anonymized_userid>",1,53048,7003,"Geert Wilders (PVV)",0.937823742597012,0.665684410646388,0
"<anonymized_userid>",1,53049,7004,"Geert Wilders (PVV)",0.937841421373641,0.665779467680608,0
"<anonymized_userid>",1,53050,7005,"Geert Wilders (PVV)",0.93785910015027,0.665874524714829,0
"<anonymized_userid>",1,53051,7006,"Geert Wilders (PVV)",0.937876778926898,0.665969581749049,0
"<anonymized_userid>",1,53052,7007,"Geert Wilders (PVV)",0.937894457703527,0.66606463878327,0
"<anonymized_userid>",1,53053,7008,"Geert Wilders (PVV)",0.937912136480156,0.66615969581749,0
"<anonymized_userid>",1,53054,7009,"Geert Wilders (PVV)",0.937929815256784,0.666254752851711,0
"<anonymized_userid>",1,53055,7010,"Geert Wilders (PVV)",0.937947494033413,0.666349809885932,0
"<anonymized_userid>",1,53056,7011,"Geert Wilders (PVV)",0.937965172810042,0.666444866920152,0
"<anonymized_userid>",1,53057,7012,"Geert Wilders (PVV)",0.93798285158667,0.666539923954373,0
"<anonymized_userid>",1,53058,7013,"Geert Wilders (PVV)",0.938000530363299,0.666634980988593,0
"<anonymized_userid>",1,53059,7014,"Geert Wilders (PVV)",0.938018209139928,0.666730038022814,0
"<anonymized_userid>",1,53060,7015,"Geert Wilders (PVV)",0.938035887916556,0.666825095057034,0
"<anonymized_userid>",1,53061,7016,"Geert Wilders (PVV)",0.938053566693185,0.666920152091255,0
"<anonymized_userid>",1,53062,7017,"Geert Wilders (PVV)",0.938071245469813,0.667015209125475,0
"<anonymized_userid>",1,53063,7018,"Geert Wilders (PVV)",0.938088924246442,0.667110266159696,0
"<anonymized_userid>",1,53064,7019,"Geert Wilders (PVV)",0.938106603023071,0.667205323193916,0
"<anonymized_userid>",1,53065,7020,"Geert Wilders (PVV)",0.938124281799699,0.667300380228137,0
"<anonymized_userid>",1,53066,7021,"Geert Wilders (PVV)",0.938141960576328,0.667395437262357,0
"<anonymized_userid>",1,53067,7022,"Geert Wilders (PVV)",0.938159639352957,0.667490494296578,0
"<anonymized_userid>",1,53068,7023,"Geert Wilders (PVV)",0.938177318129585,0.667585551330798,0
"<anonymized_userid>",1,53069,7024,"Geert Wilders (PVV)",0.938194996906214,0.667680608365019,0
"<anonymized_userid>",1,53070,7025,"Geert Wilders (PVV)",0.938212675682843,0.667775665399239,0
"<anonymized_userid>",1,53071,7026,"Geert Wilders (PVV)",0.938230354459471,0.66787072243346,0
"<anonymized_userid>",1,53072,7027,"Geert Wilders (PVV)",0.9382480332361,0.667965779467681,0
"<anonymized_userid>",1,53073,7028,"Geert Wilders (PVV)",0.938265712012729,0.668060836501901,0
"<anonymized_userid>",1,53074,7029,"Geert Wilders (PVV)",0.938283390789357,0.668155893536122,0
"<anonymized_userid>",1,53075,7030,"Geert Wilders (PVV)",0.938301069565986,0.668250950570342,0
"<anonymized_userid>",1,53076,7031,"Geert Wilders (PVV)",0.938318748342615,0.668346007604563,0
"<anonymized_userid>",1,53077,7032,"Geert Wilders (PVV)",0.938336427119243,0.668441064638783,0
"<anonymized_userid>",1,53078,7033,"Geert Wilders (PVV)",0.938354105895872,0.668536121673004,0
"<anonymized_userid>",1,53079,7034,"Geert Wilders (PVV)",0.938371784672501,0.668631178707224,0
"<anonymized_userid>",1,53080,7035,"Geert Wilders (PVV)",0.938389463449129,0.668726235741445,0
"<anonymized_userid>",1,53081,7036,"Geert Wilders (PVV)",0.938407142225758,0.668821292775665,0
"<anonymized_userid>",1,53082,7037,"Geert Wilders (PVV)",0.938424821002387,0.668916349809886,0
"<anonymized_userid>",1,53083,7038,"Geert Wilders (PVV)",0.938442499779015,0.669011406844106,0
"<anonymized_userid>",1,53084,7039,"Geert Wilders (PVV)",0.938460178555644,0.669106463878327,0
"<anonymized_userid>",1,53085,7040,"Geert Wilders (PVV)",0.938477857332273,0.669201520912547,0
"<anonymized_userid>",1,53086,7041,"Geert Wilders (PVV)",0.938495536108901,0.669296577946768,0
"<anonymized_userid>",1,53087,7042,"Geert Wilders (PVV)",0.93851321488553,0.669391634980989,0
"<anonymized_userid>",1,53088,7043,"Geert Wilders (PVV)",0.938530893662159,0.669486692015209,0
"<anonymized_userid>",1,53089,7044,"Geert Wilders (PVV)",0.938548572438787,0.66958174904943,0
"<anonymized_userid>",1,53090,7045,"Geert Wilders (PVV)",0.938566251215416,0.66967680608365,0
"<anonymized_userid>",1,53091,7046,"Geert Wilders (PVV)",0.938583929992045,0.669771863117871,0
"<anonymized_userid>",1,53092,7047,"Geert Wilders (PVV)",0.938601608768673,0.669866920152091,0
"<anonymized_userid>",1,53093,7048,"Geert Wilders (PVV)",0.938619287545302,0.669961977186312,0
"<anonymized_userid>",1,53094,7049,"Geert Wilders (PVV)",0.93863696632193,0.670057034220532,0
"<anonymized_userid>",1,53095,7050,"Geert Wilders (PVV)",0.938654645098559,0.670152091254753,0
"<anonymized_userid>",1,53096,7051,"Geert Wilders (PVV)",0.938672323875188,0.670247148288973,0
"<anonymized_userid>",1,53097,7052,"Geert Wilders (PVV)",0.938690002651816,0.670342205323194,0
"<anonymized_userid>",1,53098,7053,"Geert Wilders (PVV)",0.938707681428445,0.670437262357414,0
"<anonymized_userid>",1,53099,7054,"Geert Wilders (PVV)",0.938725360205074,0.670532319391635,0
"<anonymized_userid>",1,53100,7055,"Geert Wilders (PVV)",0.938743038981702,0.670627376425855,0
"<anonymized_userid>",1,53101,7056,"Geert Wilders (PVV)",0.938760717758331,0.670722433460076,0
"<anonymized_userid>",1,53102,7057,"Geert Wilders (PVV)",0.93877839653496,0.670817490494297,0
"<anonymized_userid>",1,53103,7058,"Geert Wilders (PVV)",0.938796075311588,0.670912547528517,0
"<anonymized_userid>",1,53104,7059,"Geert Wilders (PVV)",0.938813754088217,0.671007604562738,0
"<anonymized_userid>",1,53105,7060,"Geert Wilders (PVV)",0.938831432864846,0.671102661596958,0
"<anonymized_userid>",1,53106,7061,"Geert Wilders (PVV)",0.938849111641474,0.671197718631179,0
"<anonymized_userid>",1,53107,7062,"Geert Wilders (PVV)",0.938866790418103,0.671292775665399,0
"<anonymized_userid>",1,53108,7063,"Geert Wilders (PVV)",0.938884469194732,0.67138783269962,0
"<anonymized_userid>",1,53109,7064,"Geert Wilders (PVV)",0.93890214797136,0.67148288973384,0
"<anonymized_userid>",1,53110,7065,"Geert Wilders (PVV)",0.938919826747989,0.671577946768061,0
"<anonymized_userid>",1,53111,7066,"Geert Wilders (PVV)",0.938937505524618,0.671673003802281,0
"<anonymized_userid>",1,53112,7067,"Geert Wilders (PVV)",0.938955184301246,0.671768060836502,0
"<anonymized_userid>",1,53113,7068,"Geert Wilders (PVV)",0.938972863077875,0.671863117870722,0
"<anonymized_userid>",1,53114,7069,"Geert Wilders (PVV)",0.938990541854504,0.671958174904943,0
"<anonymized_userid>",1,53115,7070,"Geert Wilders (PVV)",0.939008220631132,0.672053231939164,0
"<anonymized_userid>",1,53116,7071,"Geert Wilders (PVV)",0.939025899407761,0.672148288973384,0
"<anonymized_userid>",1,53117,7072,"Geert Wilders (PVV)",0.93904357818439,0.672243346007605,0
"<anonymized_userid>",1,53118,7073,"Geert Wilders (PVV)",0.939061256961018,0.672338403041825,0
"<anonymized_userid>",1,53119,7074,"Geert Wilders (PVV)",0.939078935737647,0.672433460076046,0
"<anonymized_userid>",1,53120,7075,"Geert Wilders (PVV)",0.939096614514276,0.672528517110266,0
"<anonymized_userid>",1,53121,7076,"Geert Wilders (PVV)",0.939114293290904,0.672623574144487,0
"<anonymized_userid>",1,53122,7077,"Geert Wilders (PVV)",0.939131972067533,0.672718631178707,0
"<anonymized_userid>",1,53123,7078,"Geert Wilders (PVV)",0.939149650844162,0.672813688212928,0
"<anonymized_userid>",1,53124,7079,"Geert Wilders (PVV)",0.93916732962079,0.672908745247148,0
"<anonymized_userid>",1,53125,7080,"Geert Wilders (PVV)",0.939185008397419,0.673003802281369,0
"<anonymized_userid>",1,53126,7081,"Geert Wilders (PVV)",0.939202687174048,0.673098859315589,0
"<anonymized_userid>",1,53127,7082,"Geert Wilders (PVV)",0.939220365950676,0.67319391634981,0
"<anonymized_userid>",1,53128,7083,"Geert Wilders (PVV)",0.939238044727305,0.67328897338403,0
"<anonymized_userid>",1,53129,7084,"Geert Wilders (PVV)",0.939255723503933,0.673384030418251,0
"<anonymized_userid>",1,53130,7085,"Geert Wilders (PVV)",0.939273402280562,0.673479087452472,0
"<anonymized_userid>",1,53131,7086,"Geert Wilders (PVV)",0.939291081057191,0.673574144486692,0
"<anonymized_userid>",1,53132,7087,"Geert Wilders (PVV)",0.939308759833819,0.673669201520913,0
"<anonymized_userid>",1,53133,7088,"Geert Wilders (PVV)",0.939326438610448,0.673764258555133,0
"<anonymized_userid>",1,53134,7089,"Geert Wilders (PVV)",0.939344117387077,0.673859315589354,0
"<anonymized_userid>",1,53135,7090,"Geert Wilders (PVV)",0.939361796163706,0.673954372623574,0
"<anonymized_userid>",1,53136,7091,"Geert Wilders (PVV)",0.939379474940334,0.674049429657795,0
"<anonymized_userid>",1,53137,7092,"Geert Wilders (PVV)",0.939397153716963,0.674144486692015,0
"<anonymized_userid>",1,53138,7093,"Geert Wilders (PVV)",0.939414832493591,0.674239543726236,0
"<anonymized_userid>",1,53139,7094,"Geert Wilders (PVV)",0.93943251127022,0.674334600760456,0
"<anonymized_userid>",1,53140,7095,"Geert Wilders (PVV)",0.939450190046849,0.674429657794677,0
"<anonymized_userid>",1,53141,7096,"Geert Wilders (PVV)",0.939467868823477,0.674524714828897,0
"<anonymized_userid>",1,53142,7097,"Geert Wilders (PVV)",0.939485547600106,0.674619771863118,0
"<anonymized_userid>",1,53143,7098,"Geert Wilders (PVV)",0.939503226376735,0.674714828897338,0
"<anonymized_userid>",1,53144,7099,"Geert Wilders (PVV)",0.939520905153363,0.674809885931559,0
"<anonymized_userid>",1,53145,7100,"Geert Wilders (PVV)",0.939538583929992,0.67490494296578,0
"<anonymized_userid>",1,53146,7101,"Geert Wilders (PVV)",0.939556262706621,0.675,0
"<anonymized_userid>",1,53147,7102,"Geert Wilders (PVV)",0.939573941483249,0.675095057034221,0
"<anonymized_userid>",1,53148,7103,"Geert Wilders (PVV)",0.939591620259878,0.675190114068441,0
"<anonymized_userid>",1,53149,7104,"Geert Wilders (PVV)",0.939609299036507,0.675285171102662,0
"<anonymized_userid>",1,53150,7105,"Geert Wilders (PVV)",0.939626977813135,0.675380228136882,0
"<anonymized_userid>",1,53151,7106,"Geert Wilders (PVV)",0.939644656589764,0.675475285171103,0
"<anonymized_userid>",1,53152,7107,"Geert Wilders (PVV)",0.939662335366393,0.675570342205323,0
"<anonymized_userid>",1,53153,7108,"Geert Wilders (PVV)",0.939680014143021,0.675665399239544,0
"<anonymized_userid>",1,53154,7109,"Geert Wilders (PVV)",0.93969769291965,0.675760456273764,0
"<anonymized_userid>",1,53155,7110,"Geert Wilders (PVV)",0.939715371696279,0.675855513307985,0
"<anonymized_userid>",1,53156,7111,"Geert Wilders (PVV)",0.939733050472907,0.675950570342205,0
"<anonymized_userid>",1,53157,7112,"Geert Wilders (PVV)",0.939750729249536,0.676045627376426,0
"<anonymized_userid>",1,53158,7113,"Geert Wilders (PVV)",0.939768408026165,0.676140684410646,0
"<anonymized_userid>",1,53159,7114,"Geert Wilders (PVV)",0.939786086802793,0.676235741444867,0
"<anonymized_userid>",1,53160,7115,"Geert Wilders (PVV)",0.939803765579422,0.676330798479088,0
"<anonymized_userid>",1,53161,7116,"Geert Wilders (PVV)",0.939821444356051,0.676425855513308,0
"<anonymized_userid>",1,53162,7117,"Geert Wilders (PVV)",0.939839123132679,0.676520912547529,0
"<anonymized_userid>",1,53163,7118,"Geert Wilders (PVV)",0.939856801909308,0.676615969581749,0
"<anonymized_userid>",1,53164,7119,"Geert Wilders (PVV)",0.939874480685936,0.67671102661597,0
"<anonymized_userid>",1,53165,7120,"Geert Wilders (PVV)",0.939892159462565,0.67680608365019,0
"<anonymized_userid>",1,53166,7121,"Geert Wilders (PVV)",0.939909838239194,0.676901140684411,0
"<anonymized_userid>",1,53167,7122,"Geert Wilders (PVV)",0.939927517015823,0.676996197718631,0
"<anonymized_userid>",1,53168,7123,"Geert Wilders (PVV)",0.939945195792451,0.677091254752852,0
"<anonymized_userid>",1,53169,7124,"Geert Wilders (PVV)",0.93996287456908,0.677186311787072,0
"<anonymized_userid>",1,53170,7125,"Geert Wilders (PVV)",0.939980553345709,0.677281368821293,0
"<anonymized_userid>",1,53171,7126,"Geert Wilders (PVV)",0.939998232122337,0.677376425855513,0
"<anonymized_userid>",1,53172,7127,"Geert Wilders (PVV)",0.940015910898966,0.677471482889734,0
"<anonymized_userid>",1,53173,7128,"Geert Wilders (PVV)",0.940033589675594,0.677566539923954,0
"<anonymized_userid>",1,53174,7129,"Geert Wilders (PVV)",0.940051268452223,0.677661596958175,0
"<anonymized_userid>",1,53175,7130,"Geert Wilders (PVV)",0.940068947228852,0.677756653992395,0
"<anonymized_userid>",1,53176,7131,"Geert Wilders (PVV)",0.94008662600548,0.677851711026616,0
"<anonymized_userid>",1,53177,7132,"Geert Wilders (PVV)",0.940104304782109,0.677946768060837,0
"<anonymized_userid>",1,53178,7133,"Geert Wilders (PVV)",0.940121983558738,0.678041825095057,0
"<anonymized_userid>",1,53179,7134,"Geert Wilders (PVV)",0.940139662335366,0.678136882129278,0
"<anonymized_userid>",1,53180,7135,"Geert Wilders (PVV)",0.940157341111995,0.678231939163498,0
"<anonymized_userid>",1,53181,7136,"Geert Wilders (PVV)",0.940175019888624,0.678326996197719,0
"<anonymized_userid>",1,53182,7137,"Geert Wilders (PVV)",0.940192698665252,0.678422053231939,0
"<anonymized_userid>",1,53183,7138,"Geert Wilders (PVV)",0.940210377441881,0.67851711026616,0
"<anonymized_userid>",1,53184,7139,"Geert Wilders (PVV)",0.94022805621851,0.67861216730038,0
"<anonymized_userid>",1,53185,7140,"Geert Wilders (PVV)",0.940245734995138,0.678707224334601,0
"<anonymized_userid>",1,53186,7141,"Geert Wilders (PVV)",0.940263413771767,0.678802281368821,0
"<anonymized_userid>",1,53187,7142,"Geert Wilders (PVV)",0.940281092548396,0.678897338403042,0
"<anonymized_userid>",1,53188,7143,"Geert Wilders (PVV)",0.940298771325024,0.678992395437262,0
"<anonymized_userid>",1,53189,7144,"Geert Wilders (PVV)",0.940316450101653,0.679087452471483,0
"<anonymized_userid>",1,53190,7145,"Geert Wilders (PVV)",0.940334128878282,0.679182509505703,0
"<anonymized_userid>",1,53191,7146,"Geert Wilders (PVV)",0.94035180765491,0.679277566539924,0
"<anonymized_userid>",1,53192,7147,"Geert Wilders (PVV)",0.940369486431539,0.679372623574145,0
"<anonymized_userid>",1,53193,7148,"Geert Wilders (PVV)",0.940387165208168,0.679467680608365,0
"<anonymized_userid>",1,53194,7149,"Geert Wilders (PVV)",0.940404843984796,0.679562737642586,0
"<anonymized_userid>",1,53195,7150,"Geert Wilders (PVV)",0.940422522761425,0.679657794676806,0
"<anonymized_userid>",1,53196,7151,"Geert Wilders (PVV)",0.940440201538054,0.679752851711027,0
"<anonymized_userid>",1,53197,7152,"Geert Wilders (PVV)",0.940457880314682,0.679847908745247,0
"<anonymized_userid>",1,53198,7153,"Geert Wilders (PVV)",0.940475559091311,0.679942965779468,0
"<anonymized_userid>",1,53199,7154,"Geert Wilders (PVV)",0.94049323786794,0.680038022813688,0
"<anonymized_userid>",1,53200,7155,"Geert Wilders (PVV)",0.940510916644568,0.680133079847909,0
"<anonymized_userid>",1,53201,7156,"Geert Wilders (PVV)",0.940528595421197,0.680228136882129,0
"<anonymized_userid>",1,53202,7157,"Geert Wilders (PVV)",0.940546274197826,0.68032319391635,0
"<anonymized_userid>",1,53203,7158,"Geert Wilders (PVV)",0.940563952974454,0.68041825095057,0
"<anonymized_userid>",1,53204,7159,"Geert Wilders (PVV)",0.940581631751083,0.680513307984791,0
"<anonymized_userid>",1,53205,7160,"Geert Wilders (PVV)",0.940599310527712,0.680608365019011,0
"<anonymized_userid>",1,53206,7161,"Geert Wilders (PVV)",0.94061698930434,0.680703422053232,0
"<anonymized_userid>",1,53207,7162,"Geert Wilders (PVV)",0.940634668080969,0.680798479087453,0
"<anonymized_userid>",1,53208,7163,"Geert Wilders (PVV)",0.940652346857597,0.680893536121673,0
"<anonymized_userid>",1,53209,7164,"Geert Wilders (PVV)",0.940670025634226,0.680988593155894,0
"<anonymized_userid>",1,53210,7165,"Geert Wilders (PVV)",0.940687704410855,0.681083650190114,0
"<anonymized_userid>",1,53211,7166,"Geert Wilders (PVV)",0.940705383187483,0.681178707224335,0
"<anonymized_userid>",1,53212,7167,"Geert Wilders (PVV)",0.940723061964112,0.681273764258555,0
"<anonymized_userid>",1,53213,7168,"Geert Wilders (PVV)",0.940740740740741,0.681368821292776,0
"<anonymized_userid>",1,53214,7169,"Geert Wilders (PVV)",0.940758419517369,0.681463878326996,0
"<anonymized_userid>",1,53215,7170,"Geert Wilders (PVV)",0.940776098293998,0.681558935361217,0
"<anonymized_userid>",1,53216,7171,"Geert Wilders (PVV)",0.940793777070627,0.681653992395437,0
"<anonymized_userid>",1,53217,7172,"Geert Wilders (PVV)",0.940811455847255,0.681749049429658,0
"<anonymized_userid>",1,53218,7173,"Geert Wilders (PVV)",0.940829134623884,0.681844106463878,0
"<anonymized_userid>",1,53219,7174,"Geert Wilders (PVV)",0.940846813400513,0.681939163498099,0
"<anonymized_userid>",1,53220,7175,"Geert Wilders (PVV)",0.940864492177141,0.682034220532319,0
"<anonymized_userid>",1,53221,7176,"Geert Wilders (PVV)",0.94088217095377,0.68212927756654,0
"<anonymized_userid>",1,53222,7177,"Geert Wilders (PVV)",0.940899849730399,0.68222433460076,0
"<anonymized_userid>",1,53223,7178,"Geert Wilders (PVV)",0.940917528507027,0.682319391634981,0
"<anonymized_userid>",1,53224,7179,"Geert Wilders (PVV)",0.940935207283656,0.682414448669202,0
"<anonymized_userid>",1,53225,7180,"Geert Wilders (PVV)",0.940952886060285,0.682509505703422,0
"<anonymized_userid>",1,53226,7181,"Geert Wilders (PVV)",0.940970564836913,0.682604562737643,0
"<anonymized_userid>",1,53227,7182,"Geert Wilders (PVV)",0.940988243613542,0.682699619771863,0
"<anonymized_userid>",1,53228,7183,"Geert Wilders (PVV)",0.941005922390171,0.682794676806084,0
"<anonymized_userid>",1,53229,7184,"Geert Wilders (PVV)",0.941023601166799,0.682889733840304,0
"<anonymized_userid>",1,53230,7185,"Geert Wilders (PVV)",0.941041279943428,0.682984790874525,0
"<anonymized_userid>",1,53231,7186,"Geert Wilders (PVV)",0.941058958720057,0.683079847908745,0
"<anonymized_userid>",1,53232,7187,"Geert Wilders (PVV)",0.941076637496685,0.683174904942966,0
"<anonymized_userid>",1,53233,7188,"Geert Wilders (PVV)",0.941094316273314,0.683269961977186,0
"<anonymized_userid>",1,53234,7189,"Geert Wilders (PVV)",0.941111995049943,0.683365019011407,0
"<anonymized_userid>",1,53235,7190,"Geert Wilders (PVV)",0.941129673826571,0.683460076045627,0
"<anonymized_userid>",1,53236,7191,"Geert Wilders (PVV)",0.9411473526032,0.683555133079848,0
"<anonymized_userid>",1,53237,7192,"Geert Wilders (PVV)",0.941165031379829,0.683650190114068,0
"<anonymized_userid>",1,53238,7193,"Geert Wilders (PVV)",0.941182710156457,0.683745247148289,0
"<anonymized_userid>",1,53239,7194,"Geert Wilders (PVV)",0.941200388933086,0.68384030418251,0
"<anonymized_userid>",1,53240,7195,"Geert Wilders (PVV)",0.941218067709715,0.68393536121673,0
"<anonymized_userid>",1,53241,7196,"Geert Wilders (PVV)",0.941235746486343,0.684030418250951,0
"<anonymized_userid>",1,53242,7197,"Geert Wilders (PVV)",0.941253425262972,0.684125475285171,0
"<anonymized_userid>",1,53243,7198,"Geert Wilders (PVV)",0.9412711040396,0.684220532319392,0
"<anonymized_userid>",1,53244,7199,"Geert Wilders (PVV)",0.941288782816229,0.684315589353612,0
"<anonymized_userid>",1,53245,7200,"Geert Wilders (PVV)",0.941306461592858,0.684410646387833,0
"<anonymized_userid>",1,53246,7201,"Geert Wilders (PVV)",0.941324140369486,0.684505703422053,0
"<anonymized_userid>",1,53247,7202,"Geert Wilders (PVV)",0.941341819146115,0.684600760456274,0
"<anonymized_userid>",1,53248,7203,"Geert Wilders (PVV)",0.941359497922744,0.684695817490494,0
"<anonymized_userid>",1,53249,7204,"Geert Wilders (PVV)",0.941377176699372,0.684790874524715,0
"<anonymized_userid>",1,53250,7205,"Geert Wilders (PVV)",0.941394855476001,0.684885931558935,0
"<anonymized_userid>",1,53251,7206,"Geert Wilders (PVV)",0.94141253425263,0.684980988593156,0
"<anonymized_userid>",1,53252,7207,"Geert Wilders (PVV)",0.941430213029258,0.685076045627376,0
"<anonymized_userid>",1,53253,7208,"Geert Wilders (PVV)",0.941447891805887,0.685171102661597,0
"<anonymized_userid>",1,53254,7209,"Geert Wilders (PVV)",0.941465570582516,0.685266159695818,0
"<anonymized_userid>",1,53255,7210,"Geert Wilders (PVV)",0.941483249359144,0.685361216730038,0
"<anonymized_userid>",1,53256,7211,"Geert Wilders (PVV)",0.941500928135773,0.685456273764259,0
"<anonymized_userid>",1,53257,7212,"Geert Wilders (PVV)",0.941518606912402,0.685551330798479,0
"<anonymized_userid>",1,53258,7213,"Geert Wilders (PVV)",0.94153628568903,0.6856463878327,0
"<anonymized_userid>",1,53259,7214,"Geert Wilders (PVV)",0.941553964465659,0.68574144486692,0
"<anonymized_userid>",1,53260,7215,"Geert Wilders (PVV)",0.941571643242288,0.685836501901141,0
"<anonymized_userid>",1,53261,7216,"Geert Wilders (PVV)",0.941589322018916,0.685931558935361,0
"<anonymized_userid>",1,53262,7217,"Geert Wilders (PVV)",0.941607000795545,0.686026615969582,0
"<anonymized_userid>",1,53263,7218,"Geert Wilders (PVV)",0.941624679572174,0.686121673003802,0
"<anonymized_userid>",1,53264,7219,"Geert Wilders (PVV)",0.941642358348802,0.686216730038023,0
"<anonymized_userid>",1,53265,7220,"Geert Wilders (PVV)",0.941660037125431,0.686311787072243,0
"<anonymized_userid>",1,53266,7221,"Geert Wilders (PVV)",0.94167771590206,0.686406844106464,0
"<anonymized_userid>",1,53267,7222,"Geert Wilders (PVV)",0.941695394678688,0.686501901140684,0
"<anonymized_userid>",1,53268,7223,"Geert Wilders (PVV)",0.941713073455317,0.686596958174905,0
"<anonymized_userid>",1,53269,7224,"Geert Wilders (PVV)",0.941730752231946,0.686692015209125,0
"<anonymized_userid>",1,53270,7225,"Geert Wilders (PVV)",0.941748431008574,0.686787072243346,0
"<anonymized_userid>",1,53271,7226,"Geert Wilders (PVV)",0.941766109785203,0.686882129277567,0
"<anonymized_userid>",1,53272,7227,"Geert Wilders (PVV)",0.941783788561832,0.686977186311787,0
"<anonymized_userid>",1,53273,7228,"Geert Wilders (PVV)",0.94180146733846,0.687072243346008,0
"<anonymized_userid>",1,53274,7229,"Geert Wilders (PVV)",0.941819146115089,0.687167300380228,0
"<anonymized_userid>",1,53275,7230,"Geert Wilders (PVV)",0.941836824891717,0.687262357414449,0
"<anonymized_userid>",1,53276,7231,"Geert Wilders (PVV)",0.941854503668346,0.687357414448669,0
"<anonymized_userid>",1,53277,7232,"Geert Wilders (PVV)",0.941872182444975,0.68745247148289,0
"<anonymized_userid>",1,53278,7233,"Geert Wilders (PVV)",0.941889861221603,0.68754752851711,0
"<anonymized_userid>",1,53279,7234,"Geert Wilders (PVV)",0.941907539998232,0.687642585551331,0
"<anonymized_userid>",1,53280,7235,"Geert Wilders (PVV)",0.941925218774861,0.687737642585551,0
"<anonymized_userid>",1,53281,7236,"Geert Wilders (PVV)",0.941942897551489,0.687832699619772,0
"<anonymized_userid>",1,53282,7237,"Geert Wilders (PVV)",0.941960576328118,0.687927756653992,0
"<anonymized_userid>",1,53283,7238,"Geert Wilders (PVV)",0.941978255104747,0.688022813688213,0
"<anonymized_userid>",1,53284,7239,"Geert Wilders (PVV)",0.941995933881375,0.688117870722433,0
"<anonymized_userid>",1,53285,7240,"Geert Wilders (PVV)",0.942013612658004,0.688212927756654,0
"<anonymized_userid>",1,53286,7241,"Geert Wilders (PVV)",0.942031291434633,0.688307984790875,0
"<anonymized_userid>",1,53287,7242,"Geert Wilders (PVV)",0.942048970211261,0.688403041825095,0
"<anonymized_userid>",1,53288,7243,"Geert Wilders (PVV)",0.94206664898789,0.688498098859316,0
"<anonymized_userid>",1,53289,7244,"Geert Wilders (PVV)",0.942084327764519,0.688593155893536,0
"<anonymized_userid>",1,53290,7245,"Geert Wilders (PVV)",0.942102006541147,0.688688212927757,0
"<anonymized_userid>",1,53291,7246,"Geert Wilders (PVV)",0.942119685317776,0.688783269961977,0
"<anonymized_userid>",1,53292,7247,"Geert Wilders (PVV)",0.942137364094405,0.688878326996198,0
"<anonymized_userid>",1,53293,7248,"Geert Wilders (PVV)",0.942155042871033,0.688973384030418,0
"<anonymized_userid>",1,53294,7249,"Geert Wilders (PVV)",0.942172721647662,0.689068441064639,0
"<anonymized_userid>",1,53295,7250,"Geert Wilders (PVV)",0.942190400424291,0.689163498098859,0
"<anonymized_userid>",1,53296,7251,"Geert Wilders (PVV)",0.942208079200919,0.68925855513308,0
"<anonymized_userid>",1,53297,7252,"Geert Wilders (PVV)",0.942225757977548,0.6893536121673,0
"<anonymized_userid>",1,53298,7253,"Geert Wilders (PVV)",0.942243436754177,0.689448669201521,0
"<anonymized_userid>",1,53299,7254,"Geert Wilders (PVV)",0.942261115530805,0.689543726235741,0
"<anonymized_userid>",1,53300,7255,"Geert Wilders (PVV)",0.942278794307434,0.689638783269962,0
"<anonymized_userid>",1,53301,7256,"Geert Wilders (PVV)",0.942296473084063,0.689733840304182,0
"<anonymized_userid>",1,53302,7257,"Geert Wilders (PVV)",0.942314151860691,0.689828897338403,0
"<anonymized_userid>",1,53303,7258,"Geert Wilders (PVV)",0.94233183063732,0.689923954372624,0
"<anonymized_userid>",1,53304,7259,"Geert Wilders (PVV)",0.942349509413949,0.690019011406844,0
"<anonymized_userid>",1,53305,7260,"Geert Wilders (PVV)",0.942367188190577,0.690114068441065,0
"<anonymized_userid>",1,53306,7261,"Geert Wilders (PVV)",0.942384866967206,0.690209125475285,0
"<anonymized_userid>",1,53307,7262,"Geert Wilders (PVV)",0.942402545743835,0.690304182509506,0
"<anonymized_userid>",1,53308,7263,"Geert Wilders (PVV)",0.942420224520463,0.690399239543726,0
"<anonymized_userid>",1,53309,7264,"Geert Wilders (PVV)",0.942437903297092,0.690494296577947,0
"<anonymized_userid>",1,53310,7265,"Geert Wilders (PVV)",0.94245558207372,0.690589353612167,0
"<anonymized_userid>",1,53311,7266,"Geert Wilders (PVV)",0.942473260850349,0.690684410646388,0
"<anonymized_userid>",1,53312,7267,"Geert Wilders (PVV)",0.942490939626978,0.690779467680608,0
"<anonymized_userid>",1,53313,7268,"Geert Wilders (PVV)",0.942508618403606,0.690874524714829,0
"<anonymized_userid>",1,53314,7269,"Geert Wilders (PVV)",0.942526297180235,0.690969581749049,0
"<anonymized_userid>",1,53315,7270,"Geert Wilders (PVV)",0.942543975956864,0.69106463878327,0
"<anonymized_userid>",1,53316,7271,"Geert Wilders (PVV)",0.942561654733492,0.69115969581749,0
"<anonymized_userid>",1,53317,7272,"Geert Wilders (PVV)",0.942579333510121,0.691254752851711,0
"<anonymized_userid>",1,53318,7273,"Geert Wilders (PVV)",0.94259701228675,0.691349809885932,0
"<anonymized_userid>",1,53319,7274,"Geert Wilders (PVV)",0.942614691063378,0.691444866920152,0
"<anonymized_userid>",1,53320,7275,"Geert Wilders (PVV)",0.942632369840007,0.691539923954373,0
"<anonymized_userid>",1,53321,7276,"Geert Wilders (PVV)",0.942650048616636,0.691634980988593,0
"<anonymized_userid>",1,53322,7277,"Geert Wilders (PVV)",0.942667727393264,0.691730038022814,0
"<anonymized_userid>",1,53323,7278,"Geert Wilders (PVV)",0.942685406169893,0.691825095057034,0
"<anonymized_userid>",1,53324,7279,"Geert Wilders (PVV)",0.942703084946522,0.691920152091255,0
"<anonymized_userid>",1,53325,7280,"Geert Wilders (PVV)",0.94272076372315,0.692015209125475,0
"<anonymized_userid>",1,53326,7281,"Geert Wilders (PVV)",0.942738442499779,0.692110266159696,0
"<anonymized_userid>",1,53327,7282,"Geert Wilders (PVV)",0.942756121276408,0.692205323193916,0
"<anonymized_userid>",1,53328,7283,"Geert Wilders (PVV)",0.942773800053036,0.692300380228137,0
"<anonymized_userid>",1,53329,7284,"Geert Wilders (PVV)",0.942791478829665,0.692395437262357,0
"<anonymized_userid>",1,53330,7285,"Geert Wilders (PVV)",0.942809157606294,0.692490494296578,0
"<anonymized_userid>",1,53331,7286,"Geert Wilders (PVV)",0.942826836382922,0.692585551330798,0
"<anonymized_userid>",1,53332,7287,"Geert Wilders (PVV)",0.942844515159551,0.692680608365019,0
"<anonymized_userid>",1,53333,7288,"Geert Wilders (PVV)",0.94286219393618,0.69277566539924,0
"<anonymized_userid>",1,53334,7289,"Geert Wilders (PVV)",0.942879872712808,0.69287072243346,0
"<anonymized_userid>",1,53335,7290,"Geert Wilders (PVV)",0.942897551489437,0.692965779467681,0
"<anonymized_userid>",1,53336,7291,"Geert Wilders (PVV)",0.942915230266066,0.693060836501901,0
"<anonymized_userid>",1,53337,7292,"Geert Wilders (PVV)",0.942932909042694,0.693155893536122,0
"<anonymized_userid>",1,53338,7293,"Geert Wilders (PVV)",0.942950587819323,0.693250950570342,0
"<anonymized_userid>",1,53339,7294,"Geert Wilders (PVV)",0.942968266595952,0.693346007604563,0
"<anonymized_userid>",1,53340,7295,"Geert Wilders (PVV)",0.94298594537258,0.693441064638783,0
"<anonymized_userid>",1,53341,7296,"Geert Wilders (PVV)",0.943003624149209,0.693536121673004,0
"<anonymized_userid>",1,53342,7297,"Geert Wilders (PVV)",0.943021302925838,0.693631178707224,0
"<anonymized_userid>",1,53343,7298,"Geert Wilders (PVV)",0.943038981702466,0.693726235741445,0
"<anonymized_userid>",1,53344,7299,"Geert Wilders (PVV)",0.943056660479095,0.693821292775665,0
"<anonymized_userid>",1,53345,7300,"Geert Wilders (PVV)",0.943074339255723,0.693916349809886,0
"<anonymized_userid>",1,53346,7301,"Geert Wilders (PVV)",0.943092018032352,0.694011406844106,0
"<anonymized_userid>",1,53347,7302,"Geert Wilders (PVV)",0.943109696808981,0.694106463878327,0
"<anonymized_userid>",1,53348,7303,"Geert Wilders (PVV)",0.943127375585609,0.694201520912547,0
"<anonymized_userid>",1,53349,7304,"Geert Wilders (PVV)",0.943145054362238,0.694296577946768,0
"<anonymized_userid>",1,53350,7305,"Geert Wilders (PVV)",0.943162733138867,0.694391634980989,0
"<anonymized_userid>",1,53351,7306,"Geert Wilders (PVV)",0.943180411915495,0.694486692015209,0
"<anonymized_userid>",1,53352,7307,"Geert Wilders (PVV)",0.943198090692124,0.69458174904943,0
"<anonymized_userid>",1,53353,7308,"Geert Wilders (PVV)",0.943215769468753,0.69467680608365,0
"<anonymized_userid>",1,53354,7309,"Geert Wilders (PVV)",0.943233448245381,0.694771863117871,0
"<anonymized_userid>",1,53355,7310,"Geert Wilders (PVV)",0.94325112702201,0.694866920152091,0
"<anonymized_userid>",1,53356,7311,"Geert Wilders (PVV)",0.943268805798639,0.694961977186312,0
"<anonymized_userid>",1,53357,7312,"Geert Wilders (PVV)",0.943286484575267,0.695057034220532,0
"<anonymized_userid>",1,53358,7313,"Geert Wilders (PVV)",0.943304163351896,0.695152091254753,0
"<anonymized_userid>",1,53359,7314,"Geert Wilders (PVV)",0.943321842128525,0.695247148288973,0
"<anonymized_userid>",1,53360,7315,"Geert Wilders (PVV)",0.943339520905153,0.695342205323194,0
"<anonymized_userid>",1,53361,7316,"Geert Wilders (PVV)",0.943357199681782,0.695437262357414,0
"<anonymized_userid>",1,53362,7317,"Geert Wilders (PVV)",0.943374878458411,0.695532319391635,0
"<anonymized_userid>",1,53363,7318,"Geert Wilders (PVV)",0.943392557235039,0.695627376425855,0
"<anonymized_userid>",1,53364,7319,"Geert Wilders (PVV)",0.943410236011668,0.695722433460076,0
"<anonymized_userid>",1,53365,7320,"Geert Wilders (PVV)",0.943427914788297,0.695817490494297,0
"<anonymized_userid>",1,53366,7321,"Geert Wilders (PVV)",0.943445593564925,0.695912547528517,0
"<anonymized_userid>",1,53367,7322,"Geert Wilders (PVV)",0.943463272341554,0.696007604562738,0
"<anonymized_userid>",1,53368,7323,"Geert Wilders (PVV)",0.943480951118183,0.696102661596958,0
"<anonymized_userid>",1,53369,7324,"Geert Wilders (PVV)",0.943498629894811,0.696197718631179,0
"<anonymized_userid>",1,53370,7325,"Geert Wilders (PVV)",0.94351630867144,0.696292775665399,0
"<anonymized_userid>",1,53371,7326,"Geert Wilders (PVV)",0.943533987448069,0.69638783269962,0
"<anonymized_userid>",1,53372,7327,"Geert Wilders (PVV)",0.943551666224697,0.69648288973384,0
"<anonymized_userid>",1,53373,7328,"Geert Wilders (PVV)",0.943569345001326,0.696577946768061,0
"<anonymized_userid>",1,53374,7329,"Geert Wilders (PVV)",0.943587023777955,0.696673003802281,0
"<anonymized_userid>",1,53375,7330,"Geert Wilders (PVV)",0.943604702554583,0.696768060836502,0
"<anonymized_userid>",1,53376,7331,"Geert Wilders (PVV)",0.943622381331212,0.696863117870722,0
"<anonymized_userid>",1,53377,7332,"Geert Wilders (PVV)",0.943640060107841,0.696958174904943,0
"<anonymized_userid>",1,53378,7333,"Geert Wilders (PVV)",0.943657738884469,0.697053231939163,0
"<anonymized_userid>",1,53379,7334,"Geert Wilders (PVV)",0.943675417661098,0.697148288973384,0
"<anonymized_userid>",1,53380,7335,"Geert Wilders (PVV)",0.943693096437726,0.697243346007605,0
"<anonymized_userid>",1,53381,7336,"Geert Wilders (PVV)",0.943710775214355,0.697338403041825,0
"<anonymized_userid>",1,53382,7337,"Geert Wilders (PVV)",0.943728453990984,0.697433460076046,0
"<anonymized_userid>",1,53383,7338,"Geert Wilders (PVV)",0.943746132767612,0.697528517110266,0
"<anonymized_userid>",1,53384,7339,"Geert Wilders (PVV)",0.943763811544241,0.697623574144487,0
"<anonymized_userid>",1,53385,7340,"Geert Wilders (PVV)",0.94378149032087,0.697718631178707,0
"<anonymized_userid>",1,53386,7341,"Geert Wilders (PVV)",0.943799169097499,0.697813688212928,0
"<anonymized_userid>",1,53387,7342,"Geert Wilders (PVV)",0.943816847874127,0.697908745247148,0
"<anonymized_userid>",1,53388,7343,"Geert Wilders (PVV)",0.943834526650756,0.698003802281369,0
"<anonymized_userid>",1,53389,7344,"Geert Wilders (PVV)",0.943852205427384,0.698098859315589,0
"<anonymized_userid>",1,53390,7345,"Geert Wilders (PVV)",0.943869884204013,0.69819391634981,0
"<anonymized_userid>",1,53391,7346,"Geert Wilders (PVV)",0.943887562980642,0.69828897338403,0
"<anonymized_userid>",1,53392,7347,"Geert Wilders (PVV)",0.94390524175727,0.698384030418251,0
"<anonymized_userid>",1,53393,7348,"Geert Wilders (PVV)",0.943922920533899,0.698479087452471,0
"<anonymized_userid>",1,53394,7349,"Geert Wilders (PVV)",0.943940599310528,0.698574144486692,0
"<anonymized_userid>",1,53395,7350,"Geert Wilders (PVV)",0.943958278087156,0.698669201520912,0
"<anonymized_userid>",1,53396,7351,"Geert Wilders (PVV)",0.943975956863785,0.698764258555133,0
"<anonymized_userid>",1,53397,7352,"Geert Wilders (PVV)",0.943993635640414,0.698859315589354,0
"<anonymized_userid>",1,53398,7353,"Geert Wilders (PVV)",0.944011314417042,0.698954372623574,0
"<anonymized_userid>",1,53399,7354,"Geert Wilders (PVV)",0.944028993193671,0.699049429657795,0
"<anonymized_userid>",1,53400,7355,"Geert Wilders (PVV)",0.9440466719703,0.699144486692015,0
"<anonymized_userid>",1,53401,7356,"Geert Wilders (PVV)",0.944064350746928,0.699239543726236,0
"<anonymized_userid>",1,53402,7357,"Geert Wilders (PVV)",0.944082029523557,0.699334600760456,0
"<anonymized_userid>",1,53403,7358,"Geert Wilders (PVV)",0.944099708300186,0.699429657794677,0
"<anonymized_userid>",1,53404,7359,"Geert Wilders (PVV)",0.944117387076814,0.699524714828897,0
"<anonymized_userid>",1,53405,7360,"Geert Wilders (PVV)",0.944135065853443,0.699619771863118,0
"<anonymized_userid>",1,53406,7361,"Geert Wilders (PVV)",0.944152744630072,0.699714828897338,0
"<anonymized_userid>",1,53407,7362,"Geert Wilders (PVV)",0.9441704234067,0.699809885931559,0
"<anonymized_userid>",1,53408,7363,"Geert Wilders (PVV)",0.944188102183329,0.699904942965779,0
"<anonymized_userid>",1,53409,7364,"Geert Wilders (PVV)",0.944205780959958,0.7,0
"<anonymized_userid>",1,53410,7365,"Geert Wilders (PVV)",0.944223459736586,0.70009505703422,0
"<anonymized_userid>",1,53411,7366,"Geert Wilders (PVV)",0.944241138513215,0.700190114068441,0
"<anonymized_userid>",1,53412,7367,"Geert Wilders (PVV)",0.944258817289844,0.700285171102662,0
"<anonymized_userid>",1,53413,7368,"Geert Wilders (PVV)",0.944276496066472,0.700380228136882,0
"<anonymized_userid>",1,53414,7369,"Geert Wilders (PVV)",0.944294174843101,0.700475285171103,0
"<anonymized_userid>",1,53415,7370,"Geert Wilders (PVV)",0.944311853619729,0.700570342205323,0
"<anonymized_userid>",1,53416,7371,"Geert Wilders (PVV)",0.944329532396358,0.700665399239544,0
"<anonymized_userid>",1,53417,7372,"Geert Wilders (PVV)",0.944347211172987,0.700760456273764,0
"<anonymized_userid>",1,53418,7373,"Geert Wilders (PVV)",0.944364889949616,0.700855513307985,0
"<anonymized_userid>",1,53419,7374,"Geert Wilders (PVV)",0.944382568726244,0.700950570342205,0
"<anonymized_userid>",1,53420,7375,"Geert Wilders (PVV)",0.944400247502873,0.701045627376426,0
"<anonymized_userid>",1,53421,7376,"Geert Wilders (PVV)",0.944417926279501,0.701140684410646,0
"<anonymized_userid>",1,53422,7377,"Geert Wilders (PVV)",0.94443560505613,0.701235741444867,0
"<anonymized_userid>",1,53423,7378,"Geert Wilders (PVV)",0.944453283832759,0.701330798479087,0
"<anonymized_userid>",1,53424,7379,"Geert Wilders (PVV)",0.944470962609387,0.701425855513308,0
"<anonymized_userid>",1,53425,7380,"Geert Wilders (PVV)",0.944488641386016,0.701520912547528,0
"<anonymized_userid>",1,53426,7381,"Geert Wilders (PVV)",0.944506320162645,0.701615969581749,0
"<anonymized_userid>",1,53427,7382,"Geert Wilders (PVV)",0.944523998939273,0.70171102661597,0
"<anonymized_userid>",1,53428,7383,"Geert Wilders (PVV)",0.944541677715902,0.70180608365019,0
"<anonymized_userid>",1,53429,7384,"Geert Wilders (PVV)",0.944559356492531,0.701901140684411,0
"<anonymized_userid>",1,53430,7385,"Geert Wilders (PVV)",0.944577035269159,0.701996197718631,0
"<anonymized_userid>",1,53431,7386,"Geert Wilders (PVV)",0.944594714045788,0.702091254752852,0
"<anonymized_userid>",1,53432,7387,"Geert Wilders (PVV)",0.944612392822417,0.702186311787072,0
"<anonymized_userid>",1,53433,7388,"Geert Wilders (PVV)",0.944630071599045,0.702281368821293,0
"<anonymized_userid>",1,53434,7389,"Geert Wilders (PVV)",0.944647750375674,0.702376425855513,0
"<anonymized_userid>",1,53435,7390,"Geert Wilders (PVV)",0.944665429152303,0.702471482889734,0
"<anonymized_userid>",1,53436,7391,"Geert Wilders (PVV)",0.944683107928931,0.702566539923954,0
"<anonymized_userid>",1,53437,7392,"Geert Wilders (PVV)",0.94470078670556,0.702661596958175,0
"<anonymized_userid>",1,53438,7393,"Geert Wilders (PVV)",0.944718465482189,0.702756653992395,0
"<anonymized_userid>",1,53439,7394,"Geert Wilders (PVV)",0.944736144258817,0.702851711026616,0
"<anonymized_userid>",1,53440,7395,"Geert Wilders (PVV)",0.944753823035446,0.702946768060836,0
"<anonymized_userid>",1,53441,7396,"Geert Wilders (PVV)",0.944771501812075,0.703041825095057,0
"<anonymized_userid>",1,53442,7397,"Geert Wilders (PVV)",0.944789180588703,0.703136882129278,0
"<anonymized_userid>",1,53443,7398,"Geert Wilders (PVV)",0.944806859365332,0.703231939163498,0
"<anonymized_userid>",1,53444,7399,"Geert Wilders (PVV)",0.944824538141961,0.703326996197719,0
"<anonymized_userid>",1,53445,7400,"Geert Wilders (PVV)",0.944842216918589,0.703422053231939,0
"<anonymized_userid>",1,53446,7401,"Geert Wilders (PVV)",0.944859895695218,0.70351711026616,0
"<anonymized_userid>",1,53447,7402,"Geert Wilders (PVV)",0.944877574471847,0.70361216730038,0
"<anonymized_userid>",1,53448,7403,"Geert Wilders (PVV)",0.944895253248475,0.703707224334601,0
"<anonymized_userid>",1,53449,7404,"Geert Wilders (PVV)",0.944912932025104,0.703802281368821,0
"<anonymized_userid>",1,53450,7405,"Geert Wilders (PVV)",0.944930610801733,0.703897338403042,0
"<anonymized_userid>",1,53451,7406,"Geert Wilders (PVV)",0.944948289578361,0.703992395437262,0
"<anonymized_userid>",1,53452,7407,"Geert Wilders (PVV)",0.94496596835499,0.704087452471483,0
"<anonymized_userid>",1,53453,7408,"Geert Wilders (PVV)",0.944983647131619,0.704182509505703,0
"<anonymized_userid>",1,53454,7409,"Geert Wilders (PVV)",0.945001325908247,0.704277566539924,0
"<anonymized_userid>",1,53455,7410,"Geert Wilders (PVV)",0.945019004684876,0.704372623574145,0
"<anonymized_userid>",1,53456,7411,"Geert Wilders (PVV)",0.945036683461504,0.704467680608365,0
"<anonymized_userid>",1,53457,7412,"Geert Wilders (PVV)",0.945054362238133,0.704562737642586,0
"<anonymized_userid>",1,53458,7413,"Geert Wilders (PVV)",0.945072041014762,0.704657794676806,0
"<anonymized_userid>",1,53459,7414,"Geert Wilders (PVV)",0.94508971979139,0.704752851711027,0
"<anonymized_userid>",1,53460,7415,"Geert Wilders (PVV)",0.945107398568019,0.704847908745247,0
"<anonymized_userid>",1,53461,7416,"Geert Wilders (PVV)",0.945125077344648,0.704942965779468,0
"<anonymized_userid>",1,53462,7417,"Geert Wilders (PVV)",0.945142756121276,0.705038022813688,0
"<anonymized_userid>",1,53463,7418,"Geert Wilders (PVV)",0.945160434897905,0.705133079847909,0
"<anonymized_userid>",1,53464,7419,"Geert Wilders (PVV)",0.945178113674534,0.705228136882129,0
"<anonymized_userid>",1,53465,7420,"Geert Wilders (PVV)",0.945195792451162,0.70532319391635,0
"<anonymized_userid>",1,53466,7421,"Geert Wilders (PVV)",0.945213471227791,0.70541825095057,0
"<anonymized_userid>",1,53467,7422,"Geert Wilders (PVV)",0.94523115000442,0.705513307984791,0
"<anonymized_userid>",1,53468,7423,"Geert Wilders (PVV)",0.945248828781048,0.705608365019011,0
"<anonymized_userid>",1,53469,7424,"Geert Wilders (PVV)",0.945266507557677,0.705703422053232,0
"<anonymized_userid>",1,53470,7425,"Geert Wilders (PVV)",0.945284186334306,0.705798479087453,0
"<anonymized_userid>",1,53471,7426,"Geert Wilders (PVV)",0.945301865110934,0.705893536121673,0
"<anonymized_userid>",1,53472,7427,"Geert Wilders (PVV)",0.945319543887563,0.705988593155894,0
"<anonymized_userid>",1,53473,7428,"Geert Wilders (PVV)",0.945337222664192,0.706083650190114,0
"<anonymized_userid>",1,53474,7429,"Geert Wilders (PVV)",0.94535490144082,0.706178707224335,0
"<anonymized_userid>",1,53475,7430,"Geert Wilders (PVV)",0.945372580217449,0.706273764258555,0
"<anonymized_userid>",1,53476,7431,"Geert Wilders (PVV)",0.945390258994078,0.706368821292776,0
"<anonymized_userid>",1,53477,7432,"Geert Wilders (PVV)",0.945407937770706,0.706463878326996,0
"<anonymized_userid>",1,53478,7433,"Geert Wilders (PVV)",0.945425616547335,0.706558935361217,0
"<anonymized_userid>",1,53479,7434,"Geert Wilders (PVV)",0.945443295323964,0.706653992395437,0
"<anonymized_userid>",1,53480,7435,"Geert Wilders (PVV)",0.945460974100592,0.706749049429658,0
"<anonymized_userid>",1,53481,7436,"Geert Wilders (PVV)",0.945478652877221,0.706844106463878,0
"<anonymized_userid>",1,53482,7437,"Geert Wilders (PVV)",0.94549633165385,0.706939163498099,0
"<anonymized_userid>",1,53483,7438,"Geert Wilders (PVV)",0.945514010430478,0.707034220532319,0
"<anonymized_userid>",1,53484,7439,"Geert Wilders (PVV)",0.945531689207107,0.70712927756654,0
"<anonymized_userid>",1,53485,7440,"Geert Wilders (PVV)",0.945549367983736,0.707224334600761,0
"<anonymized_userid>",1,53486,7441,"Geert Wilders (PVV)",0.945567046760364,0.707319391634981,0
"<anonymized_userid>",1,53487,7442,"Geert Wilders (PVV)",0.945584725536993,0.707414448669202,0
"<anonymized_userid>",1,53488,7443,"Geert Wilders (PVV)",0.945602404313622,0.707509505703422,0
"<anonymized_userid>",1,53489,7444,"Geert Wilders (PVV)",0.94562008309025,0.707604562737643,0
"<anonymized_userid>",1,53490,7445,"Geert Wilders (PVV)",0.945637761866879,0.707699619771863,0
"<anonymized_userid>",1,53491,7446,"Geert Wilders (PVV)",0.945655440643507,0.707794676806084,0
"<anonymized_userid>",1,53492,7447,"Geert Wilders (PVV)",0.945673119420136,0.707889733840304,0
"<anonymized_userid>",1,53493,7448,"Geert Wilders (PVV)",0.945690798196765,0.707984790874525,0
"<anonymized_userid>",1,53494,7449,"Geert Wilders (PVV)",0.945708476973393,0.708079847908745,0
"<anonymized_userid>",1,53495,7450,"Geert Wilders (PVV)",0.945726155750022,0.708174904942966,0
"<anonymized_userid>",1,53496,7451,"Geert Wilders (PVV)",0.945743834526651,0.708269961977186,0
"<anonymized_userid>",1,53497,7452,"Geert Wilders (PVV)",0.945761513303279,0.708365019011407,0
"<anonymized_userid>",1,53498,7453,"Geert Wilders (PVV)",0.945779192079908,0.708460076045627,0
"<anonymized_userid>",1,53499,7454,"Geert Wilders (PVV)",0.945796870856537,0.708555133079848,0
"<anonymized_userid>",1,53500,7455,"Geert Wilders (PVV)",0.945814549633165,0.708650190114068,0
"<anonymized_userid>",1,53501,7456,"Geert Wilders (PVV)",0.945832228409794,0.708745247148289,0
"<anonymized_userid>",1,53502,7457,"Geert Wilders (PVV)",0.945849907186423,0.70884030418251,0
"<anonymized_userid>",1,53503,7458,"Geert Wilders (PVV)",0.945867585963051,0.70893536121673,0
"<anonymized_userid>",1,53504,7459,"Geert Wilders (PVV)",0.94588526473968,0.709030418250951,0
"<anonymized_userid>",1,53505,7460,"Geert Wilders (PVV)",0.945902943516309,0.709125475285171,0
"<anonymized_userid>",1,53506,7461,"Geert Wilders (PVV)",0.945920622292937,0.709220532319392,0
"<anonymized_userid>",1,53507,7462,"Geert Wilders (PVV)",0.945938301069566,0.709315589353612,0
"<anonymized_userid>",1,53508,7463,"Geert Wilders (PVV)",0.945955979846195,0.709410646387833,0
"<anonymized_userid>",1,53509,7464,"Geert Wilders (PVV)",0.945973658622823,0.709505703422053,0
"<anonymized_userid>",1,53510,7465,"Geert Wilders (PVV)",0.945991337399452,0.709600760456274,0
"<anonymized_userid>",1,53511,7466,"Geert Wilders (PVV)",0.946009016176081,0.709695817490494,0
"<anonymized_userid>",1,53512,7467,"Geert Wilders (PVV)",0.946026694952709,0.709790874524715,0
"<anonymized_userid>",1,53513,7468,"Geert Wilders (PVV)",0.946044373729338,0.709885931558935,0
"<anonymized_userid>",1,53514,7469,"Geert Wilders (PVV)",0.946062052505967,0.709980988593156,0
"<anonymized_userid>",1,53515,7470,"Geert Wilders (PVV)",0.946079731282595,0.710076045627376,0
"<anonymized_userid>",1,53516,7471,"Geert Wilders (PVV)",0.946097410059224,0.710171102661597,0
"<anonymized_userid>",1,53517,7472,"Geert Wilders (PVV)",0.946115088835853,0.710266159695818,0
"<anonymized_userid>",1,53518,7473,"Geert Wilders (PVV)",0.946132767612481,0.710361216730038,0
"<anonymized_userid>",1,53519,7474,"Geert Wilders (PVV)",0.94615044638911,0.710456273764259,0
"<anonymized_userid>",1,53520,7475,"Geert Wilders (PVV)",0.946168125165739,0.710551330798479,0
"<anonymized_userid>",1,53521,7476,"Geert Wilders (PVV)",0.946185803942367,0.7106463878327,0
"<anonymized_userid>",1,53522,7477,"Geert Wilders (PVV)",0.946203482718996,0.71074144486692,0
"<anonymized_userid>",1,53523,7478,"Geert Wilders (PVV)",0.946221161495625,0.710836501901141,0
"<anonymized_userid>",1,53524,7479,"Geert Wilders (PVV)",0.946238840272253,0.710931558935361,0
"<anonymized_userid>",1,53525,7480,"Geert Wilders (PVV)",0.946256519048882,0.711026615969582,0
"<anonymized_userid>",1,53526,7481,"Geert Wilders (PVV)",0.94627419782551,0.711121673003802,0
"<anonymized_userid>",1,53527,7482,"Geert Wilders (PVV)",0.946291876602139,0.711216730038023,0
"<anonymized_userid>",1,53528,7483,"Geert Wilders (PVV)",0.946309555378768,0.711311787072243,0
"<anonymized_userid>",1,53529,7484,"Geert Wilders (PVV)",0.946327234155396,0.711406844106464,0
"<anonymized_userid>",1,53530,7485,"Geert Wilders (PVV)",0.946344912932025,0.711501901140684,0
"<anonymized_userid>",1,53531,7486,"Geert Wilders (PVV)",0.946362591708654,0.711596958174905,0
"<anonymized_userid>",1,53532,7487,"Geert Wilders (PVV)",0.946380270485282,0.711692015209126,0
"<anonymized_userid>",1,53533,7488,"Geert Wilders (PVV)",0.946397949261911,0.711787072243346,0
"<anonymized_userid>",1,53534,7489,"Geert Wilders (PVV)",0.94641562803854,0.711882129277567,0
"<anonymized_userid>",1,53535,7490,"Geert Wilders (PVV)",0.946433306815168,0.711977186311787,0
"<anonymized_userid>",1,53536,7491,"Geert Wilders (PVV)",0.946450985591797,0.712072243346008,0
"<anonymized_userid>",1,53537,7492,"Geert Wilders (PVV)",0.946468664368426,0.712167300380228,0
"<anonymized_userid>",1,53538,7493,"Geert Wilders (PVV)",0.946486343145054,0.712262357414449,0
"<anonymized_userid>",1,53539,7494,"Geert Wilders (PVV)",0.946504021921683,0.712357414448669,0
"<anonymized_userid>",1,53540,7495,"Geert Wilders (PVV)",0.946521700698312,0.71245247148289,0
"<anonymized_userid>",1,53541,7496,"Geert Wilders (PVV)",0.94653937947494,0.71254752851711,0
"<anonymized_userid>",1,53542,7497,"Geert Wilders (PVV)",0.946557058251569,0.712642585551331,0
"<anonymized_userid>",1,53543,7498,"Geert Wilders (PVV)",0.946574737028198,0.712737642585551,0
"<anonymized_userid>",1,53544,7499,"Geert Wilders (PVV)",0.946592415804826,0.712832699619772,0
"<anonymized_userid>",1,53545,7500,"Geert Wilders (PVV)",0.946610094581455,0.712927756653992,0
"<anonymized_userid>",1,53546,7501,"Geert Wilders (PVV)",0.946627773358084,0.713022813688213,0
"<anonymized_userid>",1,53547,7502,"Geert Wilders (PVV)",0.946645452134712,0.713117870722433,0
"<anonymized_userid>",1,53548,7503,"Geert Wilders (PVV)",0.946663130911341,0.713212927756654,0
"<anonymized_userid>",1,53549,7504,"Geert Wilders (PVV)",0.94668080968797,0.713307984790875,0
"<anonymized_userid>",1,53550,7505,"Geert Wilders (PVV)",0.946698488464598,0.713403041825095,0
"<anonymized_userid>",1,53551,7506,"Geert Wilders (PVV)",0.946716167241227,0.713498098859316,0
"<anonymized_userid>",1,53552,7507,"Geert Wilders (PVV)",0.946733846017856,0.713593155893536,0
"<anonymized_userid>",1,53553,7508,"Geert Wilders (PVV)",0.946751524794484,0.713688212927757,0
"<anonymized_userid>",1,53554,7509,"Geert Wilders (PVV)",0.946769203571113,0.713783269961977,0
"<anonymized_userid>",1,53555,7510,"Geert Wilders (PVV)",0.946786882347742,0.713878326996198,0
"<anonymized_userid>",1,53556,7511,"Geert Wilders (PVV)",0.94680456112437,0.713973384030418,0
"<anonymized_userid>",1,53557,7512,"Geert Wilders (PVV)",0.946822239900999,0.714068441064639,0
"<anonymized_userid>",1,53558,7513,"Geert Wilders (PVV)",0.946839918677628,0.714163498098859,0
"<anonymized_userid>",1,53559,7514,"Geert Wilders (PVV)",0.946857597454256,0.71425855513308,0
"<anonymized_userid>",1,53560,7515,"Geert Wilders (PVV)",0.946875276230885,0.7143536121673,0
"<anonymized_userid>",1,53561,7516,"Geert Wilders (PVV)",0.946892955007513,0.714448669201521,0
"<anonymized_userid>",1,53562,7517,"Geert Wilders (PVV)",0.946910633784142,0.714543726235741,0
"<anonymized_userid>",1,53563,7518,"Geert Wilders (PVV)",0.946928312560771,0.714638783269962,0
"<anonymized_userid>",1,53564,7519,"Geert Wilders (PVV)",0.946945991337399,0.714733840304183,0
"<anonymized_userid>",1,53565,7520,"Geert Wilders (PVV)",0.946963670114028,0.714828897338403,0
"<anonymized_userid>",1,53566,7521,"Geert Wilders (PVV)",0.946981348890657,0.714923954372624,0
"<anonymized_userid>",1,53567,7522,"Geert Wilders (PVV)",0.946999027667285,0.715019011406844,0
"<anonymized_userid>",1,53568,7523,"Geert Wilders (PVV)",0.947016706443914,0.715114068441065,0
"<anonymized_userid>",1,53569,7524,"Geert Wilders (PVV)",0.947034385220543,0.715209125475285,0
"<anonymized_userid>",1,53570,7525,"Geert Wilders (PVV)",0.947052063997171,0.715304182509506,0
"<anonymized_userid>",1,53571,7526,"Geert Wilders (PVV)",0.9470697427738,0.715399239543726,0
"<anonymized_userid>",1,53572,7527,"Geert Wilders (PVV)",0.947087421550429,0.715494296577947,0
"<anonymized_userid>",1,53573,7528,"Geert Wilders (PVV)",0.947105100327057,0.715589353612167,0
"<anonymized_userid>",1,53574,7529,"Geert Wilders (PVV)",0.947122779103686,0.715684410646388,0
"<anonymized_userid>",1,53575,7530,"Geert Wilders (PVV)",0.947140457880315,0.715779467680608,0
"<anonymized_userid>",1,53576,7531,"Geert Wilders (PVV)",0.947158136656943,0.715874524714829,0
"<anonymized_userid>",1,53577,7532,"Geert Wilders (PVV)",0.947175815433572,0.715969581749049,0
"<anonymized_userid>",1,53578,7533,"Geert Wilders (PVV)",0.947193494210201,0.71606463878327,0
"<anonymized_userid>",1,53579,7534,"Geert Wilders (PVV)",0.947211172986829,0.716159695817491,0
"<anonymized_userid>",1,53580,7535,"Geert Wilders (PVV)",0.947228851763458,0.716254752851711,0
"<anonymized_userid>",1,53581,7536,"Geert Wilders (PVV)",0.947246530540087,0.716349809885932,0
"<anonymized_userid>",1,53582,7537,"Geert Wilders (PVV)",0.947264209316715,0.716444866920152,0
"<anonymized_userid>",1,53583,7538,"Geert Wilders (PVV)",0.947281888093344,0.716539923954373,0
"<anonymized_userid>",1,53584,7539,"Geert Wilders (PVV)",0.947299566869973,0.716634980988593,0
"<anonymized_userid>",1,53585,7540,"Geert Wilders (PVV)",0.947317245646601,0.716730038022814,0
"<anonymized_userid>",1,53586,7541,"Geert Wilders (PVV)",0.94733492442323,0.716825095057034,0
"<anonymized_userid>",1,53587,7542,"Geert Wilders (PVV)",0.947352603199859,0.716920152091255,0
"<anonymized_userid>",1,53588,7543,"Geert Wilders (PVV)",0.947370281976487,0.717015209125475,0
"<anonymized_userid>",1,53589,7544,"Geert Wilders (PVV)",0.947387960753116,0.717110266159696,0
"<anonymized_userid>",1,53590,7545,"Geert Wilders (PVV)",0.947405639529745,0.717205323193916,0
"<anonymized_userid>",1,53591,7546,"Geert Wilders (PVV)",0.947423318306373,0.717300380228137,0
"<anonymized_userid>",1,53592,7547,"Geert Wilders (PVV)",0.947440997083002,0.717395437262357,0
"<anonymized_userid>",1,53593,7548,"Geert Wilders (PVV)",0.947458675859631,0.717490494296578,0
"<anonymized_userid>",1,53594,7549,"Geert Wilders (PVV)",0.947476354636259,0.717585551330798,0
"<anonymized_userid>",1,53595,7550,"Geert Wilders (PVV)",0.947494033412888,0.717680608365019,0
"<anonymized_userid>",1,53596,7551,"Geert Wilders (PVV)",0.947511712189516,0.71777566539924,0
"<anonymized_userid>",1,53597,7552,"Geert Wilders (PVV)",0.947529390966145,0.71787072243346,0
"<anonymized_userid>",1,53598,7553,"Geert Wilders (PVV)",0.947547069742774,0.717965779467681,0
"<anonymized_userid>",1,53599,7554,"Geert Wilders (PVV)",0.947564748519402,0.718060836501901,0
"<anonymized_userid>",1,53600,7555,"Geert Wilders (PVV)",0.947582427296031,0.718155893536122,0
"<anonymized_userid>",1,53601,7556,"Geert Wilders (PVV)",0.94760010607266,0.718250950570342,0
"<anonymized_userid>",1,53602,7557,"Geert Wilders (PVV)",0.947617784849288,0.718346007604563,0
"<anonymized_userid>",1,53603,7558,"Geert Wilders (PVV)",0.947635463625917,0.718441064638783,0
"<anonymized_userid>",1,53604,7559,"Geert Wilders (PVV)",0.947653142402546,0.718536121673004,0
"<anonymized_userid>",1,53605,7560,"Geert Wilders (PVV)",0.947670821179174,0.718631178707224,0
"<anonymized_userid>",1,53606,7561,"Geert Wilders (PVV)",0.947688499955803,0.718726235741445,0
"<anonymized_userid>",1,53607,7562,"Geert Wilders (PVV)",0.947706178732432,0.718821292775665,0
"<anonymized_userid>",1,53608,7563,"Geert Wilders (PVV)",0.94772385750906,0.718916349809886,0
"<anonymized_userid>",1,53609,7564,"Geert Wilders (PVV)",0.947741536285689,0.719011406844106,0
"<anonymized_userid>",1,53610,7565,"Geert Wilders (PVV)",0.947759215062318,0.719106463878327,0
"<anonymized_userid>",1,53611,7566,"Geert Wilders (PVV)",0.947776893838946,0.719201520912548,0
"<anonymized_userid>",1,53612,7567,"Geert Wilders (PVV)",0.947794572615575,0.719296577946768,0
"<anonymized_userid>",1,53613,7568,"Geert Wilders (PVV)",0.947812251392204,0.719391634980989,0
"<anonymized_userid>",1,53614,7569,"Geert Wilders (PVV)",0.947829930168832,0.719486692015209,0
"<anonymized_userid>",1,53615,7570,"Geert Wilders (PVV)",0.947847608945461,0.71958174904943,0
"<anonymized_userid>",1,53616,7571,"Geert Wilders (PVV)",0.94786528772209,0.71967680608365,0
"<anonymized_userid>",1,53617,7572,"Geert Wilders (PVV)",0.947882966498718,0.719771863117871,0
"<anonymized_userid>",1,53618,7573,"Geert Wilders (PVV)",0.947900645275347,0.719866920152091,0
"<anonymized_userid>",1,53619,7574,"Geert Wilders (PVV)",0.947918324051976,0.719961977186312,0
"<anonymized_userid>",1,53620,7575,"Geert Wilders (PVV)",0.947936002828604,0.720057034220532,0
"<anonymized_userid>",1,53621,7576,"Geert Wilders (PVV)",0.947953681605233,0.720152091254753,0
"<anonymized_userid>",1,53622,7577,"Geert Wilders (PVV)",0.947971360381862,0.720247148288973,0
"<anonymized_userid>",1,53623,7578,"Geert Wilders (PVV)",0.94798903915849,0.720342205323194,0
"<anonymized_userid>",1,53624,7579,"Geert Wilders (PVV)",0.948006717935119,0.720437262357414,0
"<anonymized_userid>",1,53625,7580,"Geert Wilders (PVV)",0.948024396711748,0.720532319391635,0
"<anonymized_userid>",1,53626,7581,"Geert Wilders (PVV)",0.948042075488376,0.720627376425856,0
"<anonymized_userid>",1,53627,7582,"Geert Wilders (PVV)",0.948059754265005,0.720722433460076,0
"<anonymized_userid>",1,53628,7583,"Geert Wilders (PVV)",0.948077433041633,0.720817490494297,0
"<anonymized_userid>",1,53629,7584,"Geert Wilders (PVV)",0.948095111818262,0.720912547528517,0
"<anonymized_userid>",1,53630,7585,"Geert Wilders (PVV)",0.948112790594891,0.721007604562738,0
"<anonymized_userid>",1,53631,7586,"Geert Wilders (PVV)",0.948130469371519,0.721102661596958,0
"<anonymized_userid>",1,53632,7587,"Geert Wilders (PVV)",0.948148148148148,0.721197718631179,0
"<anonymized_userid>",1,53633,7588,"Geert Wilders (PVV)",0.948165826924777,0.721292775665399,0
"<anonymized_userid>",1,53634,7589,"Geert Wilders (PVV)",0.948183505701405,0.72138783269962,0
"<anonymized_userid>",1,53635,7590,"Geert Wilders (PVV)",0.948201184478034,0.72148288973384,0
"<anonymized_userid>",1,53636,7591,"Geert Wilders (PVV)",0.948218863254663,0.721577946768061,0
"<anonymized_userid>",1,53637,7592,"Geert Wilders (PVV)",0.948236542031291,0.721673003802281,0
"<anonymized_userid>",1,53638,7593,"Geert Wilders (PVV)",0.94825422080792,0.721768060836502,0
"<anonymized_userid>",1,53639,7594,"Geert Wilders (PVV)",0.948271899584549,0.721863117870722,0
"<anonymized_userid>",1,53640,7595,"Geert Wilders (PVV)",0.948289578361177,0.721958174904943,0
"<anonymized_userid>",1,53641,7596,"Geert Wilders (PVV)",0.948307257137806,0.722053231939163,0
"<anonymized_userid>",1,53642,7597,"Geert Wilders (PVV)",0.948324935914435,0.722148288973384,0
"<anonymized_userid>",1,53643,7598,"Geert Wilders (PVV)",0.948342614691063,0.722243346007605,0
"<anonymized_userid>",1,53644,7599,"Geert Wilders (PVV)",0.948360293467692,0.722338403041825,0
"<anonymized_userid>",1,53645,7600,"Geert Wilders (PVV)",0.948377972244321,0.722433460076046,0
"<anonymized_userid>",1,53646,7601,"Geert Wilders (PVV)",0.948395651020949,0.722528517110266,0
"<anonymized_userid>",1,53647,7602,"Geert Wilders (PVV)",0.948413329797578,0.722623574144487,0
"<anonymized_userid>",1,53648,7603,"Geert Wilders (PVV)",0.948431008574207,0.722718631178707,0
"<anonymized_userid>",1,53649,7604,"Geert Wilders (PVV)",0.948448687350835,0.722813688212928,0
"<anonymized_userid>",1,53650,7605,"Geert Wilders (PVV)",0.948466366127464,0.722908745247148,0
"<anonymized_userid>",1,53651,7606,"Geert Wilders (PVV)",0.948484044904093,0.723003802281369,0
"<anonymized_userid>",1,53652,7607,"Geert Wilders (PVV)",0.948501723680721,0.723098859315589,0
"<anonymized_userid>",1,53653,7608,"Geert Wilders (PVV)",0.94851940245735,0.72319391634981,0
"<anonymized_userid>",1,53654,7609,"Geert Wilders (PVV)",0.948537081233979,0.72328897338403,0
"<anonymized_userid>",1,53655,7610,"Geert Wilders (PVV)",0.948554760010607,0.723384030418251,0
"<anonymized_userid>",1,53656,7611,"Geert Wilders (PVV)",0.948572438787236,0.723479087452471,0
"<anonymized_userid>",1,53657,7612,"Geert Wilders (PVV)",0.948590117563865,0.723574144486692,0
"<anonymized_userid>",1,53658,7613,"Geert Wilders (PVV)",0.948607796340493,0.723669201520913,0
"<anonymized_userid>",1,53659,7614,"Geert Wilders (PVV)",0.948625475117122,0.723764258555133,0
"<anonymized_userid>",1,53660,7615,"Geert Wilders (PVV)",0.948643153893751,0.723859315589354,0
"<anonymized_userid>",1,53661,7616,"Geert Wilders (PVV)",0.948660832670379,0.723954372623574,0
"<anonymized_userid>",1,53662,7617,"Geert Wilders (PVV)",0.948678511447008,0.724049429657795,0
"<anonymized_userid>",1,53663,7618,"Geert Wilders (PVV)",0.948696190223636,0.724144486692015,0
"<anonymized_userid>",1,53664,7619,"Geert Wilders (PVV)",0.948713869000265,0.724239543726236,0
"<anonymized_userid>",1,53665,7620,"Geert Wilders (PVV)",0.948731547776894,0.724334600760456,0
"<anonymized_userid>",1,53666,7621,"Geert Wilders (PVV)",0.948749226553522,0.724429657794677,0
"<anonymized_userid>",1,53667,7622,"Geert Wilders (PVV)",0.948766905330151,0.724524714828897,0
"<anonymized_userid>",1,53668,7623,"Geert Wilders (PVV)",0.94878458410678,0.724619771863118,0
"<anonymized_userid>",1,53669,7624,"Geert Wilders (PVV)",0.948802262883409,0.724714828897338,0
"<anonymized_userid>",1,53670,7625,"Geert Wilders (PVV)",0.948819941660037,0.724809885931559,0
"<anonymized_userid>",1,53671,7626,"Geert Wilders (PVV)",0.948837620436666,0.724904942965779,0
"<anonymized_userid>",1,53672,7627,"Geert Wilders (PVV)",0.948855299213294,0.725,0
"<anonymized_userid>",1,53673,7628,"Geert Wilders (PVV)",0.948872977989923,0.725095057034221,0
"<anonymized_userid>",1,53674,7629,"Geert Wilders (PVV)",0.948890656766552,0.725190114068441,0
"<anonymized_userid>",1,53675,7630,"Geert Wilders (PVV)",0.94890833554318,0.725285171102662,0
"<anonymized_userid>",1,53676,7631,"Geert Wilders (PVV)",0.948926014319809,0.725380228136882,0
"<anonymized_userid>",1,53677,7632,"Geert Wilders (PVV)",0.948943693096438,0.725475285171103,0
"<anonymized_userid>",1,53678,7633,"Geert Wilders (PVV)",0.948961371873066,0.725570342205323,0
"<anonymized_userid>",1,53679,7634,"Geert Wilders (PVV)",0.948979050649695,0.725665399239544,0
"<anonymized_userid>",1,53680,7635,"Geert Wilders (PVV)",0.948996729426324,0.725760456273764,0
"<anonymized_userid>",1,53681,7636,"Geert Wilders (PVV)",0.949014408202952,0.725855513307985,0
"<anonymized_userid>",1,53682,7637,"Geert Wilders (PVV)",0.949032086979581,0.725950570342205,0
"<anonymized_userid>",1,53683,7638,"Geert Wilders (PVV)",0.94904976575621,0.726045627376426,0
"<anonymized_userid>",1,53684,7639,"Geert Wilders (PVV)",0.949067444532838,0.726140684410646,0
"<anonymized_userid>",1,53685,7640,"Geert Wilders (PVV)",0.949085123309467,0.726235741444867,0
"<anonymized_userid>",1,53686,7641,"Geert Wilders (PVV)",0.949102802086096,0.726330798479087,0
"<anonymized_userid>",1,53687,7642,"Geert Wilders (PVV)",0.949120480862724,0.726425855513308,0
"<anonymized_userid>",1,53688,7643,"Geert Wilders (PVV)",0.949138159639353,0.726520912547528,0
"<anonymized_userid>",1,53689,7644,"Geert Wilders (PVV)",0.949155838415982,0.726615969581749,0
"<anonymized_userid>",1,53690,7645,"Geert Wilders (PVV)",0.94917351719261,0.72671102661597,0
"<anonymized_userid>",1,53691,7646,"Geert Wilders (PVV)",0.949191195969239,0.72680608365019,0
"<anonymized_userid>",1,53692,7647,"Geert Wilders (PVV)",0.949208874745868,0.726901140684411,0
"<anonymized_userid>",1,53693,7648,"Geert Wilders (PVV)",0.949226553522496,0.726996197718631,0
"<anonymized_userid>",1,53694,7649,"Geert Wilders (PVV)",0.949244232299125,0.727091254752852,0
"<anonymized_userid>",1,53695,7650,"Geert Wilders (PVV)",0.949261911075754,0.727186311787072,0
"<anonymized_userid>",1,53696,7651,"Geert Wilders (PVV)",0.949279589852382,0.727281368821293,0
"<anonymized_userid>",1,53697,7652,"Geert Wilders (PVV)",0.949297268629011,0.727376425855513,0
"<anonymized_userid>",1,53698,7653,"Geert Wilders (PVV)",0.949314947405639,0.727471482889734,0
"<anonymized_userid>",1,53699,7654,"Geert Wilders (PVV)",0.949332626182268,0.727566539923954,0
"<anonymized_userid>",1,53700,7655,"Geert Wilders (PVV)",0.949350304958897,0.727661596958175,0
"<anonymized_userid>",1,53701,7656,"Geert Wilders (PVV)",0.949367983735526,0.727756653992395,0
"<anonymized_userid>",1,53702,7657,"Geert Wilders (PVV)",0.949385662512154,0.727851711026616,0
"<anonymized_userid>",1,53703,7658,"Geert Wilders (PVV)",0.949403341288783,0.727946768060836,0
"<anonymized_userid>",1,53704,7659,"Geert Wilders (PVV)",0.949421020065412,0.728041825095057,0
"<anonymized_userid>",1,53705,7660,"Geert Wilders (PVV)",0.94943869884204,0.728136882129278,0
"<anonymized_userid>",1,53706,7661,"Geert Wilders (PVV)",0.949456377618669,0.728231939163498,0
"<anonymized_userid>",1,53707,7662,"Geert Wilders (PVV)",0.949474056395297,0.728326996197719,0
"<anonymized_userid>",1,53708,7663,"Geert Wilders (PVV)",0.949491735171926,0.728422053231939,0
"<anonymized_userid>",1,53709,7664,"Geert Wilders (PVV)",0.949509413948555,0.72851711026616,0
"<anonymized_userid>",1,53710,7665,"Geert Wilders (PVV)",0.949527092725183,0.72861216730038,0
"<anonymized_userid>",1,53711,7666,"Geert Wilders (PVV)",0.949544771501812,0.728707224334601,0
"<anonymized_userid>",1,53712,7667,"Geert Wilders (PVV)",0.949562450278441,0.728802281368821,0
"<anonymized_userid>",1,53713,7668,"Geert Wilders (PVV)",0.949580129055069,0.728897338403042,0
"<anonymized_userid>",1,53714,7669,"Geert Wilders (PVV)",0.949597807831698,0.728992395437262,0
"<anonymized_userid>",1,53715,7670,"Geert Wilders (PVV)",0.949615486608327,0.729087452471483,0
"<anonymized_userid>",1,53716,7671,"Geert Wilders (PVV)",0.949633165384955,0.729182509505703,0
"<anonymized_userid>",1,53717,7672,"Geert Wilders (PVV)",0.949650844161584,0.729277566539924,0
"<anonymized_userid>",1,53718,7673,"Geert Wilders (PVV)",0.949668522938213,0.729372623574144,0
"<anonymized_userid>",1,53719,7674,"Geert Wilders (PVV)",0.949686201714841,0.729467680608365,0
"<anonymized_userid>",1,53720,7675,"Geert Wilders (PVV)",0.94970388049147,0.729562737642586,0
"<anonymized_userid>",1,53721,7676,"Geert Wilders (PVV)",0.949721559268099,0.729657794676806,0
"<anonymized_userid>",1,53722,7677,"Geert Wilders (PVV)",0.949739238044727,0.729752851711027,0
"<anonymized_userid>",1,53723,7678,"Geert Wilders (PVV)",0.949756916821356,0.729847908745247,0
"<anonymized_userid>",1,53724,7679,"Geert Wilders (PVV)",0.949774595597985,0.729942965779468,0
"<anonymized_userid>",1,53725,7680,"Geert Wilders (PVV)",0.949792274374613,0.730038022813688,0
"<anonymized_userid>",1,53726,7681,"Geert Wilders (PVV)",0.949809953151242,0.730133079847909,0
"<anonymized_userid>",1,53727,7682,"Geert Wilders (PVV)",0.949827631927871,0.730228136882129,0
"<anonymized_userid>",1,53728,7683,"Geert Wilders (PVV)",0.949845310704499,0.73032319391635,0
"<anonymized_userid>",1,53729,7684,"Geert Wilders (PVV)",0.949862989481128,0.73041825095057,0
"<anonymized_userid>",1,53730,7685,"Geert Wilders (PVV)",0.949880668257757,0.730513307984791,0
"<anonymized_userid>",1,53731,7686,"Geert Wilders (PVV)",0.949898347034385,0.730608365019011,0
"<anonymized_userid>",1,53732,7687,"Geert Wilders (PVV)",0.949916025811014,0.730703422053232,0
"<anonymized_userid>",1,53733,7688,"Geert Wilders (PVV)",0.949933704587642,0.730798479087452,0
"<anonymized_userid>",1,53734,7689,"Geert Wilders (PVV)",0.949951383364271,0.730893536121673,0
"<anonymized_userid>",1,53735,7690,"Geert Wilders (PVV)",0.9499690621409,0.730988593155893,0
"<anonymized_userid>",1,53736,7691,"Geert Wilders (PVV)",0.949986740917529,0.731083650190114,0
"<anonymized_userid>",1,53737,7692,"Geert Wilders (PVV)",0.950004419694157,0.731178707224335,0
"<anonymized_userid>",1,53738,7693,"Geert Wilders (PVV)",0.950022098470786,0.731273764258555,0
"<anonymized_userid>",1,53739,7694,"Geert Wilders (PVV)",0.950039777247415,0.731368821292776,0
"<anonymized_userid>",1,53740,7695,"Geert Wilders (PVV)",0.950057456024043,0.731463878326996,0
"<anonymized_userid>",1,53741,7696,"Geert Wilders (PVV)",0.950075134800672,0.731558935361217,0
"<anonymized_userid>",1,53742,7697,"Geert Wilders (PVV)",0.9500928135773,0.731653992395437,0
"<anonymized_userid>",1,53743,7698,"Geert Wilders (PVV)",0.950110492353929,0.731749049429658,0
"<anonymized_userid>",1,53744,7699,"Geert Wilders (PVV)",0.950128171130558,0.731844106463878,0
"<anonymized_userid>",1,53745,7700,"Geert Wilders (PVV)",0.950145849907186,0.731939163498099,0
"<anonymized_userid>",1,53746,7701,"Geert Wilders (PVV)",0.950163528683815,0.732034220532319,0
"<anonymized_userid>",1,53747,7702,"Geert Wilders (PVV)",0.950181207460444,0.73212927756654,0
"<anonymized_userid>",1,53748,7703,"Geert Wilders (PVV)",0.950198886237072,0.73222433460076,0
"<anonymized_userid>",1,53749,7704,"Geert Wilders (PVV)",0.950216565013701,0.732319391634981,0
"<anonymized_userid>",1,53750,7705,"Geert Wilders (PVV)",0.95023424379033,0.732414448669201,0
"<anonymized_userid>",1,53751,7706,"Geert Wilders (PVV)",0.950251922566958,0.732509505703422,0
"<anonymized_userid>",1,53752,7707,"Geert Wilders (PVV)",0.950269601343587,0.732604562737643,0
"<anonymized_userid>",1,53753,7708,"Geert Wilders (PVV)",0.950287280120216,0.732699619771863,0
"<anonymized_userid>",1,53754,7709,"Geert Wilders (PVV)",0.950304958896844,0.732794676806084,0
"<anonymized_userid>",1,53755,7710,"Geert Wilders (PVV)",0.950322637673473,0.732889733840304,0
"<anonymized_userid>",1,53756,7711,"Geert Wilders (PVV)",0.950340316450102,0.732984790874525,0
"<anonymized_userid>",1,53757,7712,"Geert Wilders (PVV)",0.95035799522673,0.733079847908745,0
"<anonymized_userid>",1,53758,7713,"Geert Wilders (PVV)",0.950375674003359,0.733174904942966,0
"<anonymized_userid>",1,53759,7714,"Geert Wilders (PVV)",0.950393352779988,0.733269961977186,0
"<anonymized_userid>",1,53760,7715,"Geert Wilders (PVV)",0.950411031556616,0.733365019011407,0
"<anonymized_userid>",1,53761,7716,"Geert Wilders (PVV)",0.950428710333245,0.733460076045627,0
"<anonymized_userid>",1,53762,7717,"Geert Wilders (PVV)",0.950446389109874,0.733555133079848,0
"<anonymized_userid>",1,53763,7718,"Geert Wilders (PVV)",0.950464067886502,0.733650190114068,0
"<anonymized_userid>",1,53764,7719,"Geert Wilders (PVV)",0.950481746663131,0.733745247148289,0
"<anonymized_userid>",1,53765,7720,"Geert Wilders (PVV)",0.95049942543976,0.733840304182509,0
"<anonymized_userid>",1,53766,7721,"Geert Wilders (PVV)",0.950517104216388,0.73393536121673,0
"<anonymized_userid>",1,53767,7722,"Geert Wilders (PVV)",0.950534782993017,0.734030418250951,0
"<anonymized_userid>",1,53768,7723,"Geert Wilders (PVV)",0.950552461769646,0.734125475285171,0
"<anonymized_userid>",1,53769,7724,"Geert Wilders (PVV)",0.950570140546274,0.734220532319392,0
"<anonymized_userid>",1,53770,7725,"Geert Wilders (PVV)",0.950587819322903,0.734315589353612,0
"<anonymized_userid>",1,53771,7726,"Geert Wilders (PVV)",0.950605498099532,0.734410646387833,0
"<anonymized_userid>",1,53772,7727,"Geert Wilders (PVV)",0.95062317687616,0.734505703422053,0
"<anonymized_userid>",1,53773,7728,"Geert Wilders (PVV)",0.950640855652789,0.734600760456274,0
"<anonymized_userid>",1,53774,7729,"Geert Wilders (PVV)",0.950658534429418,0.734695817490494,0
"<anonymized_userid>",1,53775,7730,"Geert Wilders (PVV)",0.950676213206046,0.734790874524715,0
"<anonymized_userid>",1,53776,7731,"Geert Wilders (PVV)",0.950693891982675,0.734885931558935,0
"<anonymized_userid>",1,53777,7732,"Geert Wilders (PVV)",0.950711570759303,0.734980988593156,0
"<anonymized_userid>",1,53778,7733,"Geert Wilders (PVV)",0.950729249535932,0.735076045627376,0
"<anonymized_userid>",1,53779,7734,"Geert Wilders (PVV)",0.950746928312561,0.735171102661597,0
"<anonymized_userid>",1,53780,7735,"Geert Wilders (PVV)",0.950764607089189,0.735266159695818,0
"<anonymized_userid>",1,53781,7736,"Geert Wilders (PVV)",0.950782285865818,0.735361216730038,0
"<anonymized_userid>",1,53782,7737,"Geert Wilders (PVV)",0.950799964642447,0.735456273764259,0
"<anonymized_userid>",1,53783,7738,"Geert Wilders (PVV)",0.950817643419075,0.735551330798479,0
"<anonymized_userid>",1,53784,7739,"Geert Wilders (PVV)",0.950835322195704,0.7356463878327,0
"<anonymized_userid>",1,53785,7740,"Geert Wilders (PVV)",0.950853000972333,0.73574144486692,0
"<anonymized_userid>",1,53786,7741,"Geert Wilders (PVV)",0.950870679748961,0.735836501901141,0
"<anonymized_userid>",1,53787,7742,"Geert Wilders (PVV)",0.95088835852559,0.735931558935361,0
"<anonymized_userid>",1,53788,7743,"Geert Wilders (PVV)",0.950906037302219,0.736026615969582,0
"<anonymized_userid>",1,53789,7744,"Geert Wilders (PVV)",0.950923716078847,0.736121673003802,0
"<anonymized_userid>",1,53790,7745,"Geert Wilders (PVV)",0.950941394855476,0.736216730038023,0
"<anonymized_userid>",1,53791,7746,"Geert Wilders (PVV)",0.950959073632105,0.736311787072243,0
"<anonymized_userid>",1,53792,7747,"Geert Wilders (PVV)",0.950976752408733,0.736406844106464,0
"<anonymized_userid>",1,53793,7748,"Geert Wilders (PVV)",0.950994431185362,0.736501901140684,0
"<anonymized_userid>",1,53794,7749,"Geert Wilders (PVV)",0.951012109961991,0.736596958174905,0
"<anonymized_userid>",1,53795,7750,"Geert Wilders (PVV)",0.951029788738619,0.736692015209126,0
"<anonymized_userid>",1,53796,7751,"Geert Wilders (PVV)",0.951047467515248,0.736787072243346,0
"<anonymized_userid>",1,53797,7752,"Geert Wilders (PVV)",0.951065146291877,0.736882129277567,0
"<anonymized_userid>",1,53798,7753,"Geert Wilders (PVV)",0.951082825068505,0.736977186311787,0
"<anonymized_userid>",1,53799,7754,"Geert Wilders (PVV)",0.951100503845134,0.737072243346008,0
"<anonymized_userid>",1,53800,7755,"Geert Wilders (PVV)",0.951118182621763,0.737167300380228,0
"<anonymized_userid>",1,53801,7756,"Geert Wilders (PVV)",0.951135861398391,0.737262357414449,0
"<anonymized_userid>",1,53802,7757,"Geert Wilders (PVV)",0.95115354017502,0.737357414448669,0
"<anonymized_userid>",1,53803,7758,"Geert Wilders (PVV)",0.951171218951649,0.73745247148289,0
"<anonymized_userid>",1,53804,7759,"Geert Wilders (PVV)",0.951188897728277,0.73754752851711,0
"<anonymized_userid>",1,53805,7760,"Geert Wilders (PVV)",0.951206576504906,0.737642585551331,0
"<anonymized_userid>",1,53806,7761,"Geert Wilders (PVV)",0.951224255281535,0.737737642585551,0
"<anonymized_userid>",1,53807,7762,"Geert Wilders (PVV)",0.951241934058163,0.737832699619772,0
"<anonymized_userid>",1,53808,7763,"Geert Wilders (PVV)",0.951259612834792,0.737927756653992,0
"<anonymized_userid>",1,53809,7764,"Geert Wilders (PVV)",0.95127729161142,0.738022813688213,0
"<anonymized_userid>",1,53810,7765,"Geert Wilders (PVV)",0.951294970388049,0.738117870722434,0
"<anonymized_userid>",1,53811,7766,"Geert Wilders (PVV)",0.951312649164678,0.738212927756654,0
"<anonymized_userid>",1,53812,7767,"Geert Wilders (PVV)",0.951330327941306,0.738307984790875,0
"<anonymized_userid>",1,53813,7768,"Geert Wilders (PVV)",0.951348006717935,0.738403041825095,0
"<anonymized_userid>",1,53814,7769,"Geert Wilders (PVV)",0.951365685494564,0.738498098859316,0
"<anonymized_userid>",1,53815,7770,"Geert Wilders (PVV)",0.951383364271192,0.738593155893536,0
"<anonymized_userid>",1,53816,7771,"Geert Wilders (PVV)",0.951401043047821,0.738688212927757,0
"<anonymized_userid>",1,53817,7772,"Geert Wilders (PVV)",0.95141872182445,0.738783269961977,0
"<anonymized_userid>",1,53818,7773,"Geert Wilders (PVV)",0.951436400601078,0.738878326996198,0
"<anonymized_userid>",1,53819,7774,"Geert Wilders (PVV)",0.951454079377707,0.738973384030418,0
"<anonymized_userid>",1,53820,7775,"Geert Wilders (PVV)",0.951471758154336,0.739068441064639,0
"<anonymized_userid>",1,53821,7776,"Geert Wilders (PVV)",0.951489436930964,0.739163498098859,0
"<anonymized_userid>",1,53822,7777,"Geert Wilders (PVV)",0.951507115707593,0.73925855513308,0
"<anonymized_userid>",1,53823,7778,"Geert Wilders (PVV)",0.951524794484222,0.7393536121673,0
"<anonymized_userid>",1,53824,7779,"Geert Wilders (PVV)",0.95154247326085,0.739448669201521,0
"<anonymized_userid>",1,53825,7780,"Geert Wilders (PVV)",0.951560152037479,0.739543726235741,0
"<anonymized_userid>",1,53826,7781,"Geert Wilders (PVV)",0.951577830814108,0.739638783269962,0
"<anonymized_userid>",1,53827,7782,"Geert Wilders (PVV)",0.951595509590736,0.739733840304183,0
"<anonymized_userid>",1,53828,7783,"Geert Wilders (PVV)",0.951613188367365,0.739828897338403,0
"<anonymized_userid>",1,53829,7784,"Geert Wilders (PVV)",0.951630867143994,0.739923954372624,0
"<anonymized_userid>",1,53830,7785,"Geert Wilders (PVV)",0.951648545920622,0.740019011406844,0
"<anonymized_userid>",1,53831,7786,"Geert Wilders (PVV)",0.951666224697251,0.740114068441065,0
"<anonymized_userid>",1,53832,7787,"Geert Wilders (PVV)",0.95168390347388,0.740209125475285,0
"<anonymized_userid>",1,53833,7788,"Geert Wilders (PVV)",0.951701582250508,0.740304182509506,0
"<anonymized_userid>",1,53834,7789,"Geert Wilders (PVV)",0.951719261027137,0.740399239543726,0
"<anonymized_userid>",1,53835,7790,"Geert Wilders (PVV)",0.951736939803766,0.740494296577947,0
"<anonymized_userid>",1,53836,7791,"Geert Wilders (PVV)",0.951754618580394,0.740589353612167,0
"<anonymized_userid>",1,53837,7792,"Geert Wilders (PVV)",0.951772297357023,0.740684410646388,0
"<anonymized_userid>",1,53838,7793,"Geert Wilders (PVV)",0.951789976133652,0.740779467680608,0
"<anonymized_userid>",1,53839,7794,"Geert Wilders (PVV)",0.95180765491028,0.740874524714829,0
"<anonymized_userid>",1,53840,7795,"Geert Wilders (PVV)",0.951825333686909,0.740969581749049,0
"<anonymized_userid>",1,53841,7796,"Geert Wilders (PVV)",0.951843012463538,0.74106463878327,0
"<anonymized_userid>",1,53842,7797,"Geert Wilders (PVV)",0.951860691240166,0.741159695817491,0
"<anonymized_userid>",1,53843,7798,"Geert Wilders (PVV)",0.951878370016795,0.741254752851711,0
"<anonymized_userid>",1,53844,7799,"Geert Wilders (PVV)",0.951896048793423,0.741349809885932,0
"<anonymized_userid>",1,53845,7800,"Geert Wilders (PVV)",0.951913727570052,0.741444866920152,0
"<anonymized_userid>",1,53846,7801,"Geert Wilders (PVV)",0.951931406346681,0.741539923954373,0
"<anonymized_userid>",1,53847,7802,"Geert Wilders (PVV)",0.951949085123309,0.741634980988593,0
"<anonymized_userid>",1,53848,7803,"Geert Wilders (PVV)",0.951966763899938,0.741730038022814,0
"<anonymized_userid>",1,53849,7804,"Geert Wilders (PVV)",0.951984442676567,0.741825095057034,0
"<anonymized_userid>",1,53850,7805,"Geert Wilders (PVV)",0.952002121453195,0.741920152091255,0
"<anonymized_userid>",1,53851,7806,"Geert Wilders (PVV)",0.952019800229824,0.742015209125475,0
"<anonymized_userid>",1,53852,7807,"Geert Wilders (PVV)",0.952037479006453,0.742110266159696,0
"<anonymized_userid>",1,53853,7808,"Geert Wilders (PVV)",0.952055157783081,0.742205323193916,0
"<anonymized_userid>",1,53854,7809,"Geert Wilders (PVV)",0.95207283655971,0.742300380228137,0
"<anonymized_userid>",1,53855,7810,"Geert Wilders (PVV)",0.952090515336339,0.742395437262357,0
"<anonymized_userid>",1,53856,7811,"Geert Wilders (PVV)",0.952108194112967,0.742490494296578,0
"<anonymized_userid>",1,53857,7812,"Geert Wilders (PVV)",0.952125872889596,0.742585551330799,0
"<anonymized_userid>",1,53858,7813,"Geert Wilders (PVV)",0.952143551666225,0.742680608365019,0
"<anonymized_userid>",1,53859,7814,"Geert Wilders (PVV)",0.952161230442853,0.74277566539924,0
"<anonymized_userid>",1,53860,7815,"Geert Wilders (PVV)",0.952178909219482,0.74287072243346,0
"<anonymized_userid>",1,53861,7816,"Geert Wilders (PVV)",0.952196587996111,0.742965779467681,0
"<anonymized_userid>",1,53862,7817,"Geert Wilders (PVV)",0.952214266772739,0.743060836501901,0
"<anonymized_userid>",1,53863,7818,"Geert Wilders (PVV)",0.952231945549368,0.743155893536122,0
"<anonymized_userid>",1,53864,7819,"Geert Wilders (PVV)",0.952249624325997,0.743250950570342,0
"<anonymized_userid>",1,53865,7820,"Geert Wilders (PVV)",0.952267303102625,0.743346007604563,0
"<anonymized_userid>",1,53866,7821,"Geert Wilders (PVV)",0.952284981879254,0.743441064638783,0
"<anonymized_userid>",1,53867,7822,"Geert Wilders (PVV)",0.952302660655883,0.743536121673004,0
"<anonymized_userid>",1,53868,7823,"Geert Wilders (PVV)",0.952320339432511,0.743631178707224,0
"<anonymized_userid>",1,53869,7824,"Geert Wilders (PVV)",0.95233801820914,0.743726235741445,0
"<anonymized_userid>",1,53870,7825,"Geert Wilders (PVV)",0.952355696985769,0.743821292775665,0
"<anonymized_userid>",1,53871,7826,"Geert Wilders (PVV)",0.952373375762397,0.743916349809886,0
"<anonymized_userid>",1,53872,7827,"Geert Wilders (PVV)",0.952391054539026,0.744011406844106,0
"<anonymized_userid>",1,53873,7828,"Geert Wilders (PVV)",0.952408733315655,0.744106463878327,0
"<anonymized_userid>",1,53874,7829,"Geert Wilders (PVV)",0.952426412092283,0.744201520912548,0
"<anonymized_userid>",1,53875,7830,"Geert Wilders (PVV)",0.952444090868912,0.744296577946768,0
"<anonymized_userid>",1,53876,7831,"Geert Wilders (PVV)",0.952461769645541,0.744391634980989,0
"<anonymized_userid>",1,53877,7832,"Geert Wilders (PVV)",0.952479448422169,0.744486692015209,0
"<anonymized_userid>",1,53878,7833,"Geert Wilders (PVV)",0.952497127198798,0.74458174904943,0
"<anonymized_userid>",1,53879,7834,"Geert Wilders (PVV)",0.952514805975426,0.74467680608365,0
"<anonymized_userid>",1,53880,7835,"Geert Wilders (PVV)",0.952532484752055,0.744771863117871,0
"<anonymized_userid>",1,53881,7836,"Geert Wilders (PVV)",0.952550163528684,0.744866920152091,0
"<anonymized_userid>",1,53882,7837,"Geert Wilders (PVV)",0.952567842305312,0.744961977186312,0
"<anonymized_userid>",1,53883,7838,"Geert Wilders (PVV)",0.952585521081941,0.745057034220532,0
"<anonymized_userid>",1,53884,7839,"Geert Wilders (PVV)",0.95260319985857,0.745152091254753,0
"<anonymized_userid>",1,53885,7840,"Geert Wilders (PVV)",0.952620878635198,0.745247148288973,0
"<anonymized_userid>",1,53886,7841,"Geert Wilders (PVV)",0.952638557411827,0.745342205323194,0
"<anonymized_userid>",1,53887,7842,"Geert Wilders (PVV)",0.952656236188456,0.745437262357414,0
"<anonymized_userid>",1,53888,7843,"Geert Wilders (PVV)",0.952673914965084,0.745532319391635,0
"<anonymized_userid>",1,53889,7844,"Geert Wilders (PVV)",0.952691593741713,0.745627376425856,0
"<anonymized_userid>",1,53890,7845,"Geert Wilders (PVV)",0.952709272518342,0.745722433460076,0
"<anonymized_userid>",1,53891,7846,"Geert Wilders (PVV)",0.95272695129497,0.745817490494297,0
"<anonymized_userid>",1,53892,7847,"Geert Wilders (PVV)",0.952744630071599,0.745912547528517,0
"<anonymized_userid>",1,53893,7848,"Geert Wilders (PVV)",0.952762308848228,0.746007604562738,0
"<anonymized_userid>",1,53894,7849,"Geert Wilders (PVV)",0.952779987624856,0.746102661596958,0
"<anonymized_userid>",1,53895,7850,"Geert Wilders (PVV)",0.952797666401485,0.746197718631179,0
"<anonymized_userid>",1,53896,7851,"Geert Wilders (PVV)",0.952815345178114,0.746292775665399,0
"<anonymized_userid>",1,53897,7852,"Geert Wilders (PVV)",0.952833023954742,0.74638783269962,0
"<anonymized_userid>",1,53898,7853,"Geert Wilders (PVV)",0.952850702731371,0.74648288973384,0
"<anonymized_userid>",1,53899,7854,"Geert Wilders (PVV)",0.952868381508,0.746577946768061,0
"<anonymized_userid>",1,53900,7855,"Geert Wilders (PVV)",0.952886060284628,0.746673003802281,0
"<anonymized_userid>",1,53901,7856,"Geert Wilders (PVV)",0.952903739061257,0.746768060836502,0
"<anonymized_userid>",1,53902,7857,"Geert Wilders (PVV)",0.952921417837886,0.746863117870722,0
"<anonymized_userid>",1,53903,7858,"Geert Wilders (PVV)",0.952939096614514,0.746958174904943,0
"<anonymized_userid>",1,53904,7859,"Geert Wilders (PVV)",0.952956775391143,0.747053231939164,0
"<anonymized_userid>",1,53905,7860,"Geert Wilders (PVV)",0.952974454167772,0.747148288973384,0
"<anonymized_userid>",1,53906,7861,"Geert Wilders (PVV)",0.9529921329444,0.747243346007605,0
"<anonymized_userid>",1,53907,7862,"Geert Wilders (PVV)",0.953009811721029,0.747338403041825,0
"<anonymized_userid>",1,53908,7863,"Geert Wilders (PVV)",0.953027490497658,0.747433460076046,0
"<anonymized_userid>",1,53909,7864,"Geert Wilders (PVV)",0.953045169274286,0.747528517110266,0
"<anonymized_userid>",1,53910,7865,"Geert Wilders (PVV)",0.953062848050915,0.747623574144487,0
"<anonymized_userid>",1,53911,7866,"Geert Wilders (PVV)",0.953080526827544,0.747718631178707,0
"<anonymized_userid>",1,53912,7867,"Geert Wilders (PVV)",0.953098205604172,0.747813688212928,0
"<anonymized_userid>",1,53913,7868,"Geert Wilders (PVV)",0.953115884380801,0.747908745247148,0
"<anonymized_userid>",1,53914,7869,"Geert Wilders (PVV)",0.953133563157429,0.748003802281369,0
"<anonymized_userid>",1,53915,7870,"Geert Wilders (PVV)",0.953151241934058,0.748098859315589,0
"<anonymized_userid>",1,53916,7871,"Geert Wilders (PVV)",0.953168920710687,0.74819391634981,0
"<anonymized_userid>",1,53917,7872,"Geert Wilders (PVV)",0.953186599487315,0.74828897338403,0
"<anonymized_userid>",1,53918,7873,"Geert Wilders (PVV)",0.953204278263944,0.748384030418251,0
"<anonymized_userid>",1,53919,7874,"Geert Wilders (PVV)",0.953221957040573,0.748479087452471,0
"<anonymized_userid>",1,53920,7875,"Geert Wilders (PVV)",0.953239635817202,0.748574144486692,0
"<anonymized_userid>",1,53921,7876,"Geert Wilders (PVV)",0.95325731459383,0.748669201520913,0
"<anonymized_userid>",1,53922,7877,"Geert Wilders (PVV)",0.953274993370459,0.748764258555133,0
"<anonymized_userid>",1,53923,7878,"Geert Wilders (PVV)",0.953292672147087,0.748859315589354,0
"<anonymized_userid>",1,53924,7879,"Geert Wilders (PVV)",0.953310350923716,0.748954372623574,0
"<anonymized_userid>",1,53925,7880,"Geert Wilders (PVV)",0.953328029700345,0.749049429657795,0
"<anonymized_userid>",1,53926,7881,"Geert Wilders (PVV)",0.953345708476973,0.749144486692015,0
"<anonymized_userid>",1,53927,7882,"Geert Wilders (PVV)",0.953363387253602,0.749239543726236,0
"<anonymized_userid>",1,53928,7883,"Geert Wilders (PVV)",0.953381066030231,0.749334600760456,0
"<anonymized_userid>",1,53929,7884,"Geert Wilders (PVV)",0.953398744806859,0.749429657794677,0
"<anonymized_userid>",1,53930,7885,"Geert Wilders (PVV)",0.953416423583488,0.749524714828897,0
"<anonymized_userid>",1,53931,7886,"Geert Wilders (PVV)",0.953434102360117,0.749619771863118,0
"<anonymized_userid>",1,53932,7887,"Geert Wilders (PVV)",0.953451781136745,0.749714828897338,0
"<anonymized_userid>",1,53933,7888,"Geert Wilders (PVV)",0.953469459913374,0.749809885931559,0
"<anonymized_userid>",1,53934,7889,"Geert Wilders (PVV)",0.953487138690003,0.749904942965779,0
"<anonymized_userid>",1,53935,7890,"Geert Wilders (PVV)",0.953504817466631,0.75,0
"<anonymized_userid>",1,53936,7891,"Geert Wilders (PVV)",0.95352249624326,0.750095057034221,1
"<anonymized_userid>",1,53937,7892,"Geert Wilders (PVV)",0.953540175019889,0.750190114068441,0
"<anonymized_userid>",1,53938,7893,"Geert Wilders (PVV)",0.953557853796517,0.750285171102662,0
"<anonymized_userid>",1,53939,7894,"Geert Wilders (PVV)",0.953575532573146,0.750380228136882,0
"<anonymized_userid>",1,53940,7895,"Geert Wilders (PVV)",0.953593211349775,0.750475285171103,0
"<anonymized_userid>",1,53941,7896,"Geert Wilders (PVV)",0.953610890126403,0.750570342205323,0
"<anonymized_userid>",1,53942,7897,"Geert Wilders (PVV)",0.953628568903032,0.750665399239544,0
"<anonymized_userid>",1,53943,7898,"Geert Wilders (PVV)",0.953646247679661,0.750760456273764,0
"<anonymized_userid>",1,53944,7899,"Geert Wilders (PVV)",0.953663926456289,0.750855513307985,0
"<anonymized_userid>",1,53945,7900,"Geert Wilders (PVV)",0.953681605232918,0.750950570342205,0
"<anonymized_userid>",1,53946,7901,"Geert Wilders (PVV)",0.953699284009547,0.751045627376426,0
"<anonymized_userid>",1,53947,7902,"Geert Wilders (PVV)",0.953716962786175,0.751140684410646,0
"<anonymized_userid>",1,53948,7903,"Geert Wilders (PVV)",0.953734641562804,0.751235741444867,0
"<anonymized_userid>",1,53949,7904,"Geert Wilders (PVV)",0.953752320339432,0.751330798479087,0
"<anonymized_userid>",1,53950,7905,"Geert Wilders (PVV)",0.953769999116061,0.751425855513308,0
"<anonymized_userid>",1,53951,7906,"Geert Wilders (PVV)",0.95378767789269,0.751520912547529,0
"<anonymized_userid>",1,53952,7907,"Geert Wilders (PVV)",0.953805356669319,0.751615969581749,0
"<anonymized_userid>",1,53953,7908,"Geert Wilders (PVV)",0.953823035445947,0.75171102661597,0
"<anonymized_userid>",1,53954,7909,"Geert Wilders (PVV)",0.953840714222576,0.75180608365019,0
"<anonymized_userid>",1,53955,7910,"Geert Wilders (PVV)",0.953858392999204,0.751901140684411,0
"<anonymized_userid>",1,53956,7911,"Geert Wilders (PVV)",0.953876071775833,0.751996197718631,0
"<anonymized_userid>",1,53957,7912,"Geert Wilders (PVV)",0.953893750552462,0.752091254752852,0
"<anonymized_userid>",1,53958,7913,"Geert Wilders (PVV)",0.95391142932909,0.752186311787072,0
"<anonymized_userid>",1,53959,7914,"Geert Wilders (PVV)",0.953929108105719,0.752281368821293,0
"<anonymized_userid>",1,53960,7915,"Geert Wilders (PVV)",0.953946786882348,0.752376425855513,0
"<anonymized_userid>",1,53961,7916,"Geert Wilders (PVV)",0.953964465658976,0.752471482889734,0
"<anonymized_userid>",1,53962,7917,"Geert Wilders (PVV)",0.953982144435605,0.752566539923954,0
"<anonymized_userid>",1,53963,7918,"Geert Wilders (PVV)",0.953999823212234,0.752661596958175,0
"<anonymized_userid>",1,53964,7919,"Geert Wilders (PVV)",0.954017501988862,0.752756653992395,0
"<anonymized_userid>",1,53965,7920,"Geert Wilders (PVV)",0.954035180765491,0.752851711026616,0
"<anonymized_userid>",1,53966,7921,"Geert Wilders (PVV)",0.95405285954212,0.752946768060836,0
"<anonymized_userid>",1,53967,7922,"Geert Wilders (PVV)",0.954070538318748,0.753041825095057,0
"<anonymized_userid>",1,53968,7923,"Geert Wilders (PVV)",0.954088217095377,0.753136882129278,0
"<anonymized_userid>",1,53969,7924,"Geert Wilders (PVV)",0.954105895872006,0.753231939163498,0
"<anonymized_userid>",1,53970,7925,"Geert Wilders (PVV)",0.954123574648634,0.753326996197719,0
"<anonymized_userid>",1,53971,7926,"Geert Wilders (PVV)",0.954141253425263,0.753422053231939,0
"<anonymized_userid>",1,53972,7927,"Geert Wilders (PVV)",0.954158932201892,0.75351711026616,0
"<anonymized_userid>",1,53973,7928,"Geert Wilders (PVV)",0.95417661097852,0.75361216730038,0
"<anonymized_userid>",1,53974,7929,"Geert Wilders (PVV)",0.954194289755149,0.753707224334601,0
"<anonymized_userid>",1,53975,7930,"Geert Wilders (PVV)",0.954211968531778,0.753802281368821,0
"<anonymized_userid>",1,53976,7931,"Geert Wilders (PVV)",0.954229647308406,0.753897338403042,0
"<anonymized_userid>",1,53977,7932,"Geert Wilders (PVV)",0.954247326085035,0.753992395437262,0
"<anonymized_userid>",1,53978,7933,"Geert Wilders (PVV)",0.954265004861664,0.754087452471483,0
"<anonymized_userid>",1,53979,7934,"Geert Wilders (PVV)",0.954282683638292,0.754182509505703,0
"<anonymized_userid>",1,53980,7935,"Geert Wilders (PVV)",0.954300362414921,0.754277566539924,0
"<anonymized_userid>",1,53981,7936,"Geert Wilders (PVV)",0.95431804119155,0.754372623574144,0
"<anonymized_userid>",1,53982,7937,"Geert Wilders (PVV)",0.954335719968178,0.754467680608365,0
"<anonymized_userid>",1,53983,7938,"Geert Wilders (PVV)",0.954353398744807,0.754562737642586,0
"<anonymized_userid>",1,53984,7939,"Geert Wilders (PVV)",0.954371077521435,0.754657794676806,0
"<anonymized_userid>",1,53985,7940,"Geert Wilders (PVV)",0.954388756298064,0.754752851711027,0
"<anonymized_userid>",1,53986,7941,"Geert Wilders (PVV)",0.954406435074693,0.754847908745247,0
"<anonymized_userid>",1,53987,7942,"Geert Wilders (PVV)",0.954424113851322,0.754942965779468,0
"<anonymized_userid>",1,53988,7943,"Geert Wilders (PVV)",0.95444179262795,0.755038022813688,0
"<anonymized_userid>",1,53989,7944,"Geert Wilders (PVV)",0.954459471404579,0.755133079847909,0
"<anonymized_userid>",1,53990,7945,"Geert Wilders (PVV)",0.954477150181207,0.755228136882129,0
"<anonymized_userid>",1,53991,7946,"Geert Wilders (PVV)",0.954494828957836,0.75532319391635,0
"<anonymized_userid>",1,53992,7947,"Geert Wilders (PVV)",0.954512507734465,0.75541825095057,0
"<anonymized_userid>",1,53993,7948,"Geert Wilders (PVV)",0.954530186511093,0.755513307984791,0
"<anonymized_userid>",1,53994,7949,"Geert Wilders (PVV)",0.954547865287722,0.755608365019011,0
"<anonymized_userid>",1,53995,7950,"Geert Wilders (PVV)",0.954565544064351,0.755703422053232,0
"<anonymized_userid>",1,53996,7951,"Geert Wilders (PVV)",0.954583222840979,0.755798479087452,0
"<anonymized_userid>",1,53997,7952,"Geert Wilders (PVV)",0.954600901617608,0.755893536121673,0
"<anonymized_userid>",1,53998,7953,"Geert Wilders (PVV)",0.954618580394237,0.755988593155894,0
"<anonymized_userid>",1,53999,7954,"Geert Wilders (PVV)",0.954636259170865,0.756083650190114,0
"<anonymized_userid>",1,54000,7955,"Geert Wilders (PVV)",0.954653937947494,0.756178707224335,0
"<anonymized_userid>",1,54001,7956,"Geert Wilders (PVV)",0.954671616724123,0.756273764258555,0
"<anonymized_userid>",1,54002,7957,"Geert Wilders (PVV)",0.954689295500751,0.756368821292776,0
"<anonymized_userid>",1,54003,7958,"Geert Wilders (PVV)",0.95470697427738,0.756463878326996,0
"<anonymized_userid>",1,54004,7959,"Geert Wilders (PVV)",0.954724653054009,0.756558935361217,0
"<anonymized_userid>",1,54005,7960,"Geert Wilders (PVV)",0.954742331830637,0.756653992395437,0
"<anonymized_userid>",1,54006,7961,"Geert Wilders (PVV)",0.954760010607266,0.756749049429658,0
"<anonymized_userid>",1,54007,7962,"Geert Wilders (PVV)",0.954777689383895,0.756844106463878,0
"<anonymized_userid>",1,54008,7963,"Geert Wilders (PVV)",0.954795368160523,0.756939163498099,0
"<anonymized_userid>",1,54009,7964,"Geert Wilders (PVV)",0.954813046937152,0.757034220532319,0
"<anonymized_userid>",1,54010,7965,"Geert Wilders (PVV)",0.954830725713781,0.75712927756654,0
"<anonymized_userid>",1,54011,7966,"Geert Wilders (PVV)",0.954848404490409,0.75722433460076,0
"<anonymized_userid>",1,54012,7967,"Geert Wilders (PVV)",0.954866083267038,0.757319391634981,0
"<anonymized_userid>",1,54013,7968,"Geert Wilders (PVV)",0.954883762043667,0.757414448669201,0
"<anonymized_userid>",1,54014,7969,"Geert Wilders (PVV)",0.954901440820295,0.757509505703422,0
"<anonymized_userid>",1,54015,7970,"Geert Wilders (PVV)",0.954919119596924,0.757604562737643,0
"<anonymized_userid>",1,54016,7971,"Geert Wilders (PVV)",0.954936798373552,0.757699619771863,0
"<anonymized_userid>",1,54017,7972,"Geert Wilders (PVV)",0.954954477150181,0.757794676806084,0
"<anonymized_userid>",1,54018,7973,"Geert Wilders (PVV)",0.95497215592681,0.757889733840304,0
"<anonymized_userid>",1,54019,7974,"Geert Wilders (PVV)",0.954989834703439,0.757984790874525,0
"<anonymized_userid>",1,54020,7975,"Geert Wilders (PVV)",0.955007513480067,0.758079847908745,0
"<anonymized_userid>",1,54021,7976,"Geert Wilders (PVV)",0.955025192256696,0.758174904942966,0
"<anonymized_userid>",1,54022,7977,"Geert Wilders (PVV)",0.955042871033325,0.758269961977186,0
"<anonymized_userid>",1,54023,7978,"Geert Wilders (PVV)",0.955060549809953,0.758365019011407,0
"<anonymized_userid>",1,54024,7979,"Geert Wilders (PVV)",0.955078228586582,0.758460076045627,0
"<anonymized_userid>",1,54025,7980,"Geert Wilders (PVV)",0.95509590736321,0.758555133079848,0
"<anonymized_userid>",1,54026,7981,"Geert Wilders (PVV)",0.955113586139839,0.758650190114068,0
"<anonymized_userid>",1,54027,7982,"Geert Wilders (PVV)",0.955131264916468,0.758745247148289,0
"<anonymized_userid>",1,54028,7983,"Geert Wilders (PVV)",0.955148943693096,0.758840304182509,0
"<anonymized_userid>",1,54029,7984,"Geert Wilders (PVV)",0.955166622469725,0.75893536121673,0
"<anonymized_userid>",1,54030,7985,"Geert Wilders (PVV)",0.955184301246354,0.759030418250951,0
"<anonymized_userid>",1,54031,7986,"Geert Wilders (PVV)",0.955201980022982,0.759125475285171,0
"<anonymized_userid>",1,54032,7987,"Geert Wilders (PVV)",0.955219658799611,0.759220532319392,0
"<anonymized_userid>",1,54033,7988,"Geert Wilders (PVV)",0.95523733757624,0.759315589353612,0
"<anonymized_userid>",1,54034,7989,"Geert Wilders (PVV)",0.955255016352868,0.759410646387833,0
"<anonymized_userid>",1,54035,7990,"Geert Wilders (PVV)",0.955272695129497,0.759505703422053,0
"<anonymized_userid>",1,54036,7991,"Geert Wilders (PVV)",0.955290373906126,0.759600760456274,0
"<anonymized_userid>",1,54037,7992,"Geert Wilders (PVV)",0.955308052682754,0.759695817490494,0
"<anonymized_userid>",1,54038,7993,"Geert Wilders (PVV)",0.955325731459383,0.759790874524715,0
"<anonymized_userid>",1,54039,7994,"Geert Wilders (PVV)",0.955343410236012,0.759885931558935,0
"<anonymized_userid>",1,54040,7995,"Geert Wilders (PVV)",0.95536108901264,0.759980988593156,0
"<anonymized_userid>",1,54041,7996,"Geert Wilders (PVV)",0.955378767789269,0.760076045627376,0
"<anonymized_userid>",1,54042,7997,"Geert Wilders (PVV)",0.955396446565898,0.760171102661597,0
"<anonymized_userid>",1,54043,7998,"Geert Wilders (PVV)",0.955414125342526,0.760266159695817,0
"<anonymized_userid>",1,54044,7999,"Geert Wilders (PVV)",0.955431804119155,0.760361216730038,0
"<anonymized_userid>",1,54045,8000,"Geert Wilders (PVV)",0.955449482895784,0.760456273764259,0
"<anonymized_userid>",1,54046,8001,"Geert Wilders (PVV)",0.955467161672412,0.760551330798479,0
"<anonymized_userid>",1,54047,8002,"Geert Wilders (PVV)",0.955484840449041,0.7606463878327,0
"<anonymized_userid>",1,54048,8003,"Geert Wilders (PVV)",0.95550251922567,0.76074144486692,0
"<anonymized_userid>",1,54049,8004,"Geert Wilders (PVV)",0.955520198002298,0.760836501901141,0
"<anonymized_userid>",1,54050,8005,"Geert Wilders (PVV)",0.955537876778927,0.760931558935361,0
"<anonymized_userid>",1,54051,8006,"Geert Wilders (PVV)",0.955555555555556,0.761026615969582,0
"<anonymized_userid>",1,54052,8007,"Geert Wilders (PVV)",0.955573234332184,0.761121673003802,0
"<anonymized_userid>",1,54053,8008,"Geert Wilders (PVV)",0.955590913108813,0.761216730038023,0
"<anonymized_userid>",1,54054,8009,"Geert Wilders (PVV)",0.955608591885442,0.761311787072243,0
"<anonymized_userid>",1,54055,8010,"Geert Wilders (PVV)",0.95562627066207,0.761406844106464,0
"<anonymized_userid>",1,54056,8011,"Geert Wilders (PVV)",0.955643949438699,0.761501901140684,0
"<anonymized_userid>",1,54057,8012,"Geert Wilders (PVV)",0.955661628215328,0.761596958174905,0
"<anonymized_userid>",1,54058,8013,"Geert Wilders (PVV)",0.955679306991956,0.761692015209125,0
"<anonymized_userid>",1,54059,8014,"Geert Wilders (PVV)",0.955696985768585,0.761787072243346,0
"<anonymized_userid>",1,54060,8015,"Geert Wilders (PVV)",0.955714664545213,0.761882129277566,0
"<anonymized_userid>",1,54061,8016,"Geert Wilders (PVV)",0.955732343321842,0.761977186311787,0
"<anonymized_userid>",1,54062,8017,"Geert Wilders (PVV)",0.955750022098471,0.762072243346008,0
"<anonymized_userid>",1,54063,8018,"Geert Wilders (PVV)",0.955767700875099,0.762167300380228,0
"<anonymized_userid>",1,54064,8019,"Geert Wilders (PVV)",0.955785379651728,0.762262357414449,0
"<anonymized_userid>",1,54065,8020,"Geert Wilders (PVV)",0.955803058428357,0.762357414448669,0
"<anonymized_userid>",1,54066,8021,"Geert Wilders (PVV)",0.955820737204985,0.76245247148289,0
"<anonymized_userid>",1,54067,8022,"Geert Wilders (PVV)",0.955838415981614,0.76254752851711,0
"<anonymized_userid>",1,54068,8023,"Geert Wilders (PVV)",0.955856094758243,0.762642585551331,0
"<anonymized_userid>",1,54069,8024,"Geert Wilders (PVV)",0.955873773534871,0.762737642585551,0
"<anonymized_userid>",1,54070,8025,"Geert Wilders (PVV)",0.9558914523115,0.762832699619772,0
"<anonymized_userid>",1,54071,8026,"Geert Wilders (PVV)",0.955909131088129,0.762927756653992,0
"<anonymized_userid>",1,54072,8027,"Geert Wilders (PVV)",0.955926809864757,0.763022813688213,0
"<anonymized_userid>",1,54073,8028,"Geert Wilders (PVV)",0.955944488641386,0.763117870722433,0
"<anonymized_userid>",1,54074,8029,"Geert Wilders (PVV)",0.955962167418015,0.763212927756654,0
"<anonymized_userid>",1,54075,8030,"Geert Wilders (PVV)",0.955979846194643,0.763307984790874,0
"<anonymized_userid>",1,54076,8031,"Geert Wilders (PVV)",0.955997524971272,0.763403041825095,0
"<anonymized_userid>",1,54077,8032,"Geert Wilders (PVV)",0.956015203747901,0.763498098859316,0
"<anonymized_userid>",1,54078,8033,"Geert Wilders (PVV)",0.956032882524529,0.763593155893536,0
"<anonymized_userid>",1,54079,8034,"Geert Wilders (PVV)",0.956050561301158,0.763688212927757,0
"<anonymized_userid>",1,54080,8035,"Geert Wilders (PVV)",0.956068240077787,0.763783269961977,0
"<anonymized_userid>",1,54081,8036,"Geert Wilders (PVV)",0.956085918854415,0.763878326996198,0
"<anonymized_userid>",1,54082,8037,"Geert Wilders (PVV)",0.956103597631044,0.763973384030418,0
"<anonymized_userid>",1,54083,8038,"Geert Wilders (PVV)",0.956121276407673,0.764068441064639,0
"<anonymized_userid>",1,54084,8039,"Geert Wilders (PVV)",0.956138955184301,0.764163498098859,0
"<anonymized_userid>",1,54085,8040,"Geert Wilders (PVV)",0.95615663396093,0.76425855513308,0
"<anonymized_userid>",1,54086,8041,"Geert Wilders (PVV)",0.956174312737559,0.7643536121673,0
"<anonymized_userid>",1,54087,8042,"Geert Wilders (PVV)",0.956191991514187,0.764448669201521,0
"<anonymized_userid>",1,54088,8043,"Geert Wilders (PVV)",0.956209670290816,0.764543726235741,0
"<anonymized_userid>",1,54089,8044,"Geert Wilders (PVV)",0.956227349067445,0.764638783269962,0
"<anonymized_userid>",1,54090,8045,"Geert Wilders (PVV)",0.956245027844073,0.764733840304182,0
"<anonymized_userid>",1,54091,8046,"Geert Wilders (PVV)",0.956262706620702,0.764828897338403,0
"<anonymized_userid>",1,54092,8047,"Geert Wilders (PVV)",0.956280385397331,0.764923954372624,0
"<anonymized_userid>",1,54093,8048,"Geert Wilders (PVV)",0.956298064173959,0.765019011406844,0
"<anonymized_userid>",1,54094,8049,"Geert Wilders (PVV)",0.956315742950588,0.765114068441065,0
"<anonymized_userid>",1,54095,8050,"Geert Wilders (PVV)",0.956333421727216,0.765209125475285,0
"<anonymized_userid>",1,54096,8051,"Geert Wilders (PVV)",0.956351100503845,0.765304182509506,0
"<anonymized_userid>",1,54097,8052,"Geert Wilders (PVV)",0.956368779280474,0.765399239543726,0
"<anonymized_userid>",1,54098,8053,"Geert Wilders (PVV)",0.956386458057102,0.765494296577947,0
"<anonymized_userid>",1,54099,8054,"Geert Wilders (PVV)",0.956404136833731,0.765589353612167,0
"<anonymized_userid>",1,54100,8055,"Geert Wilders (PVV)",0.95642181561036,0.765684410646388,0
"<anonymized_userid>",1,54101,8056,"Geert Wilders (PVV)",0.956439494386988,0.765779467680608,0
"<anonymized_userid>",1,54102,8057,"Geert Wilders (PVV)",0.956457173163617,0.765874524714829,0
"<anonymized_userid>",1,54103,8058,"Geert Wilders (PVV)",0.956474851940246,0.765969581749049,0
"<anonymized_userid>",1,54104,8059,"Geert Wilders (PVV)",0.956492530716874,0.76606463878327,0
"<anonymized_userid>",1,54105,8060,"Geert Wilders (PVV)",0.956510209493503,0.766159695817491,0
"<anonymized_userid>",1,54106,8061,"Geert Wilders (PVV)",0.956527888270132,0.766254752851711,0
"<anonymized_userid>",1,54107,8062,"Geert Wilders (PVV)",0.95654556704676,0.766349809885932,0
"<anonymized_userid>",1,54108,8063,"Geert Wilders (PVV)",0.956563245823389,0.766444866920152,0
"<anonymized_userid>",1,54109,8064,"Geert Wilders (PVV)",0.956580924600018,0.766539923954373,0
"<anonymized_userid>",1,54110,8065,"Geert Wilders (PVV)",0.956598603376646,0.766634980988593,0
"<anonymized_userid>",1,54111,8066,"Geert Wilders (PVV)",0.956616282153275,0.766730038022814,0
"<anonymized_userid>",1,54112,8067,"Geert Wilders (PVV)",0.956633960929904,0.766825095057034,0
"<anonymized_userid>",1,54113,8068,"Geert Wilders (PVV)",0.956651639706532,0.766920152091255,0
"<anonymized_userid>",1,54114,8069,"Geert Wilders (PVV)",0.956669318483161,0.767015209125475,0
"<anonymized_userid>",1,54115,8070,"Geert Wilders (PVV)",0.95668699725979,0.767110266159696,0
"<anonymized_userid>",1,54116,8071,"Geert Wilders (PVV)",0.956704676036418,0.767205323193916,0
"<anonymized_userid>",1,54117,8072,"Geert Wilders (PVV)",0.956722354813047,0.767300380228137,0
"<anonymized_userid>",1,54118,8073,"Geert Wilders (PVV)",0.956740033589676,0.767395437262357,0
"<anonymized_userid>",1,54119,8074,"Geert Wilders (PVV)",0.956757712366304,0.767490494296578,0
"<anonymized_userid>",1,54120,8075,"Geert Wilders (PVV)",0.956775391142933,0.767585551330799,0
"<anonymized_userid>",1,54121,8076,"Geert Wilders (PVV)",0.956793069919562,0.767680608365019,0
"<anonymized_userid>",1,54122,8077,"Geert Wilders (PVV)",0.95681074869619,0.76777566539924,0
"<anonymized_userid>",1,54123,8078,"Geert Wilders (PVV)",0.956828427472819,0.76787072243346,0
"<anonymized_userid>",1,54124,8079,"Geert Wilders (PVV)",0.956846106249448,0.767965779467681,0
"<anonymized_userid>",1,54125,8080,"Geert Wilders (PVV)",0.956863785026076,0.768060836501901,0
"<anonymized_userid>",1,54126,8081,"Geert Wilders (PVV)",0.956881463802705,0.768155893536122,0
"<anonymized_userid>",1,54127,8082,"Geert Wilders (PVV)",0.956899142579334,0.768250950570342,0
"<anonymized_userid>",1,54128,8083,"Geert Wilders (PVV)",0.956916821355962,0.768346007604563,0
"<anonymized_userid>",1,54129,8084,"Geert Wilders (PVV)",0.956934500132591,0.768441064638783,0
"<anonymized_userid>",1,54130,8085,"Geert Wilders (PVV)",0.956952178909219,0.768536121673004,0
"<anonymized_userid>",1,54131,8086,"Geert Wilders (PVV)",0.956969857685848,0.768631178707224,0
"<anonymized_userid>",1,54132,8087,"Geert Wilders (PVV)",0.956987536462477,0.768726235741445,0
"<anonymized_userid>",1,54133,8088,"Geert Wilders (PVV)",0.957005215239105,0.768821292775665,0
"<anonymized_userid>",1,54134,8089,"Geert Wilders (PVV)",0.957022894015734,0.768916349809886,0
"<anonymized_userid>",1,54135,8090,"Geert Wilders (PVV)",0.957040572792363,0.769011406844107,0
"<anonymized_userid>",1,54136,8091,"Geert Wilders (PVV)",0.957058251568991,0.769106463878327,0
"<anonymized_userid>",1,54137,8092,"Geert Wilders (PVV)",0.95707593034562,0.769201520912548,0
"<anonymized_userid>",1,54138,8093,"Geert Wilders (PVV)",0.957093609122249,0.769296577946768,0
"<anonymized_userid>",1,54139,8094,"Geert Wilders (PVV)",0.957111287898877,0.769391634980989,0
"<anonymized_userid>",1,54140,8095,"Geert Wilders (PVV)",0.957128966675506,0.769486692015209,0
"<anonymized_userid>",1,54141,8096,"Geert Wilders (PVV)",0.957146645452135,0.76958174904943,0
"<anonymized_userid>",1,54142,8097,"Geert Wilders (PVV)",0.957164324228763,0.76967680608365,0
"<anonymized_userid>",1,54143,8098,"Geert Wilders (PVV)",0.957182003005392,0.769771863117871,0
"<anonymized_userid>",1,54144,8099,"Geert Wilders (PVV)",0.957199681782021,0.769866920152091,0
"<anonymized_userid>",1,54145,8100,"Geert Wilders (PVV)",0.957217360558649,0.769961977186312,0
"<anonymized_userid>",1,54146,8101,"Geert Wilders (PVV)",0.957235039335278,0.770057034220532,0
"<anonymized_userid>",1,54147,8102,"Geert Wilders (PVV)",0.957252718111907,0.770152091254753,0
"<anonymized_userid>",1,54148,8103,"Geert Wilders (PVV)",0.957270396888535,0.770247148288973,0
"<anonymized_userid>",1,54149,8104,"Geert Wilders (PVV)",0.957288075665164,0.770342205323194,0
"<anonymized_userid>",1,54150,8105,"Geert Wilders (PVV)",0.957305754441793,0.770437262357414,0
"<anonymized_userid>",1,54151,8106,"Geert Wilders (PVV)",0.957323433218421,0.770532319391635,0
"<anonymized_userid>",1,54152,8107,"Geert Wilders (PVV)",0.95734111199505,0.770627376425856,0
"<anonymized_userid>",1,54153,8108,"Geert Wilders (PVV)",0.957358790771679,0.770722433460076,0
"<anonymized_userid>",1,54154,8109,"Geert Wilders (PVV)",0.957376469548307,0.770817490494297,0
"<anonymized_userid>",1,54155,8110,"Geert Wilders (PVV)",0.957394148324936,0.770912547528517,0
"<anonymized_userid>",1,54156,8111,"Geert Wilders (PVV)",0.957411827101565,0.771007604562738,0
"<anonymized_userid>",1,54157,8112,"Geert Wilders (PVV)",0.957429505878193,0.771102661596958,0
"<anonymized_userid>",1,54158,8113,"Geert Wilders (PVV)",0.957447184654822,0.771197718631179,0
"<anonymized_userid>",1,54159,8114,"Geert Wilders (PVV)",0.957464863431451,0.771292775665399,0
"<anonymized_userid>",1,54160,8115,"Geert Wilders (PVV)",0.957482542208079,0.77138783269962,0
"<anonymized_userid>",1,54161,8116,"Geert Wilders (PVV)",0.957500220984708,0.77148288973384,0
"<anonymized_userid>",1,54162,8117,"Geert Wilders (PVV)",0.957517899761336,0.771577946768061,0
"<anonymized_userid>",1,54163,8118,"Geert Wilders (PVV)",0.957535578537965,0.771673003802281,0
"<anonymized_userid>",1,54164,8119,"Geert Wilders (PVV)",0.957553257314594,0.771768060836502,0
"<anonymized_userid>",1,54165,8120,"Geert Wilders (PVV)",0.957570936091222,0.771863117870722,0
"<anonymized_userid>",1,54166,8121,"Geert Wilders (PVV)",0.957588614867851,0.771958174904943,0
"<anonymized_userid>",1,54167,8122,"Geert Wilders (PVV)",0.95760629364448,0.772053231939164,0
"<anonymized_userid>",1,54168,8123,"Geert Wilders (PVV)",0.957623972421108,0.772148288973384,0
"<anonymized_userid>",1,54169,8124,"Geert Wilders (PVV)",0.957641651197737,0.772243346007605,0
"<anonymized_userid>",1,54170,8125,"Geert Wilders (PVV)",0.957659329974366,0.772338403041825,0
"<anonymized_userid>",1,54171,8126,"Geert Wilders (PVV)",0.957677008750994,0.772433460076046,0
"<anonymized_userid>",1,54172,8127,"Geert Wilders (PVV)",0.957694687527623,0.772528517110266,0
"<anonymized_userid>",1,54173,8128,"Geert Wilders (PVV)",0.957712366304252,0.772623574144487,0
"<anonymized_userid>",1,54174,8129,"Geert Wilders (PVV)",0.95773004508088,0.772718631178707,0
"<anonymized_userid>",1,54175,8130,"Geert Wilders (PVV)",0.957747723857509,0.772813688212928,0
"<anonymized_userid>",1,54176,8131,"Geert Wilders (PVV)",0.957765402634138,0.772908745247148,0
"<anonymized_userid>",1,54177,8132,"Geert Wilders (PVV)",0.957783081410766,0.773003802281369,0
"<anonymized_userid>",1,54178,8133,"Geert Wilders (PVV)",0.957800760187395,0.773098859315589,0
"<anonymized_userid>",1,54179,8134,"Geert Wilders (PVV)",0.957818438964024,0.77319391634981,0
"<anonymized_userid>",1,54180,8135,"Geert Wilders (PVV)",0.957836117740652,0.77328897338403,0
"<anonymized_userid>",1,54181,8136,"Geert Wilders (PVV)",0.957853796517281,0.773384030418251,0
"<anonymized_userid>",1,54182,8137,"Geert Wilders (PVV)",0.95787147529391,0.773479087452472,0
"<anonymized_userid>",1,54183,8138,"Geert Wilders (PVV)",0.957889154070538,0.773574144486692,0
"<anonymized_userid>",1,54184,8139,"Geert Wilders (PVV)",0.957906832847167,0.773669201520913,0
"<anonymized_userid>",1,54185,8140,"Geert Wilders (PVV)",0.957924511623796,0.773764258555133,0
"<anonymized_userid>",1,54186,8141,"Geert Wilders (PVV)",0.957942190400424,0.773859315589354,0
"<anonymized_userid>",1,54187,8142,"Geert Wilders (PVV)",0.957959869177053,0.773954372623574,0
"<anonymized_userid>",1,54188,8143,"Geert Wilders (PVV)",0.957977547953682,0.774049429657795,0
"<anonymized_userid>",1,54189,8144,"Geert Wilders (PVV)",0.95799522673031,0.774144486692015,0
"<anonymized_userid>",1,54190,8145,"Geert Wilders (PVV)",0.958012905506939,0.774239543726236,0
"<anonymized_userid>",1,54191,8146,"Geert Wilders (PVV)",0.958030584283568,0.774334600760456,0
"<anonymized_userid>",1,54192,8147,"Geert Wilders (PVV)",0.958048263060196,0.774429657794677,0
"<anonymized_userid>",1,54193,8148,"Geert Wilders (PVV)",0.958065941836825,0.774524714828897,0
"<anonymized_userid>",1,54194,8149,"Geert Wilders (PVV)",0.958083620613454,0.774619771863118,0
"<anonymized_userid>",1,54195,8150,"Geert Wilders (PVV)",0.958101299390082,0.774714828897338,0
"<anonymized_userid>",1,54196,8151,"Geert Wilders (PVV)",0.958118978166711,0.774809885931559,0
"<anonymized_userid>",1,54197,8152,"Geert Wilders (PVV)",0.958136656943339,0.774904942965779,0
"<anonymized_userid>",1,54198,8153,"Geert Wilders (PVV)",0.958154335719968,0.775,0
"<anonymized_userid>",1,54199,8154,"Geert Wilders (PVV)",0.958172014496597,0.775095057034221,0
"<anonymized_userid>",1,54200,8155,"Geert Wilders (PVV)",0.958189693273225,0.775190114068441,0
"<anonymized_userid>",1,54201,8156,"Geert Wilders (PVV)",0.958207372049854,0.775285171102662,0
"<anonymized_userid>",1,54202,8157,"Geert Wilders (PVV)",0.958225050826483,0.775380228136882,0
"<anonymized_userid>",1,54203,8158,"Geert Wilders (PVV)",0.958242729603111,0.775475285171103,0
"<anonymized_userid>",1,54204,8159,"Geert Wilders (PVV)",0.95826040837974,0.775570342205323,0
"<anonymized_userid>",1,54205,8160,"Geert Wilders (PVV)",0.958278087156369,0.775665399239544,0
"<anonymized_userid>",1,54206,8161,"Geert Wilders (PVV)",0.958295765932997,0.775760456273764,0
"<anonymized_userid>",1,54207,8162,"Geert Wilders (PVV)",0.958313444709626,0.775855513307985,0
"<anonymized_userid>",1,54208,8163,"Geert Wilders (PVV)",0.958331123486255,0.775950570342205,0
"<anonymized_userid>",1,54209,8164,"Geert Wilders (PVV)",0.958348802262883,0.776045627376426,0
"<anonymized_userid>",1,54210,8165,"Geert Wilders (PVV)",0.958366481039512,0.776140684410646,0
"<anonymized_userid>",1,54211,8166,"Geert Wilders (PVV)",0.958384159816141,0.776235741444867,0
"<anonymized_userid>",1,54212,8167,"Geert Wilders (PVV)",0.958401838592769,0.776330798479087,0
"<anonymized_userid>",1,54213,8168,"Geert Wilders (PVV)",0.958419517369398,0.776425855513308,0
"<anonymized_userid>",1,54214,8169,"Geert Wilders (PVV)",0.958437196146027,0.776520912547529,0
"<anonymized_userid>",1,54215,8170,"Geert Wilders (PVV)",0.958454874922655,0.776615969581749,0
"<anonymized_userid>",1,54216,8171,"Geert Wilders (PVV)",0.958472553699284,0.77671102661597,0
"<anonymized_userid>",1,54217,8172,"Geert Wilders (PVV)",0.958490232475913,0.77680608365019,0
"<anonymized_userid>",1,54218,8173,"Geert Wilders (PVV)",0.958507911252541,0.776901140684411,0
"<anonymized_userid>",1,54219,8174,"Geert Wilders (PVV)",0.95852559002917,0.776996197718631,0
"<anonymized_userid>",1,54220,8175,"Geert Wilders (PVV)",0.958543268805799,0.777091254752852,0
"<anonymized_userid>",1,54221,8176,"Geert Wilders (PVV)",0.958560947582427,0.777186311787072,0
"<anonymized_userid>",1,54222,8177,"Geert Wilders (PVV)",0.958578626359056,0.777281368821293,0
"<anonymized_userid>",1,54223,8178,"Geert Wilders (PVV)",0.958596305135685,0.777376425855513,0
"<anonymized_userid>",1,54224,8179,"Geert Wilders (PVV)",0.958613983912313,0.777471482889734,0
"<anonymized_userid>",1,54225,8180,"Geert Wilders (PVV)",0.958631662688942,0.777566539923954,0
"<anonymized_userid>",1,54226,8181,"Geert Wilders (PVV)",0.958649341465571,0.777661596958175,0
"<anonymized_userid>",1,54227,8182,"Geert Wilders (PVV)",0.958667020242199,0.777756653992395,0
"<anonymized_userid>",1,54228,8183,"Geert Wilders (PVV)",0.958684699018828,0.777851711026616,0
"<anonymized_userid>",1,54229,8184,"Geert Wilders (PVV)",0.958702377795457,0.777946768060837,0
"<anonymized_userid>",1,54230,8185,"Geert Wilders (PVV)",0.958720056572085,0.778041825095057,0
"<anonymized_userid>",1,54231,8186,"Geert Wilders (PVV)",0.958737735348714,0.778136882129278,0
"<anonymized_userid>",1,54232,8187,"Geert Wilders (PVV)",0.958755414125342,0.778231939163498,0
"<anonymized_userid>",1,54233,8188,"Geert Wilders (PVV)",0.958773092901971,0.778326996197719,0
"<anonymized_userid>",1,54234,8189,"Geert Wilders (PVV)",0.9587907716786,0.778422053231939,0
"<anonymized_userid>",1,54235,8190,"Geert Wilders (PVV)",0.958808450455228,0.77851711026616,0
"<anonymized_userid>",1,54236,8191,"Geert Wilders (PVV)",0.958826129231857,0.77861216730038,0
"<anonymized_userid>",1,54237,8192,"Geert Wilders (PVV)",0.958843808008486,0.778707224334601,0
"<anonymized_userid>",1,54238,8193,"Geert Wilders (PVV)",0.958861486785115,0.778802281368821,0
"<anonymized_userid>",1,54239,8194,"Geert Wilders (PVV)",0.958879165561743,0.778897338403042,0
"<anonymized_userid>",1,54240,8195,"Geert Wilders (PVV)",0.958896844338372,0.778992395437262,0
"<anonymized_userid>",1,54241,8196,"Geert Wilders (PVV)",0.958914523115,0.779087452471483,0
"<anonymized_userid>",1,54242,8197,"Geert Wilders (PVV)",0.958932201891629,0.779182509505703,0
"<anonymized_userid>",1,54243,8198,"Geert Wilders (PVV)",0.958949880668258,0.779277566539924,0
"<anonymized_userid>",1,54244,8199,"Geert Wilders (PVV)",0.958967559444886,0.779372623574144,0
"<anonymized_userid>",1,54245,8200,"Geert Wilders (PVV)",0.958985238221515,0.779467680608365,0
"<anonymized_userid>",1,54246,8201,"Geert Wilders (PVV)",0.959002916998144,0.779562737642586,0
"<anonymized_userid>",1,54247,8202,"Geert Wilders (PVV)",0.959020595774772,0.779657794676806,0
"<anonymized_userid>",1,54248,8203,"Geert Wilders (PVV)",0.959038274551401,0.779752851711027,0
"<anonymized_userid>",1,54249,8204,"Geert Wilders (PVV)",0.95905595332803,0.779847908745247,0
"<anonymized_userid>",1,54250,8205,"Geert Wilders (PVV)",0.959073632104658,0.779942965779468,0
"<anonymized_userid>",1,54251,8206,"Geert Wilders (PVV)",0.959091310881287,0.780038022813688,0
"<anonymized_userid>",1,54252,8207,"Geert Wilders (PVV)",0.959108989657916,0.780133079847909,0
"<anonymized_userid>",1,54253,8208,"Geert Wilders (PVV)",0.959126668434544,0.780228136882129,0
"<anonymized_userid>",1,54254,8209,"Geert Wilders (PVV)",0.959144347211173,0.78032319391635,0
"<anonymized_userid>",1,54255,8210,"Geert Wilders (PVV)",0.959162025987802,0.78041825095057,0
"<anonymized_userid>",1,54256,8211,"Geert Wilders (PVV)",0.95917970476443,0.780513307984791,0
"<anonymized_userid>",1,54257,8212,"Geert Wilders (PVV)",0.959197383541059,0.780608365019011,0
"<anonymized_userid>",1,54258,8213,"Geert Wilders (PVV)",0.959215062317688,0.780703422053232,0
"<anonymized_userid>",1,54259,8214,"Geert Wilders (PVV)",0.959232741094316,0.780798479087452,0
"<anonymized_userid>",1,54260,8215,"Geert Wilders (PVV)",0.959250419870945,0.780893536121673,0
"<anonymized_userid>",1,54261,8216,"Geert Wilders (PVV)",0.959268098647574,0.780988593155894,0
"<anonymized_userid>",1,54262,8217,"Geert Wilders (PVV)",0.959285777424202,0.781083650190114,0
"<anonymized_userid>",1,54263,8218,"Geert Wilders (PVV)",0.959303456200831,0.781178707224335,0
"<anonymized_userid>",1,54264,8219,"Geert Wilders (PVV)",0.95932113497746,0.781273764258555,0
"<anonymized_userid>",1,54265,8220,"Geert Wilders (PVV)",0.959338813754088,0.781368821292776,0
"<anonymized_userid>",1,54266,8221,"Geert Wilders (PVV)",0.959356492530717,0.781463878326996,0
"<anonymized_userid>",1,54267,8222,"Geert Wilders (PVV)",0.959374171307345,0.781558935361217,0
"<anonymized_userid>",1,54268,8223,"Geert Wilders (PVV)",0.959391850083974,0.781653992395437,0
"<anonymized_userid>",1,54269,8224,"Geert Wilders (PVV)",0.959409528860603,0.781749049429658,0
"<anonymized_userid>",1,54270,8225,"Geert Wilders (PVV)",0.959427207637232,0.781844106463878,0
"<anonymized_userid>",1,54271,8226,"Geert Wilders (PVV)",0.95944488641386,0.781939163498099,0
"<anonymized_userid>",1,54272,8227,"Geert Wilders (PVV)",0.959462565190489,0.782034220532319,0
"<anonymized_userid>",1,54273,8228,"Geert Wilders (PVV)",0.959480243967118,0.78212927756654,0
"<anonymized_userid>",1,54274,8229,"Geert Wilders (PVV)",0.959497922743746,0.78222433460076,0
"<anonymized_userid>",1,54275,8230,"Geert Wilders (PVV)",0.959515601520375,0.782319391634981,0
"<anonymized_userid>",1,54276,8231,"Geert Wilders (PVV)",0.959533280297003,0.782414448669202,0
"<anonymized_userid>",1,54277,8232,"Geert Wilders (PVV)",0.959550959073632,0.782509505703422,0
"<anonymized_userid>",1,54278,8233,"Geert Wilders (PVV)",0.959568637850261,0.782604562737643,0
"<anonymized_userid>",1,54279,8234,"Geert Wilders (PVV)",0.959586316626889,0.782699619771863,0
"<anonymized_userid>",1,54280,8235,"Geert Wilders (PVV)",0.959603995403518,0.782794676806084,0
"<anonymized_userid>",1,54281,8236,"Geert Wilders (PVV)",0.959621674180147,0.782889733840304,0
"<anonymized_userid>",1,54282,8237,"Geert Wilders (PVV)",0.959639352956775,0.782984790874525,0
"<anonymized_userid>",1,54283,8238,"Geert Wilders (PVV)",0.959657031733404,0.783079847908745,0
"<anonymized_userid>",1,54284,8239,"Geert Wilders (PVV)",0.959674710510033,0.783174904942966,0
"<anonymized_userid>",1,54285,8240,"Geert Wilders (PVV)",0.959692389286661,0.783269961977186,0
"<anonymized_userid>",1,54286,8241,"Geert Wilders (PVV)",0.95971006806329,0.783365019011407,0
"<anonymized_userid>",1,54287,8242,"Geert Wilders (PVV)",0.959727746839919,0.783460076045627,0
"<anonymized_userid>",1,54288,8243,"Geert Wilders (PVV)",0.959745425616547,0.783555133079848,0
"<anonymized_userid>",1,54289,8244,"Geert Wilders (PVV)",0.959763104393176,0.783650190114068,0
"<anonymized_userid>",1,54290,8245,"Geert Wilders (PVV)",0.959780783169805,0.783745247148289,0
"<anonymized_userid>",1,54291,8246,"Geert Wilders (PVV)",0.959798461946433,0.783840304182509,0
"<anonymized_userid>",1,54292,8247,"Geert Wilders (PVV)",0.959816140723062,0.78393536121673,0
"<anonymized_userid>",1,54293,8248,"Geert Wilders (PVV)",0.959833819499691,0.784030418250951,0
"<anonymized_userid>",1,54294,8249,"Geert Wilders (PVV)",0.959851498276319,0.784125475285171,0
"<anonymized_userid>",1,54295,8250,"Geert Wilders (PVV)",0.959869177052948,0.784220532319392,0
"<anonymized_userid>",1,54296,8251,"Geert Wilders (PVV)",0.959886855829577,0.784315589353612,0
"<anonymized_userid>",1,54297,8252,"Geert Wilders (PVV)",0.959904534606205,0.784410646387833,0
"<anonymized_userid>",1,54298,8253,"Geert Wilders (PVV)",0.959922213382834,0.784505703422053,0
"<anonymized_userid>",1,54299,8254,"Geert Wilders (PVV)",0.959939892159463,0.784600760456274,0
"<anonymized_userid>",1,54300,8255,"Geert Wilders (PVV)",0.959957570936091,0.784695817490494,0
"<anonymized_userid>",1,54301,8256,"Geert Wilders (PVV)",0.95997524971272,0.784790874524715,0
"<anonymized_userid>",1,54302,8257,"Geert Wilders (PVV)",0.959992928489349,0.784885931558935,0
"<anonymized_userid>",1,54303,8258,"Geert Wilders (PVV)",0.960010607265977,0.784980988593156,0
"<anonymized_userid>",1,54304,8259,"Geert Wilders (PVV)",0.960028286042606,0.785076045627376,0
"<anonymized_userid>",1,54305,8260,"Geert Wilders (PVV)",0.960045964819235,0.785171102661597,0
"<anonymized_userid>",1,54306,8261,"Geert Wilders (PVV)",0.960063643595863,0.785266159695817,0
"<anonymized_userid>",1,54307,8262,"Geert Wilders (PVV)",0.960081322372492,0.785361216730038,0
"<anonymized_userid>",1,54308,8263,"Geert Wilders (PVV)",0.960099001149121,0.785456273764259,0
"<anonymized_userid>",1,54309,8264,"Geert Wilders (PVV)",0.960116679925749,0.785551330798479,0
"<anonymized_userid>",1,54310,8265,"Geert Wilders (PVV)",0.960134358702378,0.7856463878327,0
"<anonymized_userid>",1,54311,8266,"Geert Wilders (PVV)",0.960152037479006,0.78574144486692,0
"<anonymized_userid>",1,54312,8267,"Geert Wilders (PVV)",0.960169716255635,0.785836501901141,0
"<anonymized_userid>",1,54313,8268,"Geert Wilders (PVV)",0.960187395032264,0.785931558935361,0
"<anonymized_userid>",1,54314,8269,"Geert Wilders (PVV)",0.960205073808892,0.786026615969582,0
"<anonymized_userid>",1,54315,8270,"Geert Wilders (PVV)",0.960222752585521,0.786121673003802,0
"<anonymized_userid>",1,54316,8271,"Geert Wilders (PVV)",0.96024043136215,0.786216730038023,0
"<anonymized_userid>",1,54317,8272,"Geert Wilders (PVV)",0.960258110138778,0.786311787072243,0
"<anonymized_userid>",1,54318,8273,"Geert Wilders (PVV)",0.960275788915407,0.786406844106464,0
"<anonymized_userid>",1,54319,8274,"Geert Wilders (PVV)",0.960293467692036,0.786501901140684,0
"<anonymized_userid>",1,54320,8275,"Geert Wilders (PVV)",0.960311146468664,0.786596958174905,0
"<anonymized_userid>",1,54321,8276,"Geert Wilders (PVV)",0.960328825245293,0.786692015209125,0
"<anonymized_userid>",1,54322,8277,"Geert Wilders (PVV)",0.960346504021922,0.786787072243346,0
"<anonymized_userid>",1,54323,8278,"Geert Wilders (PVV)",0.96036418279855,0.786882129277567,0
"<anonymized_userid>",1,54324,8279,"Geert Wilders (PVV)",0.960381861575179,0.786977186311787,0
"<anonymized_userid>",1,54325,8280,"Geert Wilders (PVV)",0.960399540351808,0.787072243346008,0
"<anonymized_userid>",1,54326,8281,"Geert Wilders (PVV)",0.960417219128436,0.787167300380228,0
"<anonymized_userid>",1,54327,8282,"Geert Wilders (PVV)",0.960434897905065,0.787262357414449,0
"<anonymized_userid>",1,54328,8283,"Geert Wilders (PVV)",0.960452576681694,0.787357414448669,0
"<anonymized_userid>",1,54329,8284,"Geert Wilders (PVV)",0.960470255458322,0.78745247148289,0
"<anonymized_userid>",1,54330,8285,"Geert Wilders (PVV)",0.960487934234951,0.78754752851711,0
"<anonymized_userid>",1,54331,8286,"Geert Wilders (PVV)",0.96050561301158,0.787642585551331,0
"<anonymized_userid>",1,54332,8287,"Geert Wilders (PVV)",0.960523291788208,0.787737642585551,0
"<anonymized_userid>",1,54333,8288,"Geert Wilders (PVV)",0.960540970564837,0.787832699619772,0
"<anonymized_userid>",1,54334,8289,"Geert Wilders (PVV)",0.960558649341466,0.787927756653992,0
"<anonymized_userid>",1,54335,8290,"Geert Wilders (PVV)",0.960576328118094,0.788022813688213,0
"<anonymized_userid>",1,54336,8291,"Geert Wilders (PVV)",0.960594006894723,0.788117870722433,0
"<anonymized_userid>",1,54337,8292,"Geert Wilders (PVV)",0.960611685671352,0.788212927756654,0
"<anonymized_userid>",1,54338,8293,"Geert Wilders (PVV)",0.96062936444798,0.788307984790874,0
"<anonymized_userid>",1,54339,8294,"Geert Wilders (PVV)",0.960647043224609,0.788403041825095,0
"<anonymized_userid>",1,54340,8295,"Geert Wilders (PVV)",0.960664722001238,0.788498098859316,0
"<anonymized_userid>",1,54341,8296,"Geert Wilders (PVV)",0.960682400777866,0.788593155893536,0
"<anonymized_userid>",1,54342,8297,"Geert Wilders (PVV)",0.960700079554495,0.788688212927757,0
"<anonymized_userid>",1,54343,8298,"Geert Wilders (PVV)",0.960717758331123,0.788783269961977,0
"<anonymized_userid>",1,54344,8299,"Geert Wilders (PVV)",0.960735437107752,0.788878326996198,0
"<anonymized_userid>",1,54345,8300,"Geert Wilders (PVV)",0.960753115884381,0.788973384030418,0
"<anonymized_userid>",1,54346,8301,"Geert Wilders (PVV)",0.960770794661009,0.789068441064639,0
"<anonymized_userid>",1,54347,8302,"Geert Wilders (PVV)",0.960788473437638,0.789163498098859,0
"<anonymized_userid>",1,54348,8303,"Geert Wilders (PVV)",0.960806152214267,0.78925855513308,0
"<anonymized_userid>",1,54349,8304,"Geert Wilders (PVV)",0.960823830990895,0.7893536121673,0
"<anonymized_userid>",1,54350,8305,"Geert Wilders (PVV)",0.960841509767524,0.789448669201521,0
"<anonymized_userid>",1,54351,8306,"Geert Wilders (PVV)",0.960859188544153,0.789543726235741,0
"<anonymized_userid>",1,54352,8307,"Geert Wilders (PVV)",0.960876867320781,0.789638783269962,0
"<anonymized_userid>",1,54353,8308,"Geert Wilders (PVV)",0.96089454609741,0.789733840304182,0
"<anonymized_userid>",1,54354,8309,"Geert Wilders (PVV)",0.960912224874039,0.789828897338403,0
"<anonymized_userid>",1,54355,8310,"Geert Wilders (PVV)",0.960929903650667,0.789923954372624,0
"<anonymized_userid>",1,54356,8311,"Geert Wilders (PVV)",0.960947582427296,0.790019011406844,0
"<anonymized_userid>",1,54357,8312,"Geert Wilders (PVV)",0.960965261203925,0.790114068441065,0
"<anonymized_userid>",1,54358,8313,"Geert Wilders (PVV)",0.960982939980553,0.790209125475285,0
"<anonymized_userid>",1,54359,8314,"Geert Wilders (PVV)",0.961000618757182,0.790304182509506,0
"<anonymized_userid>",1,54360,8315,"Geert Wilders (PVV)",0.961018297533811,0.790399239543726,0
"<anonymized_userid>",1,54361,8316,"Geert Wilders (PVV)",0.961035976310439,0.790494296577947,0
"<anonymized_userid>",1,54362,8317,"Geert Wilders (PVV)",0.961053655087068,0.790589353612167,0
"<anonymized_userid>",1,54363,8318,"Geert Wilders (PVV)",0.961071333863697,0.790684410646388,0
"<anonymized_userid>",1,54364,8319,"Geert Wilders (PVV)",0.961089012640325,0.790779467680608,0
"<anonymized_userid>",1,54365,8320,"Geert Wilders (PVV)",0.961106691416954,0.790874524714829,0
"<anonymized_userid>",1,54366,8321,"Geert Wilders (PVV)",0.961124370193583,0.790969581749049,0
"<anonymized_userid>",1,54367,8322,"Geert Wilders (PVV)",0.961142048970211,0.79106463878327,0
"<anonymized_userid>",1,54368,8323,"Geert Wilders (PVV)",0.96115972774684,0.79115969581749,0
"<anonymized_userid>",1,54369,8324,"Geert Wilders (PVV)",0.961177406523469,0.791254752851711,0
"<anonymized_userid>",1,54370,8325,"Geert Wilders (PVV)",0.961195085300097,0.791349809885932,0
"<anonymized_userid>",1,54371,8326,"Geert Wilders (PVV)",0.961212764076726,0.791444866920152,0
"<anonymized_userid>",1,54372,8327,"Geert Wilders (PVV)",0.961230442853355,0.791539923954373,0
"<anonymized_userid>",1,54373,8328,"Geert Wilders (PVV)",0.961248121629983,0.791634980988593,0
"<anonymized_userid>",1,54374,8329,"Geert Wilders (PVV)",0.961265800406612,0.791730038022814,0
"<anonymized_userid>",1,54375,8330,"Geert Wilders (PVV)",0.961283479183241,0.791825095057034,0
"<anonymized_userid>",1,54376,8331,"Geert Wilders (PVV)",0.961301157959869,0.791920152091255,0
"<anonymized_userid>",1,54377,8332,"Geert Wilders (PVV)",0.961318836736498,0.792015209125475,0
"<anonymized_userid>",1,54378,8333,"Geert Wilders (PVV)",0.961336515513126,0.792110266159696,0
"<anonymized_userid>",1,54379,8334,"Geert Wilders (PVV)",0.961354194289755,0.792205323193916,0
"<anonymized_userid>",1,54380,8335,"Geert Wilders (PVV)",0.961371873066384,0.792300380228137,0
"<anonymized_userid>",1,54381,8336,"Geert Wilders (PVV)",0.961389551843012,0.792395437262357,0
"<anonymized_userid>",1,54382,8337,"Geert Wilders (PVV)",0.961407230619641,0.792490494296578,0
"<anonymized_userid>",1,54383,8338,"Geert Wilders (PVV)",0.96142490939627,0.792585551330798,0
"<anonymized_userid>",1,54384,8339,"Geert Wilders (PVV)",0.961442588172898,0.792680608365019,0
"<anonymized_userid>",1,54385,8340,"Geert Wilders (PVV)",0.961460266949527,0.792775665399239,0
"<anonymized_userid>",1,54386,8341,"Geert Wilders (PVV)",0.961477945726156,0.79287072243346,0
"<anonymized_userid>",1,54387,8342,"Geert Wilders (PVV)",0.961495624502784,0.792965779467681,0
"<anonymized_userid>",1,54388,8343,"Geert Wilders (PVV)",0.961513303279413,0.793060836501901,0
"<anonymized_userid>",1,54389,8344,"Geert Wilders (PVV)",0.961530982056042,0.793155893536122,0
"<anonymized_userid>",1,54390,8345,"Geert Wilders (PVV)",0.96154866083267,0.793250950570342,0
"<anonymized_userid>",1,54391,8346,"Geert Wilders (PVV)",0.961566339609299,0.793346007604563,0
"<anonymized_userid>",1,54392,8347,"Geert Wilders (PVV)",0.961584018385928,0.793441064638783,0
"<anonymized_userid>",1,54393,8348,"Geert Wilders (PVV)",0.961601697162556,0.793536121673004,0
"<anonymized_userid>",1,54394,8349,"Geert Wilders (PVV)",0.961619375939185,0.793631178707224,0
"<anonymized_userid>",1,54395,8350,"Geert Wilders (PVV)",0.961637054715814,0.793726235741445,0
"<anonymized_userid>",1,54396,8351,"Geert Wilders (PVV)",0.961654733492442,0.793821292775665,0
"<anonymized_userid>",1,54397,8352,"Geert Wilders (PVV)",0.961672412269071,0.793916349809886,0
"<anonymized_userid>",1,54398,8353,"Geert Wilders (PVV)",0.9616900910457,0.794011406844106,0
"<anonymized_userid>",1,54399,8354,"Geert Wilders (PVV)",0.961707769822328,0.794106463878327,0
"<anonymized_userid>",1,54400,8355,"Geert Wilders (PVV)",0.961725448598957,0.794201520912547,0
"<anonymized_userid>",1,54401,8356,"Geert Wilders (PVV)",0.961743127375586,0.794296577946768,0
"<anonymized_userid>",1,54402,8357,"Geert Wilders (PVV)",0.961760806152214,0.794391634980989,0
"<anonymized_userid>",1,54403,8358,"Geert Wilders (PVV)",0.961778484928843,0.794486692015209,0
"<anonymized_userid>",1,54404,8359,"Geert Wilders (PVV)",0.961796163705472,0.79458174904943,0
"<anonymized_userid>",1,54405,8360,"Geert Wilders (PVV)",0.9618138424821,0.79467680608365,0
"<anonymized_userid>",1,54406,8361,"Geert Wilders (PVV)",0.961831521258729,0.794771863117871,0
"<anonymized_userid>",1,54407,8362,"Geert Wilders (PVV)",0.961849200035358,0.794866920152091,0
"<anonymized_userid>",1,54408,8363,"Geert Wilders (PVV)",0.961866878811986,0.794961977186312,0
"<anonymized_userid>",1,54409,8364,"Geert Wilders (PVV)",0.961884557588615,0.795057034220532,0
"<anonymized_userid>",1,54410,8365,"Geert Wilders (PVV)",0.961902236365244,0.795152091254753,0
"<anonymized_userid>",1,54411,8366,"Geert Wilders (PVV)",0.961919915141872,0.795247148288973,0
"<anonymized_userid>",1,54412,8367,"Geert Wilders (PVV)",0.961937593918501,0.795342205323194,0
"<anonymized_userid>",1,54413,8368,"Geert Wilders (PVV)",0.961955272695129,0.795437262357414,0
"<anonymized_userid>",1,54414,8369,"Geert Wilders (PVV)",0.961972951471758,0.795532319391635,0
"<anonymized_userid>",1,54415,8370,"Geert Wilders (PVV)",0.961990630248387,0.795627376425855,0
"<anonymized_userid>",1,54416,8371,"Geert Wilders (PVV)",0.962008309025015,0.795722433460076,0
"<anonymized_userid>",1,54417,8372,"Geert Wilders (PVV)",0.962025987801644,0.795817490494297,0
"<anonymized_userid>",1,54418,8373,"Geert Wilders (PVV)",0.962043666578273,0.795912547528517,0
"<anonymized_userid>",1,54419,8374,"Geert Wilders (PVV)",0.962061345354901,0.796007604562738,0
"<anonymized_userid>",1,54420,8375,"Geert Wilders (PVV)",0.96207902413153,0.796102661596958,0
"<anonymized_userid>",1,54421,8376,"Geert Wilders (PVV)",0.962096702908159,0.796197718631179,0
"<anonymized_userid>",1,54422,8377,"Geert Wilders (PVV)",0.962114381684787,0.796292775665399,0
"<anonymized_userid>",1,54423,8378,"Geert Wilders (PVV)",0.962132060461416,0.79638783269962,0
"<anonymized_userid>",1,54424,8379,"Geert Wilders (PVV)",0.962149739238045,0.79648288973384,0
"<anonymized_userid>",1,54425,8380,"Geert Wilders (PVV)",0.962167418014673,0.796577946768061,0
"<anonymized_userid>",1,54426,8381,"Geert Wilders (PVV)",0.962185096791302,0.796673003802281,0
"<anonymized_userid>",1,54427,8382,"Geert Wilders (PVV)",0.962202775567931,0.796768060836502,0
"<anonymized_userid>",1,54428,8383,"Geert Wilders (PVV)",0.962220454344559,0.796863117870722,0
"<anonymized_userid>",1,54429,8384,"Geert Wilders (PVV)",0.962238133121188,0.796958174904943,0
"<anonymized_userid>",1,54430,8385,"Geert Wilders (PVV)",0.962255811897817,0.797053231939164,0
"<anonymized_userid>",1,54431,8386,"Geert Wilders (PVV)",0.962273490674445,0.797148288973384,0
"<anonymized_userid>",1,54432,8387,"Geert Wilders (PVV)",0.962291169451074,0.797243346007605,0
"<anonymized_userid>",1,54433,8388,"Geert Wilders (PVV)",0.962308848227703,0.797338403041825,0
"<anonymized_userid>",1,54434,8389,"Geert Wilders (PVV)",0.962326527004331,0.797433460076046,0
"<anonymized_userid>",1,54435,8390,"Geert Wilders (PVV)",0.96234420578096,0.797528517110266,0
"<anonymized_userid>",1,54436,8391,"Geert Wilders (PVV)",0.962361884557589,0.797623574144487,0
"<anonymized_userid>",1,54437,8392,"Geert Wilders (PVV)",0.962379563334217,0.797718631178707,0
"<anonymized_userid>",1,54438,8393,"Geert Wilders (PVV)",0.962397242110846,0.797813688212928,0
"<anonymized_userid>",1,54439,8394,"Geert Wilders (PVV)",0.962414920887475,0.797908745247148,0
"<anonymized_userid>",1,54440,8395,"Geert Wilders (PVV)",0.962432599664103,0.798003802281369,0
"<anonymized_userid>",1,54441,8396,"Geert Wilders (PVV)",0.962450278440732,0.798098859315589,0
"<anonymized_userid>",1,54442,8397,"Geert Wilders (PVV)",0.962467957217361,0.79819391634981,0
"<anonymized_userid>",1,54443,8398,"Geert Wilders (PVV)",0.962485635993989,0.79828897338403,0
"<anonymized_userid>",1,54444,8399,"Geert Wilders (PVV)",0.962503314770618,0.798384030418251,0
"<anonymized_userid>",1,54445,8400,"Geert Wilders (PVV)",0.962520993547247,0.798479087452472,0
"<anonymized_userid>",1,54446,8401,"Geert Wilders (PVV)",0.962538672323875,0.798574144486692,0
"<anonymized_userid>",1,54447,8402,"Geert Wilders (PVV)",0.962556351100504,0.798669201520913,0
"<anonymized_userid>",1,54448,8403,"Geert Wilders (PVV)",0.962574029877132,0.798764258555133,0
"<anonymized_userid>",1,54449,8404,"Geert Wilders (PVV)",0.962591708653761,0.798859315589354,0
"<anonymized_userid>",1,54450,8405,"Geert Wilders (PVV)",0.96260938743039,0.798954372623574,0
"<anonymized_userid>",1,54451,8406,"Geert Wilders (PVV)",0.962627066207018,0.799049429657795,0
"<anonymized_userid>",1,54452,8407,"Geert Wilders (PVV)",0.962644744983647,0.799144486692015,0
"<anonymized_userid>",1,54453,8408,"Geert Wilders (PVV)",0.962662423760276,0.799239543726236,0
"<anonymized_userid>",1,54454,8409,"Geert Wilders (PVV)",0.962680102536904,0.799334600760456,0
"<anonymized_userid>",1,54455,8410,"Geert Wilders (PVV)",0.962697781313533,0.799429657794677,0
"<anonymized_userid>",1,54456,8411,"Geert Wilders (PVV)",0.962715460090162,0.799524714828897,0
"<anonymized_userid>",1,54457,8412,"Geert Wilders (PVV)",0.96273313886679,0.799619771863118,0
"<anonymized_userid>",1,54458,8413,"Geert Wilders (PVV)",0.962750817643419,0.799714828897338,0
"<anonymized_userid>",1,54459,8414,"Geert Wilders (PVV)",0.962768496420048,0.799809885931559,0
"<anonymized_userid>",1,54460,8415,"Geert Wilders (PVV)",0.962786175196676,0.79990494296578,0
"<anonymized_userid>",1,54461,8416,"Geert Wilders (PVV)",0.962803853973305,0.8,0
"<anonymized_userid>",1,54462,8417,"Geert Wilders (PVV)",0.962821532749934,0.800095057034221,0
"<anonymized_userid>",1,54463,8418,"Geert Wilders (PVV)",0.962839211526562,0.800190114068441,0
"<anonymized_userid>",1,54464,8419,"Geert Wilders (PVV)",0.962856890303191,0.800285171102662,0
"<anonymized_userid>",1,54465,8420,"Geert Wilders (PVV)",0.96287456907982,0.800380228136882,0
"<anonymized_userid>",1,54466,8421,"Geert Wilders (PVV)",0.962892247856448,0.800475285171103,0
"<anonymized_userid>",1,54467,8422,"Geert Wilders (PVV)",0.962909926633077,0.800570342205323,0
"<anonymized_userid>",1,54468,8423,"Geert Wilders (PVV)",0.962927605409706,0.800665399239544,0
"<anonymized_userid>",1,54469,8424,"Geert Wilders (PVV)",0.962945284186334,0.800760456273764,0
"<anonymized_userid>",1,54470,8425,"Geert Wilders (PVV)",0.962962962962963,0.800855513307985,0
"<anonymized_userid>",1,54471,8426,"Geert Wilders (PVV)",0.962980641739592,0.800950570342205,0
"<anonymized_userid>",1,54472,8427,"Geert Wilders (PVV)",0.96299832051622,0.801045627376426,0
"<anonymized_userid>",1,54473,8428,"Geert Wilders (PVV)",0.963015999292849,0.801140684410646,0
"<anonymized_userid>",1,54474,8429,"Geert Wilders (PVV)",0.963033678069478,0.801235741444867,0
"<anonymized_userid>",1,54475,8430,"Geert Wilders (PVV)",0.963051356846106,0.801330798479088,0
"<anonymized_userid>",1,54476,8431,"Geert Wilders (PVV)",0.963069035622735,0.801425855513308,0
"<anonymized_userid>",1,54477,8432,"Geert Wilders (PVV)",0.963086714399364,0.801520912547529,0
"<anonymized_userid>",1,54478,8433,"Geert Wilders (PVV)",0.963104393175992,0.801615969581749,0
"<anonymized_userid>",1,54479,8434,"Geert Wilders (PVV)",0.963122071952621,0.80171102661597,0
"<anonymized_userid>",1,54480,8435,"Geert Wilders (PVV)",0.96313975072925,0.80180608365019,0
"<anonymized_userid>",1,54481,8436,"Geert Wilders (PVV)",0.963157429505878,0.801901140684411,0
"<anonymized_userid>",1,54482,8437,"Geert Wilders (PVV)",0.963175108282507,0.801996197718631,0
"<anonymized_userid>",1,54483,8438,"Geert Wilders (PVV)",0.963192787059135,0.802091254752852,0
"<anonymized_userid>",1,54484,8439,"Geert Wilders (PVV)",0.963210465835764,0.802186311787072,0
"<anonymized_userid>",1,54485,8440,"Geert Wilders (PVV)",0.963228144612393,0.802281368821293,0
"<anonymized_userid>",1,54486,8441,"Geert Wilders (PVV)",0.963245823389021,0.802376425855513,0
"<anonymized_userid>",1,54487,8442,"Geert Wilders (PVV)",0.96326350216565,0.802471482889734,0
"<anonymized_userid>",1,54488,8443,"Geert Wilders (PVV)",0.963281180942279,0.802566539923954,0
"<anonymized_userid>",1,54489,8444,"Geert Wilders (PVV)",0.963298859718907,0.802661596958175,0
"<anonymized_userid>",1,54490,8445,"Geert Wilders (PVV)",0.963316538495536,0.802756653992395,0
"<anonymized_userid>",1,54491,8446,"Geert Wilders (PVV)",0.963334217272165,0.802851711026616,0
"<anonymized_userid>",1,54492,8447,"Geert Wilders (PVV)",0.963351896048793,0.802946768060837,0
"<anonymized_userid>",1,54493,8448,"Geert Wilders (PVV)",0.963369574825422,0.803041825095057,0
"<anonymized_userid>",1,54494,8449,"Geert Wilders (PVV)",0.963387253602051,0.803136882129278,0
"<anonymized_userid>",1,54495,8450,"Geert Wilders (PVV)",0.963404932378679,0.803231939163498,0
"<anonymized_userid>",1,54496,8451,"Geert Wilders (PVV)",0.963422611155308,0.803326996197719,0
"<anonymized_userid>",1,54497,8452,"Geert Wilders (PVV)",0.963440289931937,0.803422053231939,0
"<anonymized_userid>",1,54498,8453,"Geert Wilders (PVV)",0.963457968708565,0.80351711026616,0
"<anonymized_userid>",1,54499,8454,"Geert Wilders (PVV)",0.963475647485194,0.80361216730038,0
"<anonymized_userid>",1,54500,8455,"Geert Wilders (PVV)",0.963493326261823,0.803707224334601,0
"<anonymized_userid>",1,54501,8456,"Geert Wilders (PVV)",0.963511005038451,0.803802281368821,0
"<anonymized_userid>",1,54502,8457,"Geert Wilders (PVV)",0.96352868381508,0.803897338403042,0
"<anonymized_userid>",1,54503,8458,"Geert Wilders (PVV)",0.963546362591709,0.803992395437262,0
"<anonymized_userid>",1,54504,8459,"Geert Wilders (PVV)",0.963564041368337,0.804087452471483,0
"<anonymized_userid>",1,54505,8460,"Geert Wilders (PVV)",0.963581720144966,0.804182509505703,0
"<anonymized_userid>",1,54506,8461,"Geert Wilders (PVV)",0.963599398921595,0.804277566539924,0
"<anonymized_userid>",1,54507,8462,"Geert Wilders (PVV)",0.963617077698223,0.804372623574145,0
"<anonymized_userid>",1,54508,8463,"Geert Wilders (PVV)",0.963634756474852,0.804467680608365,0
"<anonymized_userid>",1,54509,8464,"Geert Wilders (PVV)",0.963652435251481,0.804562737642586,0
"<anonymized_userid>",1,54510,8465,"Geert Wilders (PVV)",0.963670114028109,0.804657794676806,0
"<anonymized_userid>",1,54511,8466,"Geert Wilders (PVV)",0.963687792804738,0.804752851711027,0
"<anonymized_userid>",1,54512,8467,"Geert Wilders (PVV)",0.963705471581367,0.804847908745247,0
"<anonymized_userid>",1,54513,8468,"Geert Wilders (PVV)",0.963723150357995,0.804942965779468,0
"<anonymized_userid>",1,54514,8469,"Geert Wilders (PVV)",0.963740829134624,0.805038022813688,0
"<anonymized_userid>",1,54515,8470,"Geert Wilders (PVV)",0.963758507911253,0.805133079847909,0
"<anonymized_userid>",1,54516,8471,"Geert Wilders (PVV)",0.963776186687881,0.805228136882129,0
"<anonymized_userid>",1,54517,8472,"Geert Wilders (PVV)",0.96379386546451,0.80532319391635,0
"<anonymized_userid>",1,54518,8473,"Geert Wilders (PVV)",0.963811544241138,0.80541825095057,0
"<anonymized_userid>",1,54519,8474,"Geert Wilders (PVV)",0.963829223017767,0.805513307984791,0
"<anonymized_userid>",1,54520,8475,"Geert Wilders (PVV)",0.963846901794396,0.805608365019011,0
"<anonymized_userid>",1,54521,8476,"Geert Wilders (PVV)",0.963864580571025,0.805703422053232,0
"<anonymized_userid>",1,54522,8477,"Geert Wilders (PVV)",0.963882259347653,0.805798479087453,0
"<anonymized_userid>",1,54523,8478,"Geert Wilders (PVV)",0.963899938124282,0.805893536121673,0
"<anonymized_userid>",1,54524,8479,"Geert Wilders (PVV)",0.96391761690091,0.805988593155894,0
"<anonymized_userid>",1,54525,8480,"Geert Wilders (PVV)",0.963935295677539,0.806083650190114,0
"<anonymized_userid>",1,54526,8481,"Geert Wilders (PVV)",0.963952974454168,0.806178707224335,0
"<anonymized_userid>",1,54527,8482,"Geert Wilders (PVV)",0.963970653230796,0.806273764258555,0
"<anonymized_userid>",1,54528,8483,"Geert Wilders (PVV)",0.963988332007425,0.806368821292776,0
"<anonymized_userid>",1,54529,8484,"Geert Wilders (PVV)",0.964006010784054,0.806463878326996,0
"<anonymized_userid>",1,54530,8485,"Geert Wilders (PVV)",0.964023689560682,0.806558935361217,0
"<anonymized_userid>",1,54531,8486,"Geert Wilders (PVV)",0.964041368337311,0.806653992395437,0
"<anonymized_userid>",1,54532,8487,"Geert Wilders (PVV)",0.96405904711394,0.806749049429658,0
"<anonymized_userid>",1,54533,8488,"Geert Wilders (PVV)",0.964076725890568,0.806844106463878,0
"<anonymized_userid>",1,54534,8489,"Geert Wilders (PVV)",0.964094404667197,0.806939163498099,0
"<anonymized_userid>",1,54535,8490,"Geert Wilders (PVV)",0.964112083443826,0.807034220532319,0
"<anonymized_userid>",1,54536,8491,"Geert Wilders (PVV)",0.964129762220454,0.80712927756654,0
"<anonymized_userid>",1,54537,8492,"Geert Wilders (PVV)",0.964147440997083,0.80722433460076,0
"<anonymized_userid>",1,54538,8493,"Geert Wilders (PVV)",0.964165119773712,0.807319391634981,0
"<anonymized_userid>",1,54539,8494,"Geert Wilders (PVV)",0.96418279855034,0.807414448669202,0
"<anonymized_userid>",1,54540,8495,"Geert Wilders (PVV)",0.964200477326969,0.807509505703422,0
"<anonymized_userid>",1,54541,8496,"Geert Wilders (PVV)",0.964218156103598,0.807604562737643,0
"<anonymized_userid>",1,54542,8497,"Geert Wilders (PVV)",0.964235834880226,0.807699619771863,0
"<anonymized_userid>",1,54543,8498,"Geert Wilders (PVV)",0.964253513656855,0.807794676806084,0
"<anonymized_userid>",1,54544,8499,"Geert Wilders (PVV)",0.964271192433484,0.807889733840304,0
"<anonymized_userid>",1,54545,8500,"Geert Wilders (PVV)",0.964288871210112,0.807984790874525,0
"<anonymized_userid>",1,54546,8501,"Geert Wilders (PVV)",0.964306549986741,0.808079847908745,0
"<anonymized_userid>",1,54547,8502,"Geert Wilders (PVV)",0.96432422876337,0.808174904942966,0
"<anonymized_userid>",1,54548,8503,"Geert Wilders (PVV)",0.964341907539998,0.808269961977186,0
"<anonymized_userid>",1,54549,8504,"Geert Wilders (PVV)",0.964359586316627,0.808365019011407,0
"<anonymized_userid>",1,54550,8505,"Geert Wilders (PVV)",0.964377265093255,0.808460076045627,0
"<anonymized_userid>",1,54551,8506,"Geert Wilders (PVV)",0.964394943869884,0.808555133079848,0
"<anonymized_userid>",1,54552,8507,"Geert Wilders (PVV)",0.964412622646513,0.808650190114068,0
"<anonymized_userid>",1,54553,8508,"Geert Wilders (PVV)",0.964430301423142,0.808745247148289,0
"<anonymized_userid>",1,54554,8509,"Geert Wilders (PVV)",0.96444798019977,0.80884030418251,0
"<anonymized_userid>",1,54555,8510,"Geert Wilders (PVV)",0.964465658976399,0.80893536121673,0
"<anonymized_userid>",1,54556,8511,"Geert Wilders (PVV)",0.964483337753028,0.809030418250951,0
"<anonymized_userid>",1,54557,8512,"Geert Wilders (PVV)",0.964501016529656,0.809125475285171,0
"<anonymized_userid>",1,54558,8513,"Geert Wilders (PVV)",0.964518695306285,0.809220532319392,0
"<anonymized_userid>",1,54559,8514,"Geert Wilders (PVV)",0.964536374082913,0.809315589353612,0
"<anonymized_userid>",1,54560,8515,"Geert Wilders (PVV)",0.964554052859542,0.809410646387833,0
"<anonymized_userid>",1,54561,8516,"Geert Wilders (PVV)",0.964571731636171,0.809505703422053,0
"<anonymized_userid>",1,54562,8517,"Geert Wilders (PVV)",0.964589410412799,0.809600760456274,0
"<anonymized_userid>",1,54563,8518,"Geert Wilders (PVV)",0.964607089189428,0.809695817490494,0
"<anonymized_userid>",1,54564,8519,"Geert Wilders (PVV)",0.964624767966057,0.809790874524715,0
"<anonymized_userid>",1,54565,8520,"Geert Wilders (PVV)",0.964642446742685,0.809885931558935,0
"<anonymized_userid>",1,54566,8521,"Geert Wilders (PVV)",0.964660125519314,0.809980988593156,0
"<anonymized_userid>",1,54567,8522,"Geert Wilders (PVV)",0.964677804295943,0.810076045627376,0
"<anonymized_userid>",1,54568,8523,"Geert Wilders (PVV)",0.964695483072571,0.810171102661597,0
"<anonymized_userid>",1,54569,8524,"Geert Wilders (PVV)",0.9647131618492,0.810266159695818,0
"<anonymized_userid>",1,54570,8525,"Geert Wilders (PVV)",0.964730840625829,0.810361216730038,0
"<anonymized_userid>",1,54571,8526,"Geert Wilders (PVV)",0.964748519402457,0.810456273764259,0
"<anonymized_userid>",1,54572,8527,"Geert Wilders (PVV)",0.964766198179086,0.810551330798479,0
"<anonymized_userid>",1,54573,8528,"Geert Wilders (PVV)",0.964783876955715,0.8106463878327,0
"<anonymized_userid>",1,54574,8529,"Geert Wilders (PVV)",0.964801555732343,0.81074144486692,0
"<anonymized_userid>",1,54575,8530,"Geert Wilders (PVV)",0.964819234508972,0.810836501901141,0
"<anonymized_userid>",1,54576,8531,"Geert Wilders (PVV)",0.964836913285601,0.810931558935361,0
"<anonymized_userid>",1,54577,8532,"Geert Wilders (PVV)",0.964854592062229,0.811026615969582,0
"<anonymized_userid>",1,54578,8533,"Geert Wilders (PVV)",0.964872270838858,0.811121673003802,0
"<anonymized_userid>",1,54579,8534,"Geert Wilders (PVV)",0.964889949615487,0.811216730038023,0
"<anonymized_userid>",1,54580,8535,"Geert Wilders (PVV)",0.964907628392115,0.811311787072243,0
"<anonymized_userid>",1,54581,8536,"Geert Wilders (PVV)",0.964925307168744,0.811406844106464,0
"<anonymized_userid>",1,54582,8537,"Geert Wilders (PVV)",0.964942985945373,0.811501901140684,0
"<anonymized_userid>",1,54583,8538,"Geert Wilders (PVV)",0.964960664722001,0.811596958174905,0
"<anonymized_userid>",1,54584,8539,"Geert Wilders (PVV)",0.96497834349863,0.811692015209125,0
"<anonymized_userid>",1,54585,8540,"Geert Wilders (PVV)",0.964996022275259,0.811787072243346,0
"<anonymized_userid>",1,54586,8541,"Geert Wilders (PVV)",0.965013701051887,0.811882129277567,0
"<anonymized_userid>",1,54587,8542,"Geert Wilders (PVV)",0.965031379828516,0.811977186311787,0
"<anonymized_userid>",1,54588,8543,"Geert Wilders (PVV)",0.965049058605145,0.812072243346008,0
"<anonymized_userid>",1,54589,8544,"Geert Wilders (PVV)",0.965066737381773,0.812167300380228,0
"<anonymized_userid>",1,54590,8545,"Geert Wilders (PVV)",0.965084416158402,0.812262357414449,0
"<anonymized_userid>",1,54591,8546,"Geert Wilders (PVV)",0.965102094935031,0.812357414448669,0
"<anonymized_userid>",1,54592,8547,"Geert Wilders (PVV)",0.965119773711659,0.81245247148289,0
"<anonymized_userid>",1,54593,8548,"Geert Wilders (PVV)",0.965137452488288,0.81254752851711,0
"<anonymized_userid>",1,54594,8549,"Geert Wilders (PVV)",0.965155131264916,0.812642585551331,0
"<anonymized_userid>",1,54595,8550,"Geert Wilders (PVV)",0.965172810041545,0.812737642585551,0
"<anonymized_userid>",1,54596,8551,"Geert Wilders (PVV)",0.965190488818174,0.812832699619772,0
"<anonymized_userid>",1,54597,8552,"Geert Wilders (PVV)",0.965208167594802,0.812927756653992,0
"<anonymized_userid>",1,54598,8553,"Geert Wilders (PVV)",0.965225846371431,0.813022813688213,0
"<anonymized_userid>",1,54599,8554,"Geert Wilders (PVV)",0.96524352514806,0.813117870722433,0
"<anonymized_userid>",1,54600,8555,"Geert Wilders (PVV)",0.965261203924688,0.813212927756654,0
"<anonymized_userid>",1,54601,8556,"Geert Wilders (PVV)",0.965278882701317,0.813307984790875,0
"<anonymized_userid>",1,54602,8557,"Geert Wilders (PVV)",0.965296561477946,0.813403041825095,0
"<anonymized_userid>",1,54603,8558,"Geert Wilders (PVV)",0.965314240254574,0.813498098859316,0
"<anonymized_userid>",1,54604,8559,"Geert Wilders (PVV)",0.965331919031203,0.813593155893536,0
"<anonymized_userid>",1,54605,8560,"Geert Wilders (PVV)",0.965349597807832,0.813688212927757,0
"<anonymized_userid>",1,54606,8561,"Geert Wilders (PVV)",0.96536727658446,0.813783269961977,0
"<anonymized_userid>",1,54607,8562,"Geert Wilders (PVV)",0.965384955361089,0.813878326996198,0
"<anonymized_userid>",1,54608,8563,"Geert Wilders (PVV)",0.965402634137718,0.813973384030418,0
"<anonymized_userid>",1,54609,8564,"Geert Wilders (PVV)",0.965420312914346,0.814068441064639,0
"<anonymized_userid>",1,54610,8565,"Geert Wilders (PVV)",0.965437991690975,0.814163498098859,0
"<anonymized_userid>",1,54611,8566,"Geert Wilders (PVV)",0.965455670467604,0.81425855513308,0
"<anonymized_userid>",1,54612,8567,"Geert Wilders (PVV)",0.965473349244232,0.8143536121673,0
"<anonymized_userid>",1,54613,8568,"Geert Wilders (PVV)",0.965491028020861,0.814448669201521,0
"<anonymized_userid>",1,54614,8569,"Geert Wilders (PVV)",0.96550870679749,0.814543726235741,0
"<anonymized_userid>",1,54615,8570,"Geert Wilders (PVV)",0.965526385574118,0.814638783269962,0
"<anonymized_userid>",1,54616,8571,"Geert Wilders (PVV)",0.965544064350747,0.814733840304182,0
"<anonymized_userid>",1,54617,8572,"Geert Wilders (PVV)",0.965561743127376,0.814828897338403,0
"<anonymized_userid>",1,54618,8573,"Geert Wilders (PVV)",0.965579421904004,0.814923954372624,0
"<anonymized_userid>",1,54619,8574,"Geert Wilders (PVV)",0.965597100680633,0.815019011406844,0
"<anonymized_userid>",1,54620,8575,"Geert Wilders (PVV)",0.965614779457262,0.815114068441065,0
"<anonymized_userid>",1,54621,8576,"Geert Wilders (PVV)",0.96563245823389,0.815209125475285,0
"<anonymized_userid>",1,54622,8577,"Geert Wilders (PVV)",0.965650137010519,0.815304182509506,0
"<anonymized_userid>",1,54623,8578,"Geert Wilders (PVV)",0.965667815787148,0.815399239543726,0
"<anonymized_userid>",1,54624,8579,"Geert Wilders (PVV)",0.965685494563776,0.815494296577947,0
"<anonymized_userid>",1,54625,8580,"Geert Wilders (PVV)",0.965703173340405,0.815589353612167,0
"<anonymized_userid>",1,54626,8581,"Geert Wilders (PVV)",0.965720852117034,0.815684410646388,0
"<anonymized_userid>",1,54627,8582,"Geert Wilders (PVV)",0.965738530893662,0.815779467680608,0
"<anonymized_userid>",1,54628,8583,"Geert Wilders (PVV)",0.965756209670291,0.815874524714829,0
"<anonymized_userid>",1,54629,8584,"Geert Wilders (PVV)",0.965773888446919,0.815969581749049,0
"<anonymized_userid>",1,54630,8585,"Geert Wilders (PVV)",0.965791567223548,0.81606463878327,0
"<anonymized_userid>",1,54631,8586,"Geert Wilders (PVV)",0.965809246000177,0.81615969581749,0
"<anonymized_userid>",1,54632,8587,"Geert Wilders (PVV)",0.965826924776805,0.816254752851711,0
"<anonymized_userid>",1,54633,8588,"Geert Wilders (PVV)",0.965844603553434,0.816349809885932,0
"<anonymized_userid>",1,54634,8589,"Geert Wilders (PVV)",0.965862282330063,0.816444866920152,0
"<anonymized_userid>",1,54635,8590,"Geert Wilders (PVV)",0.965879961106691,0.816539923954373,0
"<anonymized_userid>",1,54636,8591,"Geert Wilders (PVV)",0.96589763988332,0.816634980988593,0
"<anonymized_userid>",1,54637,8592,"Geert Wilders (PVV)",0.965915318659949,0.816730038022814,0
"<anonymized_userid>",1,54638,8593,"Geert Wilders (PVV)",0.965932997436577,0.816825095057034,0
"<anonymized_userid>",1,54639,8594,"Geert Wilders (PVV)",0.965950676213206,0.816920152091255,0
"<anonymized_userid>",1,54640,8595,"Geert Wilders (PVV)",0.965968354989835,0.817015209125475,0
"<anonymized_userid>",1,54641,8596,"Geert Wilders (PVV)",0.965986033766463,0.817110266159696,0
"<anonymized_userid>",1,54642,8597,"Geert Wilders (PVV)",0.966003712543092,0.817205323193916,0
"<anonymized_userid>",1,54643,8598,"Geert Wilders (PVV)",0.966021391319721,0.817300380228137,0
"<anonymized_userid>",1,54644,8599,"Geert Wilders (PVV)",0.966039070096349,0.817395437262357,0
"<anonymized_userid>",1,54645,8600,"Geert Wilders (PVV)",0.966056748872978,0.817490494296578,0
"<anonymized_userid>",1,54646,8601,"Geert Wilders (PVV)",0.966074427649607,0.817585551330798,0
"<anonymized_userid>",1,54647,8602,"Geert Wilders (PVV)",0.966092106426235,0.817680608365019,0
"<anonymized_userid>",1,54648,8603,"Geert Wilders (PVV)",0.966109785202864,0.81777566539924,0
"<anonymized_userid>",1,54649,8604,"Geert Wilders (PVV)",0.966127463979493,0.81787072243346,0
"<anonymized_userid>",1,54650,8605,"Geert Wilders (PVV)",0.966145142756121,0.817965779467681,0
"<anonymized_userid>",1,54651,8606,"Geert Wilders (PVV)",0.96616282153275,0.818060836501901,0
"<anonymized_userid>",1,54652,8607,"Geert Wilders (PVV)",0.966180500309379,0.818155893536122,0
"<anonymized_userid>",1,54653,8608,"Geert Wilders (PVV)",0.966198179086007,0.818250950570342,0
"<anonymized_userid>",1,54654,8609,"Geert Wilders (PVV)",0.966215857862636,0.818346007604563,0
"<anonymized_userid>",1,54655,8610,"Geert Wilders (PVV)",0.966233536639265,0.818441064638783,0
"<anonymized_userid>",1,54656,8611,"Geert Wilders (PVV)",0.966251215415893,0.818536121673004,0
"<anonymized_userid>",1,54657,8612,"Geert Wilders (PVV)",0.966268894192522,0.818631178707224,0
"<anonymized_userid>",1,54658,8613,"Geert Wilders (PVV)",0.966286572969151,0.818726235741445,0
"<anonymized_userid>",1,54659,8614,"Geert Wilders (PVV)",0.966304251745779,0.818821292775665,0
"<anonymized_userid>",1,54660,8615,"Geert Wilders (PVV)",0.966321930522408,0.818916349809886,0
"<anonymized_userid>",1,54661,8616,"Geert Wilders (PVV)",0.966339609299037,0.819011406844106,0
"<anonymized_userid>",1,54662,8617,"Geert Wilders (PVV)",0.966357288075665,0.819106463878327,0
"<anonymized_userid>",1,54663,8618,"Geert Wilders (PVV)",0.966374966852294,0.819201520912547,0
"<anonymized_userid>",1,54664,8619,"Geert Wilders (PVV)",0.966392645628922,0.819296577946768,0
"<anonymized_userid>",1,54665,8620,"Geert Wilders (PVV)",0.966410324405551,0.819391634980989,0
"<anonymized_userid>",1,54666,8621,"Geert Wilders (PVV)",0.96642800318218,0.819486692015209,0
"<anonymized_userid>",1,54667,8622,"Geert Wilders (PVV)",0.966445681958808,0.81958174904943,0
"<anonymized_userid>",1,54668,8623,"Geert Wilders (PVV)",0.966463360735437,0.81967680608365,0
"<anonymized_userid>",1,54669,8624,"Geert Wilders (PVV)",0.966481039512066,0.819771863117871,0
"<anonymized_userid>",1,54670,8625,"Geert Wilders (PVV)",0.966498718288694,0.819866920152091,0
"<anonymized_userid>",1,54671,8626,"Geert Wilders (PVV)",0.966516397065323,0.819961977186312,0
"<anonymized_userid>",1,54672,8627,"Geert Wilders (PVV)",0.966534075841952,0.820057034220532,0
"<anonymized_userid>",1,54673,8628,"Geert Wilders (PVV)",0.96655175461858,0.820152091254753,0
"<anonymized_userid>",1,54674,8629,"Geert Wilders (PVV)",0.966569433395209,0.820247148288973,0
"<anonymized_userid>",1,54675,8630,"Geert Wilders (PVV)",0.966587112171838,0.820342205323194,0
"<anonymized_userid>",1,54676,8631,"Geert Wilders (PVV)",0.966604790948466,0.820437262357414,0
"<anonymized_userid>",1,54677,8632,"Geert Wilders (PVV)",0.966622469725095,0.820532319391635,0
"<anonymized_userid>",1,54678,8633,"Geert Wilders (PVV)",0.966640148501724,0.820627376425855,0
"<anonymized_userid>",1,54679,8634,"Geert Wilders (PVV)",0.966657827278352,0.820722433460076,0
"<anonymized_userid>",1,54680,8635,"Geert Wilders (PVV)",0.966675506054981,0.820817490494297,0
"<anonymized_userid>",1,54681,8636,"Geert Wilders (PVV)",0.96669318483161,0.820912547528517,0
"<anonymized_userid>",1,54682,8637,"Geert Wilders (PVV)",0.966710863608238,0.821007604562738,0
"<anonymized_userid>",1,54683,8638,"Geert Wilders (PVV)",0.966728542384867,0.821102661596958,0
"<anonymized_userid>",1,54684,8639,"Geert Wilders (PVV)",0.966746221161496,0.821197718631179,0
"<anonymized_userid>",1,54685,8640,"Geert Wilders (PVV)",0.966763899938124,0.821292775665399,0
"<anonymized_userid>",1,54686,8641,"Geert Wilders (PVV)",0.966781578714753,0.82138783269962,0
"<anonymized_userid>",1,54687,8642,"Geert Wilders (PVV)",0.966799257491382,0.82148288973384,0
"<anonymized_userid>",1,54688,8643,"Geert Wilders (PVV)",0.96681693626801,0.821577946768061,0
"<anonymized_userid>",1,54689,8644,"Geert Wilders (PVV)",0.966834615044639,0.821673003802281,0
"<anonymized_userid>",1,54690,8645,"Geert Wilders (PVV)",0.966852293821268,0.821768060836502,0
"<anonymized_userid>",1,54691,8646,"Geert Wilders (PVV)",0.966869972597896,0.821863117870722,0
"<anonymized_userid>",1,54692,8647,"Geert Wilders (PVV)",0.966887651374525,0.821958174904943,0
"<anonymized_userid>",1,54693,8648,"Geert Wilders (PVV)",0.966905330151154,0.822053231939163,0
"<anonymized_userid>",1,54694,8649,"Geert Wilders (PVV)",0.966923008927782,0.822148288973384,0
"<anonymized_userid>",1,54695,8650,"Geert Wilders (PVV)",0.966940687704411,0.822243346007605,0
"<anonymized_userid>",1,54696,8651,"Geert Wilders (PVV)",0.966958366481039,0.822338403041825,0
"<anonymized_userid>",1,54697,8652,"Geert Wilders (PVV)",0.966976045257668,0.822433460076046,0
"<anonymized_userid>",1,54698,8653,"Geert Wilders (PVV)",0.966993724034297,0.822528517110266,0
"<anonymized_userid>",1,54699,8654,"Geert Wilders (PVV)",0.967011402810925,0.822623574144487,0
"<anonymized_userid>",1,54700,8655,"Geert Wilders (PVV)",0.967029081587554,0.822718631178707,0
"<anonymized_userid>",1,54701,8656,"Geert Wilders (PVV)",0.967046760364183,0.822813688212928,0
"<anonymized_userid>",1,54702,8657,"Geert Wilders (PVV)",0.967064439140811,0.822908745247148,0
"<anonymized_userid>",1,54703,8658,"Geert Wilders (PVV)",0.96708211791744,0.823003802281369,0
"<anonymized_userid>",1,54704,8659,"Geert Wilders (PVV)",0.967099796694069,0.823098859315589,0
"<anonymized_userid>",1,54705,8660,"Geert Wilders (PVV)",0.967117475470697,0.82319391634981,0
"<anonymized_userid>",1,54706,8661,"Geert Wilders (PVV)",0.967135154247326,0.82328897338403,0
"<anonymized_userid>",1,54707,8662,"Geert Wilders (PVV)",0.967152833023955,0.823384030418251,0
"<anonymized_userid>",1,54708,8663,"Geert Wilders (PVV)",0.967170511800583,0.823479087452471,0
"<anonymized_userid>",1,54709,8664,"Geert Wilders (PVV)",0.967188190577212,0.823574144486692,0
"<anonymized_userid>",1,54710,8665,"Geert Wilders (PVV)",0.967205869353841,0.823669201520912,0
"<anonymized_userid>",1,54711,8666,"Geert Wilders (PVV)",0.967223548130469,0.823764258555133,0
"<anonymized_userid>",1,54712,8667,"Geert Wilders (PVV)",0.967241226907098,0.823859315589354,0
"<anonymized_userid>",1,54713,8668,"Geert Wilders (PVV)",0.967258905683727,0.823954372623574,0
"<anonymized_userid>",1,54714,8669,"Geert Wilders (PVV)",0.967276584460355,0.824049429657795,0
"<anonymized_userid>",1,54715,8670,"Geert Wilders (PVV)",0.967294263236984,0.824144486692015,0
"<anonymized_userid>",1,54716,8671,"Geert Wilders (PVV)",0.967311942013613,0.824239543726236,0
"<anonymized_userid>",1,54717,8672,"Geert Wilders (PVV)",0.967329620790241,0.824334600760456,0
"<anonymized_userid>",1,54718,8673,"Geert Wilders (PVV)",0.96734729956687,0.824429657794677,0
"<anonymized_userid>",1,54719,8674,"Geert Wilders (PVV)",0.967364978343499,0.824524714828897,0
"<anonymized_userid>",1,54720,8675,"Geert Wilders (PVV)",0.967382657120127,0.824619771863118,0
"<anonymized_userid>",1,54721,8676,"Geert Wilders (PVV)",0.967400335896756,0.824714828897338,0
"<anonymized_userid>",1,54722,8677,"Geert Wilders (PVV)",0.967418014673385,0.824809885931559,0
"<anonymized_userid>",1,54723,8678,"Geert Wilders (PVV)",0.967435693450013,0.824904942965779,0
"<anonymized_userid>",1,54724,8679,"Geert Wilders (PVV)",0.967453372226642,0.825,0
"<anonymized_userid>",1,54725,8680,"Geert Wilders (PVV)",0.967471051003271,0.82509505703422,0
"<anonymized_userid>",1,54726,8681,"Geert Wilders (PVV)",0.967488729779899,0.825190114068441,0
"<anonymized_userid>",1,54727,8682,"Geert Wilders (PVV)",0.967506408556528,0.825285171102662,0
"<anonymized_userid>",1,54728,8683,"Geert Wilders (PVV)",0.967524087333157,0.825380228136882,0
"<anonymized_userid>",1,54729,8684,"Geert Wilders (PVV)",0.967541766109785,0.825475285171103,0
"<anonymized_userid>",1,54730,8685,"Geert Wilders (PVV)",0.967559444886414,0.825570342205323,0
"<anonymized_userid>",1,54731,8686,"Geert Wilders (PVV)",0.967577123663042,0.825665399239544,0
"<anonymized_userid>",1,54732,8687,"Geert Wilders (PVV)",0.967594802439671,0.825760456273764,0
"<anonymized_userid>",1,54733,8688,"Geert Wilders (PVV)",0.9676124812163,0.825855513307985,0
"<anonymized_userid>",1,54734,8689,"Geert Wilders (PVV)",0.967630159992928,0.825950570342205,0
"<anonymized_userid>",1,54735,8690,"Geert Wilders (PVV)",0.967647838769557,0.826045627376426,0
"<anonymized_userid>",1,54736,8691,"Geert Wilders (PVV)",0.967665517546186,0.826140684410646,0
"<anonymized_userid>",1,54737,8692,"Geert Wilders (PVV)",0.967683196322814,0.826235741444867,0
"<anonymized_userid>",1,54738,8693,"Geert Wilders (PVV)",0.967700875099443,0.826330798479087,0
"<anonymized_userid>",1,54739,8694,"Geert Wilders (PVV)",0.967718553876072,0.826425855513308,0
"<anonymized_userid>",1,54740,8695,"Geert Wilders (PVV)",0.9677362326527,0.826520912547528,0
"<anonymized_userid>",1,54741,8696,"Geert Wilders (PVV)",0.967753911429329,0.826615969581749,0
"<anonymized_userid>",1,54742,8697,"Geert Wilders (PVV)",0.967771590205958,0.82671102661597,0
"<anonymized_userid>",1,54743,8698,"Geert Wilders (PVV)",0.967789268982586,0.82680608365019,0
"<anonymized_userid>",1,54744,8699,"Geert Wilders (PVV)",0.967806947759215,0.826901140684411,0
"<anonymized_userid>",1,54745,8700,"Geert Wilders (PVV)",0.967824626535844,0.826996197718631,0
"<anonymized_userid>",1,54746,8701,"Geert Wilders (PVV)",0.967842305312472,0.827091254752852,0
"<anonymized_userid>",1,54747,8702,"Geert Wilders (PVV)",0.967859984089101,0.827186311787072,0
"<anonymized_userid>",1,54748,8703,"Geert Wilders (PVV)",0.96787766286573,0.827281368821293,0
"<anonymized_userid>",1,54749,8704,"Geert Wilders (PVV)",0.967895341642358,0.827376425855513,0
"<anonymized_userid>",1,54750,8705,"Geert Wilders (PVV)",0.967913020418987,0.827471482889734,0
"<anonymized_userid>",1,54751,8706,"Geert Wilders (PVV)",0.967930699195616,0.827566539923954,0
"<anonymized_userid>",1,54752,8707,"Geert Wilders (PVV)",0.967948377972244,0.827661596958175,0
"<anonymized_userid>",1,54753,8708,"Geert Wilders (PVV)",0.967966056748873,0.827756653992395,0
"<anonymized_userid>",1,54754,8709,"Geert Wilders (PVV)",0.967983735525502,0.827851711026616,0
"<anonymized_userid>",1,54755,8710,"Geert Wilders (PVV)",0.96800141430213,0.827946768060836,0
"<anonymized_userid>",1,54756,8711,"Geert Wilders (PVV)",0.968019093078759,0.828041825095057,0
"<anonymized_userid>",1,54757,8712,"Geert Wilders (PVV)",0.968036771855388,0.828136882129278,0
"<anonymized_userid>",1,54758,8713,"Geert Wilders (PVV)",0.968054450632016,0.828231939163498,0
"<anonymized_userid>",1,54759,8714,"Geert Wilders (PVV)",0.968072129408645,0.828326996197719,0
"<anonymized_userid>",1,54760,8715,"Geert Wilders (PVV)",0.968089808185274,0.828422053231939,0
"<anonymized_userid>",1,54761,8716,"Geert Wilders (PVV)",0.968107486961902,0.82851711026616,0
"<anonymized_userid>",1,54762,8717,"Geert Wilders (PVV)",0.968125165738531,0.82861216730038,0
"<anonymized_userid>",1,54763,8718,"Geert Wilders (PVV)",0.96814284451516,0.828707224334601,0
"<anonymized_userid>",1,54764,8719,"Geert Wilders (PVV)",0.968160523291788,0.828802281368821,0
"<anonymized_userid>",1,54765,8720,"Geert Wilders (PVV)",0.968178202068417,0.828897338403042,0
"<anonymized_userid>",1,54766,8721,"Geert Wilders (PVV)",0.968195880845045,0.828992395437262,0
"<anonymized_userid>",1,54767,8722,"Geert Wilders (PVV)",0.968213559621674,0.829087452471483,0
"<anonymized_userid>",1,54768,8723,"Geert Wilders (PVV)",0.968231238398303,0.829182509505703,0
"<anonymized_userid>",1,54769,8724,"Geert Wilders (PVV)",0.968248917174931,0.829277566539924,0
"<anonymized_userid>",1,54770,8725,"Geert Wilders (PVV)",0.96826659595156,0.829372623574145,0
"<anonymized_userid>",1,54771,8726,"Geert Wilders (PVV)",0.968284274728189,0.829467680608365,0
"<anonymized_userid>",1,54772,8727,"Geert Wilders (PVV)",0.968301953504818,0.829562737642586,0
"<anonymized_userid>",1,54773,8728,"Geert Wilders (PVV)",0.968319632281446,0.829657794676806,0
"<anonymized_userid>",1,54774,8729,"Geert Wilders (PVV)",0.968337311058075,0.829752851711027,0
"<anonymized_userid>",1,54775,8730,"Geert Wilders (PVV)",0.968354989834703,0.829847908745247,0
"<anonymized_userid>",1,54776,8731,"Geert Wilders (PVV)",0.968372668611332,0.829942965779468,0
"<anonymized_userid>",1,54777,8732,"Geert Wilders (PVV)",0.968390347387961,0.830038022813688,0
"<anonymized_userid>",1,54778,8733,"Geert Wilders (PVV)",0.968408026164589,0.830133079847909,0
"<anonymized_userid>",1,54779,8734,"Geert Wilders (PVV)",0.968425704941218,0.830228136882129,0
"<anonymized_userid>",1,54780,8735,"Geert Wilders (PVV)",0.968443383717847,0.83032319391635,0
"<anonymized_userid>",1,54781,8736,"Geert Wilders (PVV)",0.968461062494475,0.83041825095057,0
"<anonymized_userid>",1,54782,8737,"Geert Wilders (PVV)",0.968478741271104,0.830513307984791,0
"<anonymized_userid>",1,54783,8738,"Geert Wilders (PVV)",0.968496420047733,0.830608365019011,0
"<anonymized_userid>",1,54784,8739,"Geert Wilders (PVV)",0.968514098824361,0.830703422053232,0
"<anonymized_userid>",1,54785,8740,"Geert Wilders (PVV)",0.96853177760099,0.830798479087453,0
"<anonymized_userid>",1,54786,8741,"Geert Wilders (PVV)",0.968549456377619,0.830893536121673,0
"<anonymized_userid>",1,54787,8742,"Geert Wilders (PVV)",0.968567135154247,0.830988593155894,0
"<anonymized_userid>",1,54788,8743,"Geert Wilders (PVV)",0.968584813930876,0.831083650190114,0
"<anonymized_userid>",1,54789,8744,"Geert Wilders (PVV)",0.968602492707505,0.831178707224335,0
"<anonymized_userid>",1,54790,8745,"Geert Wilders (PVV)",0.968620171484133,0.831273764258555,0
"<anonymized_userid>",1,54791,8746,"Geert Wilders (PVV)",0.968637850260762,0.831368821292776,0
"<anonymized_userid>",1,54792,8747,"Geert Wilders (PVV)",0.968655529037391,0.831463878326996,0
"<anonymized_userid>",1,54793,8748,"Geert Wilders (PVV)",0.968673207814019,0.831558935361217,0
"<anonymized_userid>",1,54794,8749,"Geert Wilders (PVV)",0.968690886590648,0.831653992395437,0
"<anonymized_userid>",1,54795,8750,"Geert Wilders (PVV)",0.968708565367277,0.831749049429658,0
"<anonymized_userid>",1,54796,8751,"Geert Wilders (PVV)",0.968726244143905,0.831844106463878,0
"<anonymized_userid>",1,54797,8752,"Geert Wilders (PVV)",0.968743922920534,0.831939163498099,0
"<anonymized_userid>",1,54798,8753,"Geert Wilders (PVV)",0.968761601697163,0.832034220532319,0
"<anonymized_userid>",1,54799,8754,"Geert Wilders (PVV)",0.968779280473791,0.83212927756654,0
"<anonymized_userid>",1,54800,8755,"Geert Wilders (PVV)",0.96879695925042,0.832224334600761,0
"<anonymized_userid>",1,54801,8756,"Geert Wilders (PVV)",0.968814638027048,0.832319391634981,0
"<anonymized_userid>",1,54802,8757,"Geert Wilders (PVV)",0.968832316803677,0.832414448669202,0
"<anonymized_userid>",1,54803,8758,"Geert Wilders (PVV)",0.968849995580306,0.832509505703422,0
"<anonymized_userid>",1,54804,8759,"Geert Wilders (PVV)",0.968867674356935,0.832604562737643,0
"<anonymized_userid>",1,54805,8760,"Geert Wilders (PVV)",0.968885353133563,0.832699619771863,0
"<anonymized_userid>",1,54806,8761,"Geert Wilders (PVV)",0.968903031910192,0.832794676806084,0
"<anonymized_userid>",1,54807,8762,"Geert Wilders (PVV)",0.968920710686821,0.832889733840304,0
"<anonymized_userid>",1,54808,8763,"Geert Wilders (PVV)",0.968938389463449,0.832984790874525,0
"<anonymized_userid>",1,54809,8764,"Geert Wilders (PVV)",0.968956068240078,0.833079847908745,0
"<anonymized_userid>",1,54810,8765,"Geert Wilders (PVV)",0.968973747016706,0.833174904942966,0
"<anonymized_userid>",1,54811,8766,"Geert Wilders (PVV)",0.968991425793335,0.833269961977186,0
"<anonymized_userid>",1,54812,8767,"Geert Wilders (PVV)",0.969009104569964,0.833365019011407,0
"<anonymized_userid>",1,54813,8768,"Geert Wilders (PVV)",0.969026783346592,0.833460076045627,0
"<anonymized_userid>",1,54814,8769,"Geert Wilders (PVV)",0.969044462123221,0.833555133079848,0
"<anonymized_userid>",1,54815,8770,"Geert Wilders (PVV)",0.96906214089985,0.833650190114068,0
"<anonymized_userid>",1,54816,8771,"Geert Wilders (PVV)",0.969079819676478,0.833745247148289,0
"<anonymized_userid>",1,54817,8772,"Geert Wilders (PVV)",0.969097498453107,0.83384030418251,0
"<anonymized_userid>",1,54818,8773,"Geert Wilders (PVV)",0.969115177229736,0.83393536121673,0
"<anonymized_userid>",1,54819,8774,"Geert Wilders (PVV)",0.969132856006364,0.834030418250951,0
"<anonymized_userid>",1,54820,8775,"Geert Wilders (PVV)",0.969150534782993,0.834125475285171,0
"<anonymized_userid>",1,54821,8776,"Geert Wilders (PVV)",0.969168213559622,0.834220532319392,0
"<anonymized_userid>",1,54822,8777,"Geert Wilders (PVV)",0.96918589233625,0.834315589353612,0
"<anonymized_userid>",1,54823,8778,"Geert Wilders (PVV)",0.969203571112879,0.834410646387833,0
"<anonymized_userid>",1,54824,8779,"Geert Wilders (PVV)",0.969221249889508,0.834505703422053,0
"<anonymized_userid>",1,54825,8780,"Geert Wilders (PVV)",0.969238928666136,0.834600760456274,0
"<anonymized_userid>",1,54826,8781,"Geert Wilders (PVV)",0.969256607442765,0.834695817490494,0
"<anonymized_userid>",1,54827,8782,"Geert Wilders (PVV)",0.969274286219394,0.834790874524715,0
"<anonymized_userid>",1,54828,8783,"Geert Wilders (PVV)",0.969291964996022,0.834885931558935,0
"<anonymized_userid>",1,54829,8784,"Geert Wilders (PVV)",0.969309643772651,0.834980988593156,0
"<anonymized_userid>",1,54830,8785,"Geert Wilders (PVV)",0.96932732254928,0.835076045627376,0
"<anonymized_userid>",1,54831,8786,"Geert Wilders (PVV)",0.969345001325908,0.835171102661597,0
"<anonymized_userid>",1,54832,8787,"Geert Wilders (PVV)",0.969362680102537,0.835266159695818,0
"<anonymized_userid>",1,54833,8788,"Geert Wilders (PVV)",0.969380358879166,0.835361216730038,0
"<anonymized_userid>",1,54834,8789,"Geert Wilders (PVV)",0.969398037655794,0.835456273764259,0
"<anonymized_userid>",1,54835,8790,"Geert Wilders (PVV)",0.969415716432423,0.835551330798479,0
"<anonymized_userid>",1,54836,8791,"Geert Wilders (PVV)",0.969433395209052,0.8356463878327,0
"<anonymized_userid>",1,54837,8792,"Geert Wilders (PVV)",0.96945107398568,0.83574144486692,0
"<anonymized_userid>",1,54838,8793,"Geert Wilders (PVV)",0.969468752762309,0.835836501901141,0
"<anonymized_userid>",1,54839,8794,"Geert Wilders (PVV)",0.969486431538938,0.835931558935361,0
"<anonymized_userid>",1,54840,8795,"Geert Wilders (PVV)",0.969504110315566,0.836026615969582,0
"<anonymized_userid>",1,54841,8796,"Geert Wilders (PVV)",0.969521789092195,0.836121673003802,0
"<anonymized_userid>",1,54842,8797,"Geert Wilders (PVV)",0.969539467868824,0.836216730038023,0
"<anonymized_userid>",1,54843,8798,"Geert Wilders (PVV)",0.969557146645452,0.836311787072243,0
"<anonymized_userid>",1,54844,8799,"Geert Wilders (PVV)",0.969574825422081,0.836406844106464,0
"<anonymized_userid>",1,54845,8800,"Geert Wilders (PVV)",0.969592504198709,0.836501901140684,0
"<anonymized_userid>",1,54846,8801,"Geert Wilders (PVV)",0.969610182975338,0.836596958174905,0
"<anonymized_userid>",1,54847,8802,"Geert Wilders (PVV)",0.969627861751967,0.836692015209126,0
"<anonymized_userid>",1,54848,8803,"Geert Wilders (PVV)",0.969645540528595,0.836787072243346,0
"<anonymized_userid>",1,54849,8804,"Geert Wilders (PVV)",0.969663219305224,0.836882129277567,0
"<anonymized_userid>",1,54850,8805,"Geert Wilders (PVV)",0.969680898081853,0.836977186311787,0
"<anonymized_userid>",1,54851,8806,"Geert Wilders (PVV)",0.969698576858481,0.837072243346008,0
"<anonymized_userid>",1,54852,8807,"Geert Wilders (PVV)",0.96971625563511,0.837167300380228,0
"<anonymized_userid>",1,54853,8808,"Geert Wilders (PVV)",0.969733934411739,0.837262357414449,0
"<anonymized_userid>",1,54854,8809,"Geert Wilders (PVV)",0.969751613188367,0.837357414448669,0
"<anonymized_userid>",1,54855,8810,"Geert Wilders (PVV)",0.969769291964996,0.83745247148289,0
"<anonymized_userid>",1,54856,8811,"Geert Wilders (PVV)",0.969786970741625,0.83754752851711,0
"<anonymized_userid>",1,54857,8812,"Geert Wilders (PVV)",0.969804649518253,0.837642585551331,0
"<anonymized_userid>",1,54858,8813,"Geert Wilders (PVV)",0.969822328294882,0.837737642585551,0
"<anonymized_userid>",1,54859,8814,"Geert Wilders (PVV)",0.969840007071511,0.837832699619772,0
"<anonymized_userid>",1,54860,8815,"Geert Wilders (PVV)",0.969857685848139,0.837927756653992,0
"<anonymized_userid>",1,54861,8816,"Geert Wilders (PVV)",0.969875364624768,0.838022813688213,0
"<anonymized_userid>",1,54862,8817,"Geert Wilders (PVV)",0.969893043401397,0.838117870722433,0
"<anonymized_userid>",1,54863,8818,"Geert Wilders (PVV)",0.969910722178025,0.838212927756654,0
"<anonymized_userid>",1,54864,8819,"Geert Wilders (PVV)",0.969928400954654,0.838307984790875,0
"<anonymized_userid>",1,54865,8820,"Geert Wilders (PVV)",0.969946079731283,0.838403041825095,0
"<anonymized_userid>",1,54866,8821,"Geert Wilders (PVV)",0.969963758507911,0.838498098859316,0
"<anonymized_userid>",1,54867,8822,"Geert Wilders (PVV)",0.96998143728454,0.838593155893536,0
"<anonymized_userid>",1,54868,8823,"Geert Wilders (PVV)",0.969999116061169,0.838688212927757,0
"<anonymized_userid>",1,54869,8824,"Geert Wilders (PVV)",0.970016794837797,0.838783269961977,0
"<anonymized_userid>",1,54870,8825,"Geert Wilders (PVV)",0.970034473614426,0.838878326996198,0
"<anonymized_userid>",1,54871,8826,"Geert Wilders (PVV)",0.970052152391055,0.838973384030418,0
"<anonymized_userid>",1,54872,8827,"Geert Wilders (PVV)",0.970069831167683,0.839068441064639,0
"<anonymized_userid>",1,54873,8828,"Geert Wilders (PVV)",0.970087509944312,0.839163498098859,0
"<anonymized_userid>",1,54874,8829,"Geert Wilders (PVV)",0.970105188720941,0.83925855513308,0
"<anonymized_userid>",1,54875,8830,"Geert Wilders (PVV)",0.970122867497569,0.8393536121673,0
"<anonymized_userid>",1,54876,8831,"Geert Wilders (PVV)",0.970140546274198,0.839448669201521,0
"<anonymized_userid>",1,54877,8832,"Geert Wilders (PVV)",0.970158225050826,0.839543726235741,0
"<anonymized_userid>",1,54878,8833,"Geert Wilders (PVV)",0.970175903827455,0.839638783269962,0
"<anonymized_userid>",1,54879,8834,"Geert Wilders (PVV)",0.970193582604084,0.839733840304183,0
"<anonymized_userid>",1,54880,8835,"Geert Wilders (PVV)",0.970211261380712,0.839828897338403,0
"<anonymized_userid>",1,54881,8836,"Geert Wilders (PVV)",0.970228940157341,0.839923954372624,0
"<anonymized_userid>",1,54882,8837,"Geert Wilders (PVV)",0.97024661893397,0.840019011406844,0
"<anonymized_userid>",1,54883,8838,"Geert Wilders (PVV)",0.970264297710598,0.840114068441065,0
"<anonymized_userid>",1,54884,8839,"Geert Wilders (PVV)",0.970281976487227,0.840209125475285,0
"<anonymized_userid>",1,54885,8840,"Geert Wilders (PVV)",0.970299655263856,0.840304182509506,0
"<anonymized_userid>",1,54886,8841,"Geert Wilders (PVV)",0.970317334040484,0.840399239543726,0
"<anonymized_userid>",1,54887,8842,"Geert Wilders (PVV)",0.970335012817113,0.840494296577947,0
"<anonymized_userid>",1,54888,8843,"Geert Wilders (PVV)",0.970352691593742,0.840589353612167,0
"<anonymized_userid>",1,54889,8844,"Geert Wilders (PVV)",0.97037037037037,0.840684410646388,0
"<anonymized_userid>",1,54890,8845,"Geert Wilders (PVV)",0.970388049146999,0.840779467680608,0
"<anonymized_userid>",1,54891,8846,"Geert Wilders (PVV)",0.970405727923628,0.840874524714829,0
"<anonymized_userid>",1,54892,8847,"Geert Wilders (PVV)",0.970423406700256,0.840969581749049,0
"<anonymized_userid>",1,54893,8848,"Geert Wilders (PVV)",0.970441085476885,0.84106463878327,0
"<anonymized_userid>",1,54894,8849,"Geert Wilders (PVV)",0.970458764253514,0.841159695817491,0
"<anonymized_userid>",1,54895,8850,"Geert Wilders (PVV)",0.970476443030142,0.841254752851711,0
"<anonymized_userid>",1,54896,8851,"Geert Wilders (PVV)",0.970494121806771,0.841349809885932,0
"<anonymized_userid>",1,54897,8852,"Geert Wilders (PVV)",0.9705118005834,0.841444866920152,0
"<anonymized_userid>",1,54898,8853,"Geert Wilders (PVV)",0.970529479360028,0.841539923954373,0
"<anonymized_userid>",1,54899,8854,"Geert Wilders (PVV)",0.970547158136657,0.841634980988593,0
"<anonymized_userid>",1,54900,8855,"Geert Wilders (PVV)",0.970564836913286,0.841730038022814,0
"<anonymized_userid>",1,54901,8856,"Geert Wilders (PVV)",0.970582515689914,0.841825095057034,0
"<anonymized_userid>",1,54902,8857,"Geert Wilders (PVV)",0.970600194466543,0.841920152091255,0
"<anonymized_userid>",1,54903,8858,"Geert Wilders (PVV)",0.970617873243172,0.842015209125475,0
"<anonymized_userid>",1,54904,8859,"Geert Wilders (PVV)",0.9706355520198,0.842110266159696,0
"<anonymized_userid>",1,54905,8860,"Geert Wilders (PVV)",0.970653230796429,0.842205323193916,0
"<anonymized_userid>",1,54906,8861,"Geert Wilders (PVV)",0.970670909573058,0.842300380228137,0
"<anonymized_userid>",1,54907,8862,"Geert Wilders (PVV)",0.970688588349686,0.842395437262357,0
"<anonymized_userid>",1,54908,8863,"Geert Wilders (PVV)",0.970706267126315,0.842490494296578,0
"<anonymized_userid>",1,54909,8864,"Geert Wilders (PVV)",0.970723945902944,0.842585551330798,0
"<anonymized_userid>",1,54910,8865,"Geert Wilders (PVV)",0.970741624679572,0.842680608365019,0
"<anonymized_userid>",1,54911,8866,"Geert Wilders (PVV)",0.970759303456201,0.84277566539924,0
"<anonymized_userid>",1,54912,8867,"Geert Wilders (PVV)",0.970776982232829,0.84287072243346,0
"<anonymized_userid>",1,54913,8868,"Geert Wilders (PVV)",0.970794661009458,0.842965779467681,0
"<anonymized_userid>",1,54914,8869,"Geert Wilders (PVV)",0.970812339786087,0.843060836501901,0
"<anonymized_userid>",1,54915,8870,"Geert Wilders (PVV)",0.970830018562715,0.843155893536122,0
"<anonymized_userid>",1,54916,8871,"Geert Wilders (PVV)",0.970847697339344,0.843250950570342,0
"<anonymized_userid>",1,54917,8872,"Geert Wilders (PVV)",0.970865376115973,0.843346007604563,0
"<anonymized_userid>",1,54918,8873,"Geert Wilders (PVV)",0.970883054892601,0.843441064638783,0
"<anonymized_userid>",1,54919,8874,"Geert Wilders (PVV)",0.97090073366923,0.843536121673004,0
"<anonymized_userid>",1,54920,8875,"Geert Wilders (PVV)",0.970918412445859,0.843631178707224,0
"<anonymized_userid>",1,54921,8876,"Geert Wilders (PVV)",0.970936091222487,0.843726235741445,0
"<anonymized_userid>",1,54922,8877,"Geert Wilders (PVV)",0.970953769999116,0.843821292775665,0
"<anonymized_userid>",1,54923,8878,"Geert Wilders (PVV)",0.970971448775745,0.843916349809886,0
"<anonymized_userid>",1,54924,8879,"Geert Wilders (PVV)",0.970989127552373,0.844011406844106,0
"<anonymized_userid>",1,54925,8880,"Geert Wilders (PVV)",0.971006806329002,0.844106463878327,0
"<anonymized_userid>",1,54926,8881,"Geert Wilders (PVV)",0.971024485105631,0.844201520912548,0
"<anonymized_userid>",1,54927,8882,"Geert Wilders (PVV)",0.971042163882259,0.844296577946768,0
"<anonymized_userid>",1,54928,8883,"Geert Wilders (PVV)",0.971059842658888,0.844391634980989,0
"<anonymized_userid>",1,54929,8884,"Geert Wilders (PVV)",0.971077521435517,0.844486692015209,0
"<anonymized_userid>",1,54930,8885,"Geert Wilders (PVV)",0.971095200212145,0.84458174904943,0
"<anonymized_userid>",1,54931,8886,"Geert Wilders (PVV)",0.971112878988774,0.84467680608365,0
"<anonymized_userid>",1,54932,8887,"Geert Wilders (PVV)",0.971130557765403,0.844771863117871,0
"<anonymized_userid>",1,54933,8888,"Geert Wilders (PVV)",0.971148236542031,0.844866920152091,0
"<anonymized_userid>",1,54934,8889,"Geert Wilders (PVV)",0.97116591531866,0.844961977186312,0
"<anonymized_userid>",1,54935,8890,"Geert Wilders (PVV)",0.971183594095289,0.845057034220532,0
"<anonymized_userid>",1,54936,8891,"Geert Wilders (PVV)",0.971201272871917,0.845152091254753,0
"<anonymized_userid>",1,54937,8892,"Geert Wilders (PVV)",0.971218951648546,0.845247148288973,0
"<anonymized_userid>",1,54938,8893,"Geert Wilders (PVV)",0.971236630425175,0.845342205323194,0
"<anonymized_userid>",1,54939,8894,"Geert Wilders (PVV)",0.971254309201803,0.845437262357414,0
"<anonymized_userid>",1,54940,8895,"Geert Wilders (PVV)",0.971271987978432,0.845532319391635,0
"<anonymized_userid>",1,54941,8896,"Geert Wilders (PVV)",0.971289666755061,0.845627376425856,0
"<anonymized_userid>",1,54942,8897,"Geert Wilders (PVV)",0.971307345531689,0.845722433460076,0
"<anonymized_userid>",1,54943,8898,"Geert Wilders (PVV)",0.971325024308318,0.845817490494297,0
"<anonymized_userid>",1,54944,8899,"Geert Wilders (PVV)",0.971342703084947,0.845912547528517,0
"<anonymized_userid>",1,54945,8900,"Geert Wilders (PVV)",0.971360381861575,0.846007604562738,0
"<anonymized_userid>",1,54946,8901,"Geert Wilders (PVV)",0.971378060638204,0.846102661596958,0
"<anonymized_userid>",1,54947,8902,"Geert Wilders (PVV)",0.971395739414832,0.846197718631179,0
"<anonymized_userid>",1,54948,8903,"Geert Wilders (PVV)",0.971413418191461,0.846292775665399,0
"<anonymized_userid>",1,54949,8904,"Geert Wilders (PVV)",0.97143109696809,0.84638783269962,0
"<anonymized_userid>",1,54950,8905,"Geert Wilders (PVV)",0.971448775744718,0.84648288973384,0
"<anonymized_userid>",1,54951,8906,"Geert Wilders (PVV)",0.971466454521347,0.846577946768061,0
"<anonymized_userid>",1,54952,8907,"Geert Wilders (PVV)",0.971484133297976,0.846673003802281,0
"<anonymized_userid>",1,54953,8908,"Geert Wilders (PVV)",0.971501812074604,0.846768060836502,0
"<anonymized_userid>",1,54954,8909,"Geert Wilders (PVV)",0.971519490851233,0.846863117870722,0
"<anonymized_userid>",1,54955,8910,"Geert Wilders (PVV)",0.971537169627862,0.846958174904943,0
"<anonymized_userid>",1,54956,8911,"Geert Wilders (PVV)",0.97155484840449,0.847053231939163,0
"<anonymized_userid>",1,54957,8912,"Geert Wilders (PVV)",0.971572527181119,0.847148288973384,0
"<anonymized_userid>",1,54958,8913,"Geert Wilders (PVV)",0.971590205957748,0.847243346007605,0
"<anonymized_userid>",1,54959,8914,"Geert Wilders (PVV)",0.971607884734376,0.847338403041825,0
"<anonymized_userid>",1,54960,8915,"Geert Wilders (PVV)",0.971625563511005,0.847433460076046,0
"<anonymized_userid>",1,54961,8916,"Geert Wilders (PVV)",0.971643242287634,0.847528517110266,0
"<anonymized_userid>",1,54962,8917,"Geert Wilders (PVV)",0.971660921064262,0.847623574144487,0
"<anonymized_userid>",1,54963,8918,"Geert Wilders (PVV)",0.971678599840891,0.847718631178707,0
"<anonymized_userid>",1,54964,8919,"Geert Wilders (PVV)",0.97169627861752,0.847813688212928,0
"<anonymized_userid>",1,54965,8920,"Geert Wilders (PVV)",0.971713957394148,0.847908745247148,0
"<anonymized_userid>",1,54966,8921,"Geert Wilders (PVV)",0.971731636170777,0.848003802281369,0
"<anonymized_userid>",1,54967,8922,"Geert Wilders (PVV)",0.971749314947406,0.848098859315589,0
"<anonymized_userid>",1,54968,8923,"Geert Wilders (PVV)",0.971766993724034,0.84819391634981,0
"<anonymized_userid>",1,54969,8924,"Geert Wilders (PVV)",0.971784672500663,0.84828897338403,0
"<anonymized_userid>",1,54970,8925,"Geert Wilders (PVV)",0.971802351277292,0.848384030418251,0
"<anonymized_userid>",1,54971,8926,"Geert Wilders (PVV)",0.97182003005392,0.848479087452471,0
"<anonymized_userid>",1,54972,8927,"Geert Wilders (PVV)",0.971837708830549,0.848574144486692,0
"<anonymized_userid>",1,54973,8928,"Geert Wilders (PVV)",0.971855387607178,0.848669201520913,0
"<anonymized_userid>",1,54974,8929,"Geert Wilders (PVV)",0.971873066383806,0.848764258555133,0
"<anonymized_userid>",1,54975,8930,"Geert Wilders (PVV)",0.971890745160435,0.848859315589354,0
"<anonymized_userid>",1,54976,8931,"Geert Wilders (PVV)",0.971908423937064,0.848954372623574,0
"<anonymized_userid>",1,54977,8932,"Geert Wilders (PVV)",0.971926102713692,0.849049429657795,0
"<anonymized_userid>",1,54978,8933,"Geert Wilders (PVV)",0.971943781490321,0.849144486692015,0
"<anonymized_userid>",1,54979,8934,"Geert Wilders (PVV)",0.97196146026695,0.849239543726236,0
"<anonymized_userid>",1,54980,8935,"Geert Wilders (PVV)",0.971979139043578,0.849334600760456,0
"<anonymized_userid>",1,54981,8936,"Geert Wilders (PVV)",0.971996817820207,0.849429657794677,0
"<anonymized_userid>",1,54982,8937,"Geert Wilders (PVV)",0.972014496596835,0.849524714828897,0
"<anonymized_userid>",1,54983,8938,"Geert Wilders (PVV)",0.972032175373464,0.849619771863118,0
"<anonymized_userid>",1,54984,8939,"Geert Wilders (PVV)",0.972049854150093,0.849714828897338,0
"<anonymized_userid>",1,54985,8940,"Geert Wilders (PVV)",0.972067532926721,0.849809885931559,0
"<anonymized_userid>",1,54986,8941,"Geert Wilders (PVV)",0.97208521170335,0.849904942965779,0
"<anonymized_userid>",1,54987,8942,"Geert Wilders (PVV)",0.972102890479979,0.85,0
"<anonymized_userid>",1,54988,8943,"Geert Wilders (PVV)",0.972120569256607,0.850095057034221,0
"<anonymized_userid>",1,54989,8944,"Geert Wilders (PVV)",0.972138248033236,0.850190114068441,0
"<anonymized_userid>",1,54990,8945,"Geert Wilders (PVV)",0.972155926809865,0.850285171102662,0
"<anonymized_userid>",1,54991,8946,"Geert Wilders (PVV)",0.972173605586493,0.850380228136882,0
"<anonymized_userid>",1,54992,8947,"Geert Wilders (PVV)",0.972191284363122,0.850475285171103,0
"<anonymized_userid>",1,54993,8948,"Geert Wilders (PVV)",0.972208963139751,0.850570342205323,0
"<anonymized_userid>",1,54994,8949,"Geert Wilders (PVV)",0.972226641916379,0.850665399239544,0
"<anonymized_userid>",1,54995,8950,"Geert Wilders (PVV)",0.972244320693008,0.850760456273764,0
"<anonymized_userid>",1,54996,8951,"Geert Wilders (PVV)",0.972261999469637,0.850855513307985,0
"<anonymized_userid>",1,54997,8952,"Geert Wilders (PVV)",0.972279678246265,0.850950570342205,0
"<anonymized_userid>",1,54998,8953,"Geert Wilders (PVV)",0.972297357022894,0.851045627376426,0
"<anonymized_userid>",1,54999,8954,"Geert Wilders (PVV)",0.972315035799523,0.851140684410646,0
"<anonymized_userid>",1,55000,8955,"Geert Wilders (PVV)",0.972332714576151,0.851235741444867,0
"<anonymized_userid>",1,55001,8956,"Geert Wilders (PVV)",0.97235039335278,0.851330798479087,0
"<anonymized_userid>",1,55002,8957,"Geert Wilders (PVV)",0.972368072129409,0.851425855513308,0
"<anonymized_userid>",1,55003,8958,"Geert Wilders (PVV)",0.972385750906037,0.851520912547528,0
"<anonymized_userid>",1,55004,8959,"Geert Wilders (PVV)",0.972403429682666,0.851615969581749,0
"<anonymized_userid>",1,55005,8960,"Geert Wilders (PVV)",0.972421108459295,0.85171102661597,0
"<anonymized_userid>",1,55006,8961,"Geert Wilders (PVV)",0.972438787235923,0.85180608365019,0
"<anonymized_userid>",1,55007,8962,"Geert Wilders (PVV)",0.972456466012552,0.851901140684411,0
"<anonymized_userid>",1,55008,8963,"Geert Wilders (PVV)",0.972474144789181,0.851996197718631,0
"<anonymized_userid>",1,55009,8964,"Geert Wilders (PVV)",0.972491823565809,0.852091254752852,0
"<anonymized_userid>",1,55010,8965,"Geert Wilders (PVV)",0.972509502342438,0.852186311787072,0
"<anonymized_userid>",1,55011,8966,"Geert Wilders (PVV)",0.972527181119067,0.852281368821293,0
"<anonymized_userid>",1,55012,8967,"Geert Wilders (PVV)",0.972544859895695,0.852376425855513,0
"<anonymized_userid>",1,55013,8968,"Geert Wilders (PVV)",0.972562538672324,0.852471482889734,0
"<anonymized_userid>",1,55014,8969,"Geert Wilders (PVV)",0.972580217448953,0.852566539923954,0
"<anonymized_userid>",1,55015,8970,"Geert Wilders (PVV)",0.972597896225581,0.852661596958175,0
"<anonymized_userid>",1,55016,8971,"Geert Wilders (PVV)",0.97261557500221,0.852756653992395,0
"<anonymized_userid>",1,55017,8972,"Geert Wilders (PVV)",0.972633253778838,0.852851711026616,0
"<anonymized_userid>",1,55018,8973,"Geert Wilders (PVV)",0.972650932555467,0.852946768060836,0
"<anonymized_userid>",1,55019,8974,"Geert Wilders (PVV)",0.972668611332096,0.853041825095057,0
"<anonymized_userid>",1,55020,8975,"Geert Wilders (PVV)",0.972686290108724,0.853136882129278,0
"<anonymized_userid>",1,55021,8976,"Geert Wilders (PVV)",0.972703968885353,0.853231939163498,0
"<anonymized_userid>",1,55022,8977,"Geert Wilders (PVV)",0.972721647661982,0.853326996197719,0
"<anonymized_userid>",1,55023,8978,"Geert Wilders (PVV)",0.97273932643861,0.853422053231939,0
"<anonymized_userid>",1,55024,8979,"Geert Wilders (PVV)",0.972757005215239,0.85351711026616,0
"<anonymized_userid>",1,55025,8980,"Geert Wilders (PVV)",0.972774683991868,0.85361216730038,0
"<anonymized_userid>",1,55026,8981,"Geert Wilders (PVV)",0.972792362768496,0.853707224334601,0
"<anonymized_userid>",1,55027,8982,"Geert Wilders (PVV)",0.972810041545125,0.853802281368821,0
"<anonymized_userid>",1,55028,8983,"Geert Wilders (PVV)",0.972827720321754,0.853897338403042,0
"<anonymized_userid>",1,55029,8984,"Geert Wilders (PVV)",0.972845399098382,0.853992395437262,0
"<anonymized_userid>",1,55030,8985,"Geert Wilders (PVV)",0.972863077875011,0.854087452471483,0
"<anonymized_userid>",1,55031,8986,"Geert Wilders (PVV)",0.97288075665164,0.854182509505703,0
"<anonymized_userid>",1,55032,8987,"Geert Wilders (PVV)",0.972898435428268,0.854277566539924,0
"<anonymized_userid>",1,55033,8988,"Geert Wilders (PVV)",0.972916114204897,0.854372623574144,0
"<anonymized_userid>",1,55034,8989,"Geert Wilders (PVV)",0.972933792981526,0.854467680608365,0
"<anonymized_userid>",1,55035,8990,"Geert Wilders (PVV)",0.972951471758154,0.854562737642586,0
"<anonymized_userid>",1,55036,8991,"Geert Wilders (PVV)",0.972969150534783,0.854657794676806,0
"<anonymized_userid>",1,55037,8992,"Geert Wilders (PVV)",0.972986829311412,0.854752851711027,0
"<anonymized_userid>",1,55038,8993,"Geert Wilders (PVV)",0.97300450808804,0.854847908745247,0
"<anonymized_userid>",1,55039,8994,"Geert Wilders (PVV)",0.973022186864669,0.854942965779468,0
"<anonymized_userid>",1,55040,8995,"Geert Wilders (PVV)",0.973039865641298,0.855038022813688,0
"<anonymized_userid>",1,55041,8996,"Geert Wilders (PVV)",0.973057544417926,0.855133079847909,0
"<anonymized_userid>",1,55042,8997,"Geert Wilders (PVV)",0.973075223194555,0.855228136882129,0
"<anonymized_userid>",1,55043,8998,"Geert Wilders (PVV)",0.973092901971184,0.85532319391635,0
"<anonymized_userid>",1,55044,8999,"Geert Wilders (PVV)",0.973110580747812,0.85541825095057,0
"<anonymized_userid>",1,55045,9000,"Geert Wilders (PVV)",0.973128259524441,0.855513307984791,0
"<anonymized_userid>",1,55046,9001,"Geert Wilders (PVV)",0.97314593830107,0.855608365019011,0
"<anonymized_userid>",1,55047,9002,"Geert Wilders (PVV)",0.973163617077698,0.855703422053232,0
"<anonymized_userid>",1,55048,9003,"Geert Wilders (PVV)",0.973181295854327,0.855798479087452,0
"<anonymized_userid>",1,55049,9004,"Geert Wilders (PVV)",0.973198974630956,0.855893536121673,0
"<anonymized_userid>",1,55050,9005,"Geert Wilders (PVV)",0.973216653407584,0.855988593155893,0
"<anonymized_userid>",1,55051,9006,"Geert Wilders (PVV)",0.973234332184213,0.856083650190114,0
"<anonymized_userid>",1,55052,9007,"Geert Wilders (PVV)",0.973252010960841,0.856178707224335,0
"<anonymized_userid>",1,55053,9008,"Geert Wilders (PVV)",0.97326968973747,0.856273764258555,0
"<anonymized_userid>",1,55054,9009,"Geert Wilders (PVV)",0.973287368514099,0.856368821292776,0
"<anonymized_userid>",1,55055,9010,"Geert Wilders (PVV)",0.973305047290728,0.856463878326996,0
"<anonymized_userid>",1,55056,9011,"Geert Wilders (PVV)",0.973322726067356,0.856558935361217,0
"<anonymized_userid>",1,55057,9012,"Geert Wilders (PVV)",0.973340404843985,0.856653992395437,0
"<anonymized_userid>",1,55058,9013,"Geert Wilders (PVV)",0.973358083620613,0.856749049429658,0
"<anonymized_userid>",1,55059,9014,"Geert Wilders (PVV)",0.973375762397242,0.856844106463878,0
"<anonymized_userid>",1,55060,9015,"Geert Wilders (PVV)",0.973393441173871,0.856939163498099,0
"<anonymized_userid>",1,55061,9016,"Geert Wilders (PVV)",0.973411119950499,0.857034220532319,0
"<anonymized_userid>",1,55062,9017,"Geert Wilders (PVV)",0.973428798727128,0.85712927756654,0
"<anonymized_userid>",1,55063,9018,"Geert Wilders (PVV)",0.973446477503757,0.85722433460076,0
"<anonymized_userid>",1,55064,9019,"Geert Wilders (PVV)",0.973464156280385,0.857319391634981,0
"<anonymized_userid>",1,55065,9020,"Geert Wilders (PVV)",0.973481835057014,0.857414448669201,0
"<anonymized_userid>",1,55066,9021,"Geert Wilders (PVV)",0.973499513833643,0.857509505703422,0
"<anonymized_userid>",1,55067,9022,"Geert Wilders (PVV)",0.973517192610271,0.857604562737643,0
"<anonymized_userid>",1,55068,9023,"Geert Wilders (PVV)",0.9735348713869,0.857699619771863,0
"<anonymized_userid>",1,55069,9024,"Geert Wilders (PVV)",0.973552550163529,0.857794676806084,0
"<anonymized_userid>",1,55070,9025,"Geert Wilders (PVV)",0.973570228940157,0.857889733840304,0
"<anonymized_userid>",1,55071,9026,"Geert Wilders (PVV)",0.973587907716786,0.857984790874525,0
"<anonymized_userid>",1,55072,9027,"Geert Wilders (PVV)",0.973605586493415,0.858079847908745,0
"<anonymized_userid>",1,55073,9028,"Geert Wilders (PVV)",0.973623265270043,0.858174904942966,0
"<anonymized_userid>",1,55074,9029,"Geert Wilders (PVV)",0.973640944046672,0.858269961977186,0
"<anonymized_userid>",1,55075,9030,"Geert Wilders (PVV)",0.973658622823301,0.858365019011407,0
"<anonymized_userid>",1,55076,9031,"Geert Wilders (PVV)",0.973676301599929,0.858460076045627,0
"<anonymized_userid>",1,55077,9032,"Geert Wilders (PVV)",0.973693980376558,0.858555133079848,0
"<anonymized_userid>",1,55078,9033,"Geert Wilders (PVV)",0.973711659153187,0.858650190114068,0
"<anonymized_userid>",1,55079,9034,"Geert Wilders (PVV)",0.973729337929815,0.858745247148289,0
"<anonymized_userid>",1,55080,9035,"Geert Wilders (PVV)",0.973747016706444,0.858840304182509,0
"<anonymized_userid>",1,55081,9036,"Geert Wilders (PVV)",0.973764695483073,0.85893536121673,0
"<anonymized_userid>",1,55082,9037,"Geert Wilders (PVV)",0.973782374259701,0.859030418250951,0
"<anonymized_userid>",1,55083,9038,"Geert Wilders (PVV)",0.97380005303633,0.859125475285171,0
"<anonymized_userid>",1,55084,9039,"Geert Wilders (PVV)",0.973817731812958,0.859220532319392,0
"<anonymized_userid>",1,55085,9040,"Geert Wilders (PVV)",0.973835410589587,0.859315589353612,0
"<anonymized_userid>",1,55086,9041,"Geert Wilders (PVV)",0.973853089366216,0.859410646387833,0
"<anonymized_userid>",1,55087,9042,"Geert Wilders (PVV)",0.973870768142845,0.859505703422053,0
"<anonymized_userid>",1,55088,9043,"Geert Wilders (PVV)",0.973888446919473,0.859600760456274,0
"<anonymized_userid>",1,55089,9044,"Geert Wilders (PVV)",0.973906125696102,0.859695817490494,0
"<anonymized_userid>",1,55090,9045,"Geert Wilders (PVV)",0.973923804472731,0.859790874524715,0
"<anonymized_userid>",1,55091,9046,"Geert Wilders (PVV)",0.973941483249359,0.859885931558935,0
"<anonymized_userid>",1,55092,9047,"Geert Wilders (PVV)",0.973959162025988,0.859980988593156,0
"<anonymized_userid>",1,55093,9048,"Geert Wilders (PVV)",0.973976840802616,0.860076045627376,0
"<anonymized_userid>",1,55094,9049,"Geert Wilders (PVV)",0.973994519579245,0.860171102661597,0
"<anonymized_userid>",1,55095,9050,"Geert Wilders (PVV)",0.974012198355874,0.860266159695818,0
"<anonymized_userid>",1,55096,9051,"Geert Wilders (PVV)",0.974029877132502,0.860361216730038,0
"<anonymized_userid>",1,55097,9052,"Geert Wilders (PVV)",0.974047555909131,0.860456273764259,0
"<anonymized_userid>",1,55098,9053,"Geert Wilders (PVV)",0.97406523468576,0.860551330798479,0
"<anonymized_userid>",1,55099,9054,"Geert Wilders (PVV)",0.974082913462388,0.8606463878327,0
"<anonymized_userid>",1,55100,9055,"Geert Wilders (PVV)",0.974100592239017,0.86074144486692,0
"<anonymized_userid>",1,55101,9056,"Geert Wilders (PVV)",0.974118271015646,0.860836501901141,0
"<anonymized_userid>",1,55102,9057,"Geert Wilders (PVV)",0.974135949792274,0.860931558935361,0
"<anonymized_userid>",1,55103,9058,"Geert Wilders (PVV)",0.974153628568903,0.861026615969582,0
"<anonymized_userid>",1,55104,9059,"Geert Wilders (PVV)",0.974171307345532,0.861121673003802,0
"<anonymized_userid>",1,55105,9060,"Geert Wilders (PVV)",0.97418898612216,0.861216730038023,0
"<anonymized_userid>",1,55106,9061,"Geert Wilders (PVV)",0.974206664898789,0.861311787072243,0
"<anonymized_userid>",1,55107,9062,"Geert Wilders (PVV)",0.974224343675418,0.861406844106464,0
"<anonymized_userid>",1,55108,9063,"Geert Wilders (PVV)",0.974242022452046,0.861501901140684,0
"<anonymized_userid>",1,55109,9064,"Geert Wilders (PVV)",0.974259701228675,0.861596958174905,0
"<anonymized_userid>",1,55110,9065,"Geert Wilders (PVV)",0.974277380005304,0.861692015209126,0
"<anonymized_userid>",1,55111,9066,"Geert Wilders (PVV)",0.974295058781932,0.861787072243346,0
"<anonymized_userid>",1,55112,9067,"Geert Wilders (PVV)",0.974312737558561,0.861882129277567,0
"<anonymized_userid>",1,55113,9068,"Geert Wilders (PVV)",0.97433041633519,0.861977186311787,0
"<anonymized_userid>",1,55114,9069,"Geert Wilders (PVV)",0.974348095111818,0.862072243346008,0
"<anonymized_userid>",1,55115,9070,"Geert Wilders (PVV)",0.974365773888447,0.862167300380228,0
"<anonymized_userid>",1,55116,9071,"Geert Wilders (PVV)",0.974383452665076,0.862262357414449,0
"<anonymized_userid>",1,55117,9072,"Geert Wilders (PVV)",0.974401131441704,0.862357414448669,0
"<anonymized_userid>",1,55118,9073,"Geert Wilders (PVV)",0.974418810218333,0.86245247148289,0
"<anonymized_userid>",1,55119,9074,"Geert Wilders (PVV)",0.974436488994962,0.86254752851711,0
"<anonymized_userid>",1,55120,9075,"Geert Wilders (PVV)",0.97445416777159,0.862642585551331,0
"<anonymized_userid>",1,55121,9076,"Geert Wilders (PVV)",0.974471846548219,0.862737642585551,0
"<anonymized_userid>",1,55122,9077,"Geert Wilders (PVV)",0.974489525324848,0.862832699619772,0
"<anonymized_userid>",1,55123,9078,"Geert Wilders (PVV)",0.974507204101476,0.862927756653992,0
"<anonymized_userid>",1,55124,9079,"Geert Wilders (PVV)",0.974524882878105,0.863022813688213,0
"<anonymized_userid>",1,55125,9080,"Geert Wilders (PVV)",0.974542561654734,0.863117870722434,0
"<anonymized_userid>",1,55126,9081,"Geert Wilders (PVV)",0.974560240431362,0.863212927756654,0
"<anonymized_userid>",1,55127,9082,"Geert Wilders (PVV)",0.974577919207991,0.863307984790875,0
"<anonymized_userid>",1,55128,9083,"Geert Wilders (PVV)",0.974595597984619,0.863403041825095,0
"<anonymized_userid>",1,55129,9084,"Geert Wilders (PVV)",0.974613276761248,0.863498098859316,0
"<anonymized_userid>",1,55130,9085,"Geert Wilders (PVV)",0.974630955537877,0.863593155893536,0
"<anonymized_userid>",1,55131,9086,"Geert Wilders (PVV)",0.974648634314505,0.863688212927757,0
"<anonymized_userid>",1,55132,9087,"Geert Wilders (PVV)",0.974666313091134,0.863783269961977,0
"<anonymized_userid>",1,55133,9088,"Geert Wilders (PVV)",0.974683991867763,0.863878326996198,0
"<anonymized_userid>",1,55134,9089,"Geert Wilders (PVV)",0.974701670644391,0.863973384030418,0
"<anonymized_userid>",1,55135,9090,"Geert Wilders (PVV)",0.97471934942102,0.864068441064639,0
"<anonymized_userid>",1,55136,9091,"Geert Wilders (PVV)",0.974737028197649,0.864163498098859,0
"<anonymized_userid>",1,55137,9092,"Geert Wilders (PVV)",0.974754706974277,0.86425855513308,0
"<anonymized_userid>",1,55138,9093,"Geert Wilders (PVV)",0.974772385750906,0.8643536121673,0
"<anonymized_userid>",1,55139,9094,"Geert Wilders (PVV)",0.974790064527535,0.864448669201521,0
"<anonymized_userid>",1,55140,9095,"Geert Wilders (PVV)",0.974807743304163,0.864543726235741,0
"<anonymized_userid>",1,55141,9096,"Geert Wilders (PVV)",0.974825422080792,0.864638783269962,0
"<anonymized_userid>",1,55142,9097,"Geert Wilders (PVV)",0.974843100857421,0.864733840304183,0
"<anonymized_userid>",1,55143,9098,"Geert Wilders (PVV)",0.974860779634049,0.864828897338403,0
"<anonymized_userid>",1,55144,9099,"Geert Wilders (PVV)",0.974878458410678,0.864923954372624,0
"<anonymized_userid>",1,55145,9100,"Geert Wilders (PVV)",0.974896137187307,0.865019011406844,0
"<anonymized_userid>",1,55146,9101,"Geert Wilders (PVV)",0.974913815963935,0.865114068441065,0
"<anonymized_userid>",1,55147,9102,"Geert Wilders (PVV)",0.974931494740564,0.865209125475285,0
"<anonymized_userid>",1,55148,9103,"Geert Wilders (PVV)",0.974949173517193,0.865304182509506,0
"<anonymized_userid>",1,55149,9104,"Geert Wilders (PVV)",0.974966852293821,0.865399239543726,0
"<anonymized_userid>",1,55150,9105,"Geert Wilders (PVV)",0.97498453107045,0.865494296577947,0
"<anonymized_userid>",1,55151,9106,"Geert Wilders (PVV)",0.975002209847079,0.865589353612167,0
"<anonymized_userid>",1,55152,9107,"Geert Wilders (PVV)",0.975019888623707,0.865684410646388,0
"<anonymized_userid>",1,55153,9108,"Geert Wilders (PVV)",0.975037567400336,0.865779467680608,0
"<anonymized_userid>",1,55154,9109,"Geert Wilders (PVV)",0.975055246176965,0.865874524714829,0
"<anonymized_userid>",1,55155,9110,"Geert Wilders (PVV)",0.975072924953593,0.865969581749049,0
"<anonymized_userid>",1,55156,9111,"Geert Wilders (PVV)",0.975090603730222,0.86606463878327,0
"<anonymized_userid>",1,55157,9112,"Geert Wilders (PVV)",0.975108282506851,0.866159695817491,0
"<anonymized_userid>",1,55158,9113,"Geert Wilders (PVV)",0.975125961283479,0.866254752851711,0
"<anonymized_userid>",1,55159,9114,"Geert Wilders (PVV)",0.975143640060108,0.866349809885932,0
"<anonymized_userid>",1,55160,9115,"Geert Wilders (PVV)",0.975161318836737,0.866444866920152,0
"<anonymized_userid>",1,55161,9116,"Geert Wilders (PVV)",0.975178997613365,0.866539923954373,0
"<anonymized_userid>",1,55162,9117,"Geert Wilders (PVV)",0.975196676389994,0.866634980988593,0
"<anonymized_userid>",1,55163,9118,"Geert Wilders (PVV)",0.975214355166622,0.866730038022814,0
"<anonymized_userid>",1,55164,9119,"Geert Wilders (PVV)",0.975232033943251,0.866825095057034,0
"<anonymized_userid>",1,55165,9120,"Geert Wilders (PVV)",0.97524971271988,0.866920152091255,0
"<anonymized_userid>",1,55166,9121,"Geert Wilders (PVV)",0.975267391496508,0.867015209125475,0
"<anonymized_userid>",1,55167,9122,"Geert Wilders (PVV)",0.975285070273137,0.867110266159696,0
"<anonymized_userid>",1,55168,9123,"Geert Wilders (PVV)",0.975302749049766,0.867205323193916,0
"<anonymized_userid>",1,55169,9124,"Geert Wilders (PVV)",0.975320427826394,0.867300380228137,0
"<anonymized_userid>",1,55170,9125,"Geert Wilders (PVV)",0.975338106603023,0.867395437262357,0
"<anonymized_userid>",1,55171,9126,"Geert Wilders (PVV)",0.975355785379652,0.867490494296578,0
"<anonymized_userid>",1,55172,9127,"Geert Wilders (PVV)",0.97537346415628,0.867585551330799,0
"<anonymized_userid>",1,55173,9128,"Geert Wilders (PVV)",0.975391142932909,0.867680608365019,0
"<anonymized_userid>",1,55174,9129,"Geert Wilders (PVV)",0.975408821709538,0.86777566539924,0
"<anonymized_userid>",1,55175,9130,"Geert Wilders (PVV)",0.975426500486166,0.86787072243346,0
"<anonymized_userid>",1,55176,9131,"Geert Wilders (PVV)",0.975444179262795,0.867965779467681,0
"<anonymized_userid>",1,55177,9132,"Geert Wilders (PVV)",0.975461858039424,0.868060836501901,0
"<anonymized_userid>",1,55178,9133,"Geert Wilders (PVV)",0.975479536816052,0.868155893536122,0
"<anonymized_userid>",1,55179,9134,"Geert Wilders (PVV)",0.975497215592681,0.868250950570342,0
"<anonymized_userid>",1,55180,9135,"Geert Wilders (PVV)",0.97551489436931,0.868346007604563,0
"<anonymized_userid>",1,55181,9136,"Geert Wilders (PVV)",0.975532573145938,0.868441064638783,0
"<anonymized_userid>",1,55182,9137,"Geert Wilders (PVV)",0.975550251922567,0.868536121673004,0
"<anonymized_userid>",1,55183,9138,"Geert Wilders (PVV)",0.975567930699196,0.868631178707224,0
"<anonymized_userid>",1,55184,9139,"Geert Wilders (PVV)",0.975585609475824,0.868726235741445,0
"<anonymized_userid>",1,55185,9140,"Geert Wilders (PVV)",0.975603288252453,0.868821292775665,0
"<anonymized_userid>",1,55186,9141,"Geert Wilders (PVV)",0.975620967029082,0.868916349809886,0
"<anonymized_userid>",1,55187,9142,"Geert Wilders (PVV)",0.97563864580571,0.869011406844106,0
"<anonymized_userid>",1,55188,9143,"Geert Wilders (PVV)",0.975656324582339,0.869106463878327,0
"<anonymized_userid>",1,55189,9144,"Geert Wilders (PVV)",0.975674003358968,0.869201520912548,0
"<anonymized_userid>",1,55190,9145,"Geert Wilders (PVV)",0.975691682135596,0.869296577946768,0
"<anonymized_userid>",1,55191,9146,"Geert Wilders (PVV)",0.975709360912225,0.869391634980989,0
"<anonymized_userid>",1,55192,9147,"Geert Wilders (PVV)",0.975727039688854,0.869486692015209,0
"<anonymized_userid>",1,55193,9148,"Geert Wilders (PVV)",0.975744718465482,0.86958174904943,0
"<anonymized_userid>",1,55194,9149,"Geert Wilders (PVV)",0.975762397242111,0.86967680608365,0
"<anonymized_userid>",1,55195,9150,"Geert Wilders (PVV)",0.97578007601874,0.869771863117871,0
"<anonymized_userid>",1,55196,9151,"Geert Wilders (PVV)",0.975797754795368,0.869866920152091,0
"<anonymized_userid>",1,55197,9152,"Geert Wilders (PVV)",0.975815433571997,0.869961977186312,0
"<anonymized_userid>",1,55198,9153,"Geert Wilders (PVV)",0.975833112348625,0.870057034220532,0
"<anonymized_userid>",1,55199,9154,"Geert Wilders (PVV)",0.975850791125254,0.870152091254753,0
"<anonymized_userid>",1,55200,9155,"Geert Wilders (PVV)",0.975868469901883,0.870247148288973,0
"<anonymized_userid>",1,55201,9156,"Geert Wilders (PVV)",0.975886148678511,0.870342205323194,0
"<anonymized_userid>",1,55202,9157,"Geert Wilders (PVV)",0.97590382745514,0.870437262357414,0
"<anonymized_userid>",1,55203,9158,"Geert Wilders (PVV)",0.975921506231769,0.870532319391635,0
"<anonymized_userid>",1,55204,9159,"Geert Wilders (PVV)",0.975939185008397,0.870627376425856,0
"<anonymized_userid>",1,55205,9160,"Geert Wilders (PVV)",0.975956863785026,0.870722433460076,0
"<anonymized_userid>",1,55206,9161,"Geert Wilders (PVV)",0.975974542561655,0.870817490494297,0
"<anonymized_userid>",1,55207,9162,"Geert Wilders (PVV)",0.975992221338283,0.870912547528517,0
"<anonymized_userid>",1,55208,9163,"Geert Wilders (PVV)",0.976009900114912,0.871007604562738,0
"<anonymized_userid>",1,55209,9164,"Geert Wilders (PVV)",0.976027578891541,0.871102661596958,0
"<anonymized_userid>",1,55210,9165,"Geert Wilders (PVV)",0.976045257668169,0.871197718631179,0
"<anonymized_userid>",1,55211,9166,"Geert Wilders (PVV)",0.976062936444798,0.871292775665399,0
"<anonymized_userid>",1,55212,9167,"Geert Wilders (PVV)",0.976080615221427,0.87138783269962,0
"<anonymized_userid>",1,55213,9168,"Geert Wilders (PVV)",0.976098293998055,0.87148288973384,0
"<anonymized_userid>",1,55214,9169,"Geert Wilders (PVV)",0.976115972774684,0.871577946768061,0
"<anonymized_userid>",1,55215,9170,"Geert Wilders (PVV)",0.976133651551313,0.871673003802281,0
"<anonymized_userid>",1,55216,9171,"Geert Wilders (PVV)",0.976151330327941,0.871768060836502,0
"<anonymized_userid>",1,55217,9172,"Geert Wilders (PVV)",0.97616900910457,0.871863117870722,0
"<anonymized_userid>",1,55218,9173,"Geert Wilders (PVV)",0.976186687881199,0.871958174904943,0
"<anonymized_userid>",1,55219,9174,"Geert Wilders (PVV)",0.976204366657827,0.872053231939164,0
"<anonymized_userid>",1,55220,9175,"Geert Wilders (PVV)",0.976222045434456,0.872148288973384,0
"<anonymized_userid>",1,55221,9176,"Geert Wilders (PVV)",0.976239724211085,0.872243346007605,0
"<anonymized_userid>",1,55222,9177,"Geert Wilders (PVV)",0.976257402987713,0.872338403041825,0
"<anonymized_userid>",1,55223,9178,"Geert Wilders (PVV)",0.976275081764342,0.872433460076046,0
"<anonymized_userid>",1,55224,9179,"Geert Wilders (PVV)",0.976292760540971,0.872528517110266,0
"<anonymized_userid>",1,55225,9180,"Geert Wilders (PVV)",0.976310439317599,0.872623574144487,0
"<anonymized_userid>",1,55226,9181,"Geert Wilders (PVV)",0.976328118094228,0.872718631178707,0
"<anonymized_userid>",1,55227,9182,"Geert Wilders (PVV)",0.976345796870857,0.872813688212928,0
"<anonymized_userid>",1,55228,9183,"Geert Wilders (PVV)",0.976363475647485,0.872908745247148,0
"<anonymized_userid>",1,55229,9184,"Geert Wilders (PVV)",0.976381154424114,0.873003802281369,0
"<anonymized_userid>",1,55230,9185,"Geert Wilders (PVV)",0.976398833200742,0.873098859315589,0
"<anonymized_userid>",1,55231,9186,"Geert Wilders (PVV)",0.976416511977371,0.87319391634981,0
"<anonymized_userid>",1,55232,9187,"Geert Wilders (PVV)",0.976434190754,0.87328897338403,0
"<anonymized_userid>",1,55233,9188,"Geert Wilders (PVV)",0.976451869530628,0.873384030418251,0
"<anonymized_userid>",1,55234,9189,"Geert Wilders (PVV)",0.976469548307257,0.873479087452471,0
"<anonymized_userid>",1,55235,9190,"Geert Wilders (PVV)",0.976487227083886,0.873574144486692,0
"<anonymized_userid>",1,55236,9191,"Geert Wilders (PVV)",0.976504905860514,0.873669201520913,0
"<anonymized_userid>",1,55237,9192,"Geert Wilders (PVV)",0.976522584637143,0.873764258555133,0
"<anonymized_userid>",1,55238,9193,"Geert Wilders (PVV)",0.976540263413772,0.873859315589354,0
"<anonymized_userid>",1,55239,9194,"Geert Wilders (PVV)",0.9765579421904,0.873954372623574,0
"<anonymized_userid>",1,55240,9195,"Geert Wilders (PVV)",0.976575620967029,0.874049429657795,0
"<anonymized_userid>",1,55241,9196,"Geert Wilders (PVV)",0.976593299743658,0.874144486692015,0
"<anonymized_userid>",1,55242,9197,"Geert Wilders (PVV)",0.976610978520286,0.874239543726236,0
"<anonymized_userid>",1,55243,9198,"Geert Wilders (PVV)",0.976628657296915,0.874334600760456,0
"<anonymized_userid>",1,55244,9199,"Geert Wilders (PVV)",0.976646336073544,0.874429657794677,0
"<anonymized_userid>",1,55245,9200,"Geert Wilders (PVV)",0.976664014850172,0.874524714828897,0
"<anonymized_userid>",1,55246,9201,"Geert Wilders (PVV)",0.976681693626801,0.874619771863118,0
"<anonymized_userid>",1,55247,9202,"Geert Wilders (PVV)",0.97669937240343,0.874714828897338,0
"<anonymized_userid>",1,55248,9203,"Geert Wilders (PVV)",0.976717051180058,0.874809885931559,0
"<anonymized_userid>",1,55249,9204,"Geert Wilders (PVV)",0.976734729956687,0.874904942965779,0
"<anonymized_userid>",1,55250,9205,"Geert Wilders (PVV)",0.976752408733316,0.875,0
"<anonymized_userid>",1,55251,9206,"Geert Wilders (PVV)",0.976770087509944,0.875095057034221,0
"<anonymized_userid>",1,55252,9207,"Geert Wilders (PVV)",0.976787766286573,0.875190114068441,0
"<anonymized_userid>",1,55253,9208,"Geert Wilders (PVV)",0.976805445063202,0.875285171102662,0
"<anonymized_userid>",1,55254,9209,"Geert Wilders (PVV)",0.97682312383983,0.875380228136882,0
"<anonymized_userid>",1,55255,9210,"Geert Wilders (PVV)",0.976840802616459,0.875475285171103,0
"<anonymized_userid>",1,55256,9211,"Geert Wilders (PVV)",0.976858481393088,0.875570342205323,0
"<anonymized_userid>",1,55257,9212,"Geert Wilders (PVV)",0.976876160169716,0.875665399239544,0
"<anonymized_userid>",1,55258,9213,"Geert Wilders (PVV)",0.976893838946345,0.875760456273764,0
"<anonymized_userid>",1,55259,9214,"Geert Wilders (PVV)",0.976911517722974,0.875855513307985,0
"<anonymized_userid>",1,55260,9215,"Geert Wilders (PVV)",0.976929196499602,0.875950570342205,0
"<anonymized_userid>",1,55261,9216,"Geert Wilders (PVV)",0.976946875276231,0.876045627376426,0
"<anonymized_userid>",1,55262,9217,"Geert Wilders (PVV)",0.97696455405286,0.876140684410646,0
"<anonymized_userid>",1,55263,9218,"Geert Wilders (PVV)",0.976982232829488,0.876235741444867,0
"<anonymized_userid>",1,55264,9219,"Geert Wilders (PVV)",0.976999911606117,0.876330798479087,0
"<anonymized_userid>",1,55265,9220,"Geert Wilders (PVV)",0.977017590382745,0.876425855513308,0
"<anonymized_userid>",1,55266,9221,"Geert Wilders (PVV)",0.977035269159374,0.876520912547529,0
"<anonymized_userid>",1,55267,9222,"Geert Wilders (PVV)",0.977052947936003,0.876615969581749,0
"<anonymized_userid>",1,55268,9223,"Geert Wilders (PVV)",0.977070626712631,0.87671102661597,0
"<anonymized_userid>",1,55269,9224,"Geert Wilders (PVV)",0.97708830548926,0.87680608365019,0
"<anonymized_userid>",1,55270,9225,"Geert Wilders (PVV)",0.977105984265889,0.876901140684411,0
"<anonymized_userid>",1,55271,9226,"Geert Wilders (PVV)",0.977123663042517,0.876996197718631,0
"<anonymized_userid>",1,55272,9227,"Geert Wilders (PVV)",0.977141341819146,0.877091254752852,0
"<anonymized_userid>",1,55273,9228,"Geert Wilders (PVV)",0.977159020595775,0.877186311787072,0
"<anonymized_userid>",1,55274,9229,"Geert Wilders (PVV)",0.977176699372403,0.877281368821293,0
"<anonymized_userid>",1,55275,9230,"Geert Wilders (PVV)",0.977194378149032,0.877376425855513,0
"<anonymized_userid>",1,55276,9231,"Geert Wilders (PVV)",0.977212056925661,0.877471482889734,0
"<anonymized_userid>",1,55277,9232,"Geert Wilders (PVV)",0.977229735702289,0.877566539923954,0
"<anonymized_userid>",1,55278,9233,"Geert Wilders (PVV)",0.977247414478918,0.877661596958175,0
"<anonymized_userid>",1,55279,9234,"Geert Wilders (PVV)",0.977265093255547,0.877756653992395,0
"<anonymized_userid>",1,55280,9235,"Geert Wilders (PVV)",0.977282772032175,0.877851711026616,0
"<anonymized_userid>",1,55281,9236,"Geert Wilders (PVV)",0.977300450808804,0.877946768060836,0
"<anonymized_userid>",1,55282,9237,"Geert Wilders (PVV)",0.977318129585433,0.878041825095057,0
"<anonymized_userid>",1,55283,9238,"Geert Wilders (PVV)",0.977335808362061,0.878136882129278,0
"<anonymized_userid>",1,55284,9239,"Geert Wilders (PVV)",0.97735348713869,0.878231939163498,0
"<anonymized_userid>",1,55285,9240,"Geert Wilders (PVV)",0.977371165915319,0.878326996197719,0
"<anonymized_userid>",1,55286,9241,"Geert Wilders (PVV)",0.977388844691947,0.878422053231939,0
"<anonymized_userid>",1,55287,9242,"Geert Wilders (PVV)",0.977406523468576,0.87851711026616,0
"<anonymized_userid>",1,55288,9243,"Geert Wilders (PVV)",0.977424202245205,0.87861216730038,0
"<anonymized_userid>",1,55289,9244,"Geert Wilders (PVV)",0.977441881021833,0.878707224334601,0
"<anonymized_userid>",1,55290,9245,"Geert Wilders (PVV)",0.977459559798462,0.878802281368821,0
"<anonymized_userid>",1,55291,9246,"Geert Wilders (PVV)",0.977477238575091,0.878897338403042,0
"<anonymized_userid>",1,55292,9247,"Geert Wilders (PVV)",0.977494917351719,0.878992395437262,0
"<anonymized_userid>",1,55293,9248,"Geert Wilders (PVV)",0.977512596128348,0.879087452471483,0
"<anonymized_userid>",1,55294,9249,"Geert Wilders (PVV)",0.977530274904977,0.879182509505703,0
"<anonymized_userid>",1,55295,9250,"Geert Wilders (PVV)",0.977547953681605,0.879277566539924,0
"<anonymized_userid>",1,55296,9251,"Geert Wilders (PVV)",0.977565632458234,0.879372623574144,0
"<anonymized_userid>",1,55297,9252,"Geert Wilders (PVV)",0.977583311234863,0.879467680608365,0
"<anonymized_userid>",1,55298,9253,"Geert Wilders (PVV)",0.977600990011491,0.879562737642586,0
"<anonymized_userid>",1,55299,9254,"Geert Wilders (PVV)",0.97761866878812,0.879657794676806,0
"<anonymized_userid>",1,55300,9255,"Geert Wilders (PVV)",0.977636347564748,0.879752851711027,0
"<anonymized_userid>",1,55301,9256,"Geert Wilders (PVV)",0.977654026341377,0.879847908745247,0
"<anonymized_userid>",1,55302,9257,"Geert Wilders (PVV)",0.977671705118006,0.879942965779468,0
"<anonymized_userid>",1,55303,9258,"Geert Wilders (PVV)",0.977689383894634,0.880038022813688,0
"<anonymized_userid>",1,55304,9259,"Geert Wilders (PVV)",0.977707062671263,0.880133079847909,0
"<anonymized_userid>",1,55305,9260,"Geert Wilders (PVV)",0.977724741447892,0.880228136882129,0
"<anonymized_userid>",1,55306,9261,"Geert Wilders (PVV)",0.977742420224521,0.88032319391635,0
"<anonymized_userid>",1,55307,9262,"Geert Wilders (PVV)",0.977760099001149,0.88041825095057,0
"<anonymized_userid>",1,55308,9263,"Geert Wilders (PVV)",0.977777777777778,0.880513307984791,0
"<anonymized_userid>",1,55309,9264,"Geert Wilders (PVV)",0.977795456554406,0.880608365019011,0
"<anonymized_userid>",1,55310,9265,"Geert Wilders (PVV)",0.977813135331035,0.880703422053232,0
"<anonymized_userid>",1,55311,9266,"Geert Wilders (PVV)",0.977830814107664,0.880798479087452,0
"<anonymized_userid>",1,55312,9267,"Geert Wilders (PVV)",0.977848492884292,0.880893536121673,0
"<anonymized_userid>",1,55313,9268,"Geert Wilders (PVV)",0.977866171660921,0.880988593155894,0
"<anonymized_userid>",1,55314,9269,"Geert Wilders (PVV)",0.97788385043755,0.881083650190114,0
"<anonymized_userid>",1,55315,9270,"Geert Wilders (PVV)",0.977901529214178,0.881178707224335,0
"<anonymized_userid>",1,55316,9271,"Geert Wilders (PVV)",0.977919207990807,0.881273764258555,0
"<anonymized_userid>",1,55317,9272,"Geert Wilders (PVV)",0.977936886767436,0.881368821292776,0
"<anonymized_userid>",1,55318,9273,"Geert Wilders (PVV)",0.977954565544064,0.881463878326996,0
"<anonymized_userid>",1,55319,9274,"Geert Wilders (PVV)",0.977972244320693,0.881558935361217,0
"<anonymized_userid>",1,55320,9275,"Geert Wilders (PVV)",0.977989923097322,0.881653992395437,0
"<anonymized_userid>",1,55321,9276,"Geert Wilders (PVV)",0.97800760187395,0.881749049429658,0
"<anonymized_userid>",1,55322,9277,"Geert Wilders (PVV)",0.978025280650579,0.881844106463878,0
"<anonymized_userid>",1,55323,9278,"Geert Wilders (PVV)",0.978042959427208,0.881939163498099,0
"<anonymized_userid>",1,55324,9279,"Geert Wilders (PVV)",0.978060638203836,0.882034220532319,0
"<anonymized_userid>",1,55325,9280,"Geert Wilders (PVV)",0.978078316980465,0.88212927756654,0
"<anonymized_userid>",1,55326,9281,"Geert Wilders (PVV)",0.978095995757094,0.88222433460076,0
"<anonymized_userid>",1,55327,9282,"Geert Wilders (PVV)",0.978113674533722,0.882319391634981,0
"<anonymized_userid>",1,55328,9283,"Geert Wilders (PVV)",0.978131353310351,0.882414448669201,0
"<anonymized_userid>",1,55329,9284,"Geert Wilders (PVV)",0.97814903208698,0.882509505703422,0
"<anonymized_userid>",1,55330,9285,"Geert Wilders (PVV)",0.978166710863608,0.882604562737643,0
"<anonymized_userid>",1,55331,9286,"Geert Wilders (PVV)",0.978184389640237,0.882699619771863,0
"<anonymized_userid>",1,55332,9287,"Geert Wilders (PVV)",0.978202068416866,0.882794676806084,0
"<anonymized_userid>",1,55333,9288,"Geert Wilders (PVV)",0.978219747193494,0.882889733840304,0
"<anonymized_userid>",1,55334,9289,"Geert Wilders (PVV)",0.978237425970123,0.882984790874525,0
"<anonymized_userid>",1,55335,9290,"Geert Wilders (PVV)",0.978255104746751,0.883079847908745,0
"<anonymized_userid>",1,55336,9291,"Geert Wilders (PVV)",0.97827278352338,0.883174904942966,0
"<anonymized_userid>",1,55337,9292,"Geert Wilders (PVV)",0.978290462300009,0.883269961977186,0
"<anonymized_userid>",1,55338,9293,"Geert Wilders (PVV)",0.978308141076638,0.883365019011407,0
"<anonymized_userid>",1,55339,9294,"Geert Wilders (PVV)",0.978325819853266,0.883460076045627,0
"<anonymized_userid>",1,55340,9295,"Geert Wilders (PVV)",0.978343498629895,0.883555133079848,0
"<anonymized_userid>",1,55341,9296,"Geert Wilders (PVV)",0.978361177406524,0.883650190114068,0
"<anonymized_userid>",1,55342,9297,"Geert Wilders (PVV)",0.978378856183152,0.883745247148289,0
"<anonymized_userid>",1,55343,9298,"Geert Wilders (PVV)",0.978396534959781,0.883840304182509,0
"<anonymized_userid>",1,55344,9299,"Geert Wilders (PVV)",0.978414213736409,0.88393536121673,0
"<anonymized_userid>",1,55345,9300,"Geert Wilders (PVV)",0.978431892513038,0.884030418250951,0
"<anonymized_userid>",1,55346,9301,"Geert Wilders (PVV)",0.978449571289667,0.884125475285171,0
"<anonymized_userid>",1,55347,9302,"Geert Wilders (PVV)",0.978467250066295,0.884220532319392,0
"<anonymized_userid>",1,55348,9303,"Geert Wilders (PVV)",0.978484928842924,0.884315589353612,0
"<anonymized_userid>",1,55349,9304,"Geert Wilders (PVV)",0.978502607619553,0.884410646387833,0
"<anonymized_userid>",1,55350,9305,"Geert Wilders (PVV)",0.978520286396181,0.884505703422053,0
"<anonymized_userid>",1,55351,9306,"Geert Wilders (PVV)",0.97853796517281,0.884600760456274,0
"<anonymized_userid>",1,55352,9307,"Geert Wilders (PVV)",0.978555643949439,0.884695817490494,0
"<anonymized_userid>",1,55353,9308,"Geert Wilders (PVV)",0.978573322726067,0.884790874524715,0
"<anonymized_userid>",1,55354,9309,"Geert Wilders (PVV)",0.978591001502696,0.884885931558935,0
"<anonymized_userid>",1,55355,9310,"Geert Wilders (PVV)",0.978608680279325,0.884980988593156,0
"<anonymized_userid>",1,55356,9311,"Geert Wilders (PVV)",0.978626359055953,0.885076045627376,0
"<anonymized_userid>",1,55357,9312,"Geert Wilders (PVV)",0.978644037832582,0.885171102661597,0
"<anonymized_userid>",1,55358,9313,"Geert Wilders (PVV)",0.978661716609211,0.885266159695817,0
"<anonymized_userid>",1,55359,9314,"Geert Wilders (PVV)",0.978679395385839,0.885361216730038,0
"<anonymized_userid>",1,55360,9315,"Geert Wilders (PVV)",0.978697074162468,0.885456273764259,0
"<anonymized_userid>",1,55361,9316,"Geert Wilders (PVV)",0.978714752939097,0.885551330798479,0
"<anonymized_userid>",1,55362,9317,"Geert Wilders (PVV)",0.978732431715725,0.8856463878327,0
"<anonymized_userid>",1,55363,9318,"Geert Wilders (PVV)",0.978750110492354,0.88574144486692,0
"<anonymized_userid>",1,55364,9319,"Geert Wilders (PVV)",0.978767789268983,0.885836501901141,0
"<anonymized_userid>",1,55365,9320,"Geert Wilders (PVV)",0.978785468045611,0.885931558935361,0
"<anonymized_userid>",1,55366,9321,"Geert Wilders (PVV)",0.97880314682224,0.886026615969582,0
"<anonymized_userid>",1,55367,9322,"Geert Wilders (PVV)",0.978820825598869,0.886121673003802,0
"<anonymized_userid>",1,55368,9323,"Geert Wilders (PVV)",0.978838504375497,0.886216730038023,0
"<anonymized_userid>",1,55369,9324,"Geert Wilders (PVV)",0.978856183152126,0.886311787072243,0
"<anonymized_userid>",1,55370,9325,"Geert Wilders (PVV)",0.978873861928755,0.886406844106464,0
"<anonymized_userid>",1,55371,9326,"Geert Wilders (PVV)",0.978891540705383,0.886501901140684,0
"<anonymized_userid>",1,55372,9327,"Geert Wilders (PVV)",0.978909219482012,0.886596958174905,0
"<anonymized_userid>",1,55373,9328,"Geert Wilders (PVV)",0.978926898258641,0.886692015209125,0
"<anonymized_userid>",1,55374,9329,"Geert Wilders (PVV)",0.978944577035269,0.886787072243346,0
"<anonymized_userid>",1,55375,9330,"Geert Wilders (PVV)",0.978962255811898,0.886882129277566,0
"<anonymized_userid>",1,55376,9331,"Geert Wilders (PVV)",0.978979934588527,0.886977186311787,0
"<anonymized_userid>",1,55377,9332,"Geert Wilders (PVV)",0.978997613365155,0.887072243346008,0
"<anonymized_userid>",1,55378,9333,"Geert Wilders (PVV)",0.979015292141784,0.887167300380228,0
"<anonymized_userid>",1,55379,9334,"Geert Wilders (PVV)",0.979032970918412,0.887262357414449,0
"<anonymized_userid>",1,55380,9335,"Geert Wilders (PVV)",0.979050649695041,0.887357414448669,0
"<anonymized_userid>",1,55381,9336,"Geert Wilders (PVV)",0.97906832847167,0.88745247148289,0
"<anonymized_userid>",1,55382,9337,"Geert Wilders (PVV)",0.979086007248298,0.88754752851711,0
"<anonymized_userid>",1,55383,9338,"Geert Wilders (PVV)",0.979103686024927,0.887642585551331,0
"<anonymized_userid>",1,55384,9339,"Geert Wilders (PVV)",0.979121364801556,0.887737642585551,0
"<anonymized_userid>",1,55385,9340,"Geert Wilders (PVV)",0.979139043578184,0.887832699619772,0
"<anonymized_userid>",1,55386,9341,"Geert Wilders (PVV)",0.979156722354813,0.887927756653992,0
"<anonymized_userid>",1,55387,9342,"Geert Wilders (PVV)",0.979174401131442,0.888022813688213,0
"<anonymized_userid>",1,55388,9343,"Geert Wilders (PVV)",0.97919207990807,0.888117870722433,0
"<anonymized_userid>",1,55389,9344,"Geert Wilders (PVV)",0.979209758684699,0.888212927756654,0
"<anonymized_userid>",1,55390,9345,"Geert Wilders (PVV)",0.979227437461328,0.888307984790874,0
"<anonymized_userid>",1,55391,9346,"Geert Wilders (PVV)",0.979245116237956,0.888403041825095,0
"<anonymized_userid>",1,55392,9347,"Geert Wilders (PVV)",0.979262795014585,0.888498098859316,0
"<anonymized_userid>",1,55393,9348,"Geert Wilders (PVV)",0.979280473791214,0.888593155893536,0
"<anonymized_userid>",1,55394,9349,"Geert Wilders (PVV)",0.979298152567842,0.888688212927757,0
"<anonymized_userid>",1,55395,9350,"Geert Wilders (PVV)",0.979315831344471,0.888783269961977,0
"<anonymized_userid>",1,55396,9351,"Geert Wilders (PVV)",0.9793335101211,0.888878326996198,0
"<anonymized_userid>",1,55397,9352,"Geert Wilders (PVV)",0.979351188897728,0.888973384030418,0
"<anonymized_userid>",1,55398,9353,"Geert Wilders (PVV)",0.979368867674357,0.889068441064639,0
"<anonymized_userid>",1,55399,9354,"Geert Wilders (PVV)",0.979386546450986,0.889163498098859,0
"<anonymized_userid>",1,55400,9355,"Geert Wilders (PVV)",0.979404225227614,0.88925855513308,0
"<anonymized_userid>",1,55401,9356,"Geert Wilders (PVV)",0.979421904004243,0.8893536121673,0
"<anonymized_userid>",1,55402,9357,"Geert Wilders (PVV)",0.979439582780872,0.889448669201521,0
"<anonymized_userid>",1,55403,9358,"Geert Wilders (PVV)",0.9794572615575,0.889543726235741,0
"<anonymized_userid>",1,55404,9359,"Geert Wilders (PVV)",0.979474940334129,0.889638783269962,0
"<anonymized_userid>",1,55405,9360,"Geert Wilders (PVV)",0.979492619110758,0.889733840304182,0
"<anonymized_userid>",1,55406,9361,"Geert Wilders (PVV)",0.979510297887386,0.889828897338403,0
"<anonymized_userid>",1,55407,9362,"Geert Wilders (PVV)",0.979527976664015,0.889923954372624,0
"<anonymized_userid>",1,55408,9363,"Geert Wilders (PVV)",0.979545655440644,0.890019011406844,0
"<anonymized_userid>",1,55409,9364,"Geert Wilders (PVV)",0.979563334217272,0.890114068441065,0
"<anonymized_userid>",1,55410,9365,"Geert Wilders (PVV)",0.979581012993901,0.890209125475285,0
"<anonymized_userid>",1,55411,9366,"Geert Wilders (PVV)",0.979598691770529,0.890304182509506,0
"<anonymized_userid>",1,55412,9367,"Geert Wilders (PVV)",0.979616370547158,0.890399239543726,0
"<anonymized_userid>",1,55413,9368,"Geert Wilders (PVV)",0.979634049323787,0.890494296577947,0
"<anonymized_userid>",1,55414,9369,"Geert Wilders (PVV)",0.979651728100415,0.890589353612167,0
"<anonymized_userid>",1,55415,9370,"Geert Wilders (PVV)",0.979669406877044,0.890684410646388,0
"<anonymized_userid>",1,55416,9371,"Geert Wilders (PVV)",0.979687085653673,0.890779467680608,0
"<anonymized_userid>",1,55417,9372,"Geert Wilders (PVV)",0.979704764430301,0.890874524714829,0
"<anonymized_userid>",1,55418,9373,"Geert Wilders (PVV)",0.97972244320693,0.890969581749049,0
"<anonymized_userid>",1,55419,9374,"Geert Wilders (PVV)",0.979740121983559,0.89106463878327,0
"<anonymized_userid>",1,55420,9375,"Geert Wilders (PVV)",0.979757800760187,0.891159695817491,0
"<anonymized_userid>",1,55421,9376,"Geert Wilders (PVV)",0.979775479536816,0.891254752851711,0
"<anonymized_userid>",1,55422,9377,"Geert Wilders (PVV)",0.979793158313445,0.891349809885932,0
"<anonymized_userid>",1,55423,9378,"Geert Wilders (PVV)",0.979810837090073,0.891444866920152,0
"<anonymized_userid>",1,55424,9379,"Geert Wilders (PVV)",0.979828515866702,0.891539923954373,0
"<anonymized_userid>",1,55425,9380,"Geert Wilders (PVV)",0.979846194643331,0.891634980988593,0
"<anonymized_userid>",1,55426,9381,"Geert Wilders (PVV)",0.979863873419959,0.891730038022814,0
"<anonymized_userid>",1,55427,9382,"Geert Wilders (PVV)",0.979881552196588,0.891825095057034,0
"<anonymized_userid>",1,55428,9383,"Geert Wilders (PVV)",0.979899230973217,0.891920152091255,0
"<anonymized_userid>",1,55429,9384,"Geert Wilders (PVV)",0.979916909749845,0.892015209125475,0
"<anonymized_userid>",1,55430,9385,"Geert Wilders (PVV)",0.979934588526474,0.892110266159696,0
"<anonymized_userid>",1,55431,9386,"Geert Wilders (PVV)",0.979952267303103,0.892205323193916,0
"<anonymized_userid>",1,55432,9387,"Geert Wilders (PVV)",0.979969946079731,0.892300380228137,0
"<anonymized_userid>",1,55433,9388,"Geert Wilders (PVV)",0.97998762485636,0.892395437262357,0
"<anonymized_userid>",1,55434,9389,"Geert Wilders (PVV)",0.980005303632989,0.892490494296578,0
"<anonymized_userid>",1,55435,9390,"Geert Wilders (PVV)",0.980022982409617,0.892585551330799,0
"<anonymized_userid>",1,55436,9391,"Geert Wilders (PVV)",0.980040661186246,0.892680608365019,0
"<anonymized_userid>",1,55437,9392,"Geert Wilders (PVV)",0.980058339962875,0.89277566539924,0
"<anonymized_userid>",1,55438,9393,"Geert Wilders (PVV)",0.980076018739503,0.89287072243346,0
"<anonymized_userid>",1,55439,9394,"Geert Wilders (PVV)",0.980093697516132,0.892965779467681,0
"<anonymized_userid>",1,55440,9395,"Geert Wilders (PVV)",0.980111376292761,0.893060836501901,0
"<anonymized_userid>",1,55441,9396,"Geert Wilders (PVV)",0.980129055069389,0.893155893536122,0
"<anonymized_userid>",1,55442,9397,"Geert Wilders (PVV)",0.980146733846018,0.893250950570342,0
"<anonymized_userid>",1,55443,9398,"Geert Wilders (PVV)",0.980164412622647,0.893346007604563,0
"<anonymized_userid>",1,55444,9399,"Geert Wilders (PVV)",0.980182091399275,0.893441064638783,0
"<anonymized_userid>",1,55445,9400,"Geert Wilders (PVV)",0.980199770175904,0.893536121673004,0
"<anonymized_userid>",1,55446,9401,"Geert Wilders (PVV)",0.980217448952532,0.893631178707224,0
"<anonymized_userid>",1,55447,9402,"Geert Wilders (PVV)",0.980235127729161,0.893726235741445,0
"<anonymized_userid>",1,55448,9403,"Geert Wilders (PVV)",0.98025280650579,0.893821292775665,0
"<anonymized_userid>",1,55449,9404,"Geert Wilders (PVV)",0.980270485282418,0.893916349809886,0
"<anonymized_userid>",1,55450,9405,"Geert Wilders (PVV)",0.980288164059047,0.894011406844107,0
"<anonymized_userid>",1,55451,9406,"Geert Wilders (PVV)",0.980305842835676,0.894106463878327,0
"<anonymized_userid>",1,55452,9407,"Geert Wilders (PVV)",0.980323521612304,0.894201520912548,0
"<anonymized_userid>",1,55453,9408,"Geert Wilders (PVV)",0.980341200388933,0.894296577946768,0
"<anonymized_userid>",1,55454,9409,"Geert Wilders (PVV)",0.980358879165562,0.894391634980989,0
"<anonymized_userid>",1,55455,9410,"Geert Wilders (PVV)",0.98037655794219,0.894486692015209,0
"<anonymized_userid>",1,55456,9411,"Geert Wilders (PVV)",0.980394236718819,0.89458174904943,0
"<anonymized_userid>",1,55457,9412,"Geert Wilders (PVV)",0.980411915495448,0.89467680608365,0
"<anonymized_userid>",1,55458,9413,"Geert Wilders (PVV)",0.980429594272076,0.894771863117871,0
"<anonymized_userid>",1,55459,9414,"Geert Wilders (PVV)",0.980447273048705,0.894866920152091,0
"<anonymized_userid>",1,55460,9415,"Geert Wilders (PVV)",0.980464951825334,0.894961977186312,0
"<anonymized_userid>",1,55461,9416,"Geert Wilders (PVV)",0.980482630601962,0.895057034220532,0
"<anonymized_userid>",1,55462,9417,"Geert Wilders (PVV)",0.980500309378591,0.895152091254753,0
"<anonymized_userid>",1,55463,9418,"Geert Wilders (PVV)",0.98051798815522,0.895247148288973,0
"<anonymized_userid>",1,55464,9419,"Geert Wilders (PVV)",0.980535666931848,0.895342205323194,0
"<anonymized_userid>",1,55465,9420,"Geert Wilders (PVV)",0.980553345708477,0.895437262357414,0
"<anonymized_userid>",1,55466,9421,"Geert Wilders (PVV)",0.980571024485106,0.895532319391635,0
"<anonymized_userid>",1,55467,9422,"Geert Wilders (PVV)",0.980588703261734,0.895627376425856,0
"<anonymized_userid>",1,55468,9423,"Geert Wilders (PVV)",0.980606382038363,0.895722433460076,0
"<anonymized_userid>",1,55469,9424,"Geert Wilders (PVV)",0.980624060814992,0.895817490494297,0
"<anonymized_userid>",1,55470,9425,"Geert Wilders (PVV)",0.98064173959162,0.895912547528517,0
"<anonymized_userid>",1,55471,9426,"Geert Wilders (PVV)",0.980659418368249,0.896007604562738,0
"<anonymized_userid>",1,55472,9427,"Geert Wilders (PVV)",0.980677097144878,0.896102661596958,0
"<anonymized_userid>",1,55473,9428,"Geert Wilders (PVV)",0.980694775921506,0.896197718631179,0
"<anonymized_userid>",1,55474,9429,"Geert Wilders (PVV)",0.980712454698135,0.896292775665399,0
"<anonymized_userid>",1,55475,9430,"Geert Wilders (PVV)",0.980730133474764,0.89638783269962,0
"<anonymized_userid>",1,55476,9431,"Geert Wilders (PVV)",0.980747812251392,0.89648288973384,0
"<anonymized_userid>",1,55477,9432,"Geert Wilders (PVV)",0.980765491028021,0.896577946768061,0
"<anonymized_userid>",1,55478,9433,"Geert Wilders (PVV)",0.98078316980465,0.896673003802281,0
"<anonymized_userid>",1,55479,9434,"Geert Wilders (PVV)",0.980800848581278,0.896768060836502,0
"<anonymized_userid>",1,55480,9435,"Geert Wilders (PVV)",0.980818527357907,0.896863117870722,0
"<anonymized_userid>",1,55481,9436,"Geert Wilders (PVV)",0.980836206134535,0.896958174904943,0
"<anonymized_userid>",1,55482,9437,"Geert Wilders (PVV)",0.980853884911164,0.897053231939164,0
"<anonymized_userid>",1,55483,9438,"Geert Wilders (PVV)",0.980871563687793,0.897148288973384,0
"<anonymized_userid>",1,55484,9439,"Geert Wilders (PVV)",0.980889242464421,0.897243346007605,0
"<anonymized_userid>",1,55485,9440,"Geert Wilders (PVV)",0.98090692124105,0.897338403041825,0
"<anonymized_userid>",1,55486,9441,"Geert Wilders (PVV)",0.980924600017679,0.897433460076046,0
"<anonymized_userid>",1,55487,9442,"Geert Wilders (PVV)",0.980942278794307,0.897528517110266,0
"<anonymized_userid>",1,55488,9443,"Geert Wilders (PVV)",0.980959957570936,0.897623574144487,0
"<anonymized_userid>",1,55489,9444,"Geert Wilders (PVV)",0.980977636347565,0.897718631178707,0
"<anonymized_userid>",1,55490,9445,"Geert Wilders (PVV)",0.980995315124193,0.897813688212928,0
"<anonymized_userid>",1,55491,9446,"Geert Wilders (PVV)",0.981012993900822,0.897908745247148,0
"<anonymized_userid>",1,55492,9447,"Geert Wilders (PVV)",0.981030672677451,0.898003802281369,0
"<anonymized_userid>",1,55493,9448,"Geert Wilders (PVV)",0.981048351454079,0.898098859315589,0
"<anonymized_userid>",1,55494,9449,"Geert Wilders (PVV)",0.981066030230708,0.89819391634981,0
"<anonymized_userid>",1,55495,9450,"Geert Wilders (PVV)",0.981083709007337,0.89828897338403,0
"<anonymized_userid>",1,55496,9451,"Geert Wilders (PVV)",0.981101387783965,0.898384030418251,0
"<anonymized_userid>",1,55497,9452,"Geert Wilders (PVV)",0.981119066560594,0.898479087452472,0
"<anonymized_userid>",1,55498,9453,"Geert Wilders (PVV)",0.981136745337223,0.898574144486692,0
"<anonymized_userid>",1,55499,9454,"Geert Wilders (PVV)",0.981154424113851,0.898669201520913,0
"<anonymized_userid>",1,55500,9455,"Geert Wilders (PVV)",0.98117210289048,0.898764258555133,0
"<anonymized_userid>",1,55501,9456,"Geert Wilders (PVV)",0.981189781667109,0.898859315589354,0
"<anonymized_userid>",1,55502,9457,"Geert Wilders (PVV)",0.981207460443737,0.898954372623574,0
"<anonymized_userid>",1,55503,9458,"Geert Wilders (PVV)",0.981225139220366,0.899049429657795,0
"<anonymized_userid>",1,55504,9459,"Geert Wilders (PVV)",0.981242817996995,0.899144486692015,0
"<anonymized_userid>",1,55505,9460,"Geert Wilders (PVV)",0.981260496773623,0.899239543726236,0
"<anonymized_userid>",1,55506,9461,"Geert Wilders (PVV)",0.981278175550252,0.899334600760456,0
"<anonymized_userid>",1,55507,9462,"Geert Wilders (PVV)",0.981295854326881,0.899429657794677,0
"<anonymized_userid>",1,55508,9463,"Geert Wilders (PVV)",0.981313533103509,0.899524714828897,0
"<anonymized_userid>",1,55509,9464,"Geert Wilders (PVV)",0.981331211880138,0.899619771863118,0
"<anonymized_userid>",1,55510,9465,"Geert Wilders (PVV)",0.981348890656767,0.899714828897338,0
"<anonymized_userid>",1,55511,9466,"Geert Wilders (PVV)",0.981366569433395,0.899809885931559,0
"<anonymized_userid>",1,55512,9467,"Geert Wilders (PVV)",0.981384248210024,0.899904942965779,0
"<anonymized_userid>",1,55513,9468,"Geert Wilders (PVV)",0.981401926986653,0.9,0
"<anonymized_userid>",1,55514,9469,"Geert Wilders (PVV)",0.981419605763281,0.900095057034221,0
"<anonymized_userid>",1,55515,9470,"Geert Wilders (PVV)",0.98143728453991,0.900190114068441,0
"<anonymized_userid>",1,55516,9471,"Geert Wilders (PVV)",0.981454963316538,0.900285171102662,0
"<anonymized_userid>",1,55517,9472,"Geert Wilders (PVV)",0.981472642093167,0.900380228136882,0
"<anonymized_userid>",1,55518,9473,"Geert Wilders (PVV)",0.981490320869796,0.900475285171103,0
"<anonymized_userid>",1,55519,9474,"Geert Wilders (PVV)",0.981507999646424,0.900570342205323,0
"<anonymized_userid>",1,55520,9475,"Geert Wilders (PVV)",0.981525678423053,0.900665399239544,0
"<anonymized_userid>",1,55521,9476,"Geert Wilders (PVV)",0.981543357199682,0.900760456273764,0
"<anonymized_userid>",1,55522,9477,"Geert Wilders (PVV)",0.98156103597631,0.900855513307985,0
"<anonymized_userid>",1,55523,9478,"Geert Wilders (PVV)",0.981578714752939,0.900950570342205,0
"<anonymized_userid>",1,55524,9479,"Geert Wilders (PVV)",0.981596393529568,0.901045627376426,0
"<anonymized_userid>",1,55525,9480,"Geert Wilders (PVV)",0.981614072306196,0.901140684410646,0
"<anonymized_userid>",1,55526,9481,"Geert Wilders (PVV)",0.981631751082825,0.901235741444867,0
"<anonymized_userid>",1,55527,9482,"Geert Wilders (PVV)",0.981649429859454,0.901330798479087,0
"<anonymized_userid>",1,55528,9483,"Geert Wilders (PVV)",0.981667108636082,0.901425855513308,0
"<anonymized_userid>",1,55529,9484,"Geert Wilders (PVV)",0.981684787412711,0.901520912547529,0
"<anonymized_userid>",1,55530,9485,"Geert Wilders (PVV)",0.98170246618934,0.901615969581749,0
"<anonymized_userid>",1,55531,9486,"Geert Wilders (PVV)",0.981720144965968,0.90171102661597,0
"<anonymized_userid>",1,55532,9487,"Geert Wilders (PVV)",0.981737823742597,0.90180608365019,0
"<anonymized_userid>",1,55533,9488,"Geert Wilders (PVV)",0.981755502519226,0.901901140684411,0
"<anonymized_userid>",1,55534,9489,"Geert Wilders (PVV)",0.981773181295854,0.901996197718631,0
"<anonymized_userid>",1,55535,9490,"Geert Wilders (PVV)",0.981790860072483,0.902091254752852,0
"<anonymized_userid>",1,55536,9491,"Geert Wilders (PVV)",0.981808538849112,0.902186311787072,0
"<anonymized_userid>",1,55537,9492,"Geert Wilders (PVV)",0.98182621762574,0.902281368821293,0
"<anonymized_userid>",1,55538,9493,"Geert Wilders (PVV)",0.981843896402369,0.902376425855513,0
"<anonymized_userid>",1,55539,9494,"Geert Wilders (PVV)",0.981861575178998,0.902471482889734,0
"<anonymized_userid>",1,55540,9495,"Geert Wilders (PVV)",0.981879253955626,0.902566539923954,0
"<anonymized_userid>",1,55541,9496,"Geert Wilders (PVV)",0.981896932732255,0.902661596958175,0
"<anonymized_userid>",1,55542,9497,"Geert Wilders (PVV)",0.981914611508884,0.902756653992395,0
"<anonymized_userid>",1,55543,9498,"Geert Wilders (PVV)",0.981932290285512,0.902851711026616,0
"<anonymized_userid>",1,55544,9499,"Geert Wilders (PVV)",0.981949969062141,0.902946768060837,0
"<anonymized_userid>",1,55545,9500,"Geert Wilders (PVV)",0.98196764783877,0.903041825095057,0
"<anonymized_userid>",1,55546,9501,"Geert Wilders (PVV)",0.981985326615398,0.903136882129278,0
"<anonymized_userid>",1,55547,9502,"Geert Wilders (PVV)",0.982003005392027,0.903231939163498,0
"<anonymized_userid>",1,55548,9503,"Geert Wilders (PVV)",0.982020684168656,0.903326996197719,0
"<anonymized_userid>",1,55549,9504,"Geert Wilders (PVV)",0.982038362945284,0.903422053231939,0
"<anonymized_userid>",1,55550,9505,"Geert Wilders (PVV)",0.982056041721913,0.90351711026616,0
"<anonymized_userid>",1,55551,9506,"Geert Wilders (PVV)",0.982073720498541,0.90361216730038,0
"<anonymized_userid>",1,55552,9507,"Geert Wilders (PVV)",0.98209139927517,0.903707224334601,0
"<anonymized_userid>",1,55553,9508,"Geert Wilders (PVV)",0.982109078051799,0.903802281368821,0
"<anonymized_userid>",1,55554,9509,"Geert Wilders (PVV)",0.982126756828427,0.903897338403042,0
"<anonymized_userid>",1,55555,9510,"Geert Wilders (PVV)",0.982144435605056,0.903992395437262,0
"<anonymized_userid>",1,55556,9511,"Geert Wilders (PVV)",0.982162114381685,0.904087452471483,0
"<anonymized_userid>",1,55557,9512,"Geert Wilders (PVV)",0.982179793158313,0.904182509505703,0
"<anonymized_userid>",1,55558,9513,"Geert Wilders (PVV)",0.982197471934942,0.904277566539924,0
"<anonymized_userid>",1,55559,9514,"Geert Wilders (PVV)",0.982215150711571,0.904372623574144,0
"<anonymized_userid>",1,55560,9515,"Geert Wilders (PVV)",0.982232829488199,0.904467680608365,0
"<anonymized_userid>",1,55561,9516,"Geert Wilders (PVV)",0.982250508264828,0.904562737642586,0
"<anonymized_userid>",1,55562,9517,"Geert Wilders (PVV)",0.982268187041457,0.904657794676806,0
"<anonymized_userid>",1,55563,9518,"Geert Wilders (PVV)",0.982285865818085,0.904752851711027,0
"<anonymized_userid>",1,55564,9519,"Geert Wilders (PVV)",0.982303544594714,0.904847908745247,0
"<anonymized_userid>",1,55565,9520,"Geert Wilders (PVV)",0.982321223371343,0.904942965779468,0
"<anonymized_userid>",1,55566,9521,"Geert Wilders (PVV)",0.982338902147971,0.905038022813688,0
"<anonymized_userid>",1,55567,9522,"Geert Wilders (PVV)",0.9823565809246,0.905133079847909,0
"<anonymized_userid>",1,55568,9523,"Geert Wilders (PVV)",0.982374259701229,0.905228136882129,0
"<anonymized_userid>",1,55569,9524,"Geert Wilders (PVV)",0.982391938477857,0.90532319391635,0
"<anonymized_userid>",1,55570,9525,"Geert Wilders (PVV)",0.982409617254486,0.90541825095057,0
"<anonymized_userid>",1,55571,9526,"Geert Wilders (PVV)",0.982427296031115,0.905513307984791,0
"<anonymized_userid>",1,55572,9527,"Geert Wilders (PVV)",0.982444974807743,0.905608365019011,0
"<anonymized_userid>",1,55573,9528,"Geert Wilders (PVV)",0.982462653584372,0.905703422053232,0
"<anonymized_userid>",1,55574,9529,"Geert Wilders (PVV)",0.982480332361001,0.905798479087452,0
"<anonymized_userid>",1,55575,9530,"Geert Wilders (PVV)",0.982498011137629,0.905893536121673,0
"<anonymized_userid>",1,55576,9531,"Geert Wilders (PVV)",0.982515689914258,0.905988593155894,0
"<anonymized_userid>",1,55577,9532,"Geert Wilders (PVV)",0.982533368690887,0.906083650190114,0
"<anonymized_userid>",1,55578,9533,"Geert Wilders (PVV)",0.982551047467515,0.906178707224335,0
"<anonymized_userid>",1,55579,9534,"Geert Wilders (PVV)",0.982568726244144,0.906273764258555,0
"<anonymized_userid>",1,55580,9535,"Geert Wilders (PVV)",0.982586405020773,0.906368821292776,0
"<anonymized_userid>",1,55581,9536,"Geert Wilders (PVV)",0.982604083797401,0.906463878326996,0
"<anonymized_userid>",1,55582,9537,"Geert Wilders (PVV)",0.98262176257403,0.906558935361217,0
"<anonymized_userid>",1,55583,9538,"Geert Wilders (PVV)",0.982639441350659,0.906653992395437,0
"<anonymized_userid>",1,55584,9539,"Geert Wilders (PVV)",0.982657120127287,0.906749049429658,0
"<anonymized_userid>",1,55585,9540,"Geert Wilders (PVV)",0.982674798903916,0.906844106463878,0
"<anonymized_userid>",1,55586,9541,"Geert Wilders (PVV)",0.982692477680544,0.906939163498099,0
"<anonymized_userid>",1,55587,9542,"Geert Wilders (PVV)",0.982710156457173,0.907034220532319,0
"<anonymized_userid>",1,55588,9543,"Geert Wilders (PVV)",0.982727835233802,0.90712927756654,0
"<anonymized_userid>",1,55589,9544,"Geert Wilders (PVV)",0.982745514010431,0.90722433460076,0
"<anonymized_userid>",1,55590,9545,"Geert Wilders (PVV)",0.982763192787059,0.907319391634981,0
"<anonymized_userid>",1,55591,9546,"Geert Wilders (PVV)",0.982780871563688,0.907414448669202,0
"<anonymized_userid>",1,55592,9547,"Geert Wilders (PVV)",0.982798550340316,0.907509505703422,0
"<anonymized_userid>",1,55593,9548,"Geert Wilders (PVV)",0.982816229116945,0.907604562737643,0
"<anonymized_userid>",1,55594,9549,"Geert Wilders (PVV)",0.982833907893574,0.907699619771863,0
"<anonymized_userid>",1,55595,9550,"Geert Wilders (PVV)",0.982851586670202,0.907794676806084,0
"<anonymized_userid>",1,55596,9551,"Geert Wilders (PVV)",0.982869265446831,0.907889733840304,0
"<anonymized_userid>",1,55597,9552,"Geert Wilders (PVV)",0.98288694422346,0.907984790874525,0
"<anonymized_userid>",1,55598,9553,"Geert Wilders (PVV)",0.982904623000088,0.908079847908745,0
"<anonymized_userid>",1,55599,9554,"Geert Wilders (PVV)",0.982922301776717,0.908174904942966,0
"<anonymized_userid>",1,55600,9555,"Geert Wilders (PVV)",0.982939980553346,0.908269961977186,0
"<anonymized_userid>",1,55601,9556,"Geert Wilders (PVV)",0.982957659329974,0.908365019011407,0
"<anonymized_userid>",1,55602,9557,"Geert Wilders (PVV)",0.982975338106603,0.908460076045627,0
"<anonymized_userid>",1,55603,9558,"Geert Wilders (PVV)",0.982993016883232,0.908555133079848,0
"<anonymized_userid>",1,55604,9559,"Geert Wilders (PVV)",0.98301069565986,0.908650190114068,0
"<anonymized_userid>",1,55605,9560,"Geert Wilders (PVV)",0.983028374436489,0.908745247148289,0
"<anonymized_userid>",1,55606,9561,"Geert Wilders (PVV)",0.983046053213118,0.908840304182509,0
"<anonymized_userid>",1,55607,9562,"Geert Wilders (PVV)",0.983063731989746,0.90893536121673,0
"<anonymized_userid>",1,55608,9563,"Geert Wilders (PVV)",0.983081410766375,0.909030418250951,0
"<anonymized_userid>",1,55609,9564,"Geert Wilders (PVV)",0.983099089543004,0.909125475285171,0
"<anonymized_userid>",1,55610,9565,"Geert Wilders (PVV)",0.983116768319632,0.909220532319392,0
"<anonymized_userid>",1,55611,9566,"Geert Wilders (PVV)",0.983134447096261,0.909315589353612,0
"<anonymized_userid>",1,55612,9567,"Geert Wilders (PVV)",0.98315212587289,0.909410646387833,0
"<anonymized_userid>",1,55613,9568,"Geert Wilders (PVV)",0.983169804649518,0.909505703422053,0
"<anonymized_userid>",1,55614,9569,"Geert Wilders (PVV)",0.983187483426147,0.909600760456274,0
"<anonymized_userid>",1,55615,9570,"Geert Wilders (PVV)",0.983205162202776,0.909695817490494,0
"<anonymized_userid>",1,55616,9571,"Geert Wilders (PVV)",0.983222840979404,0.909790874524715,0
"<anonymized_userid>",1,55617,9572,"Geert Wilders (PVV)",0.983240519756033,0.909885931558935,0
"<anonymized_userid>",1,55618,9573,"Geert Wilders (PVV)",0.983258198532661,0.909980988593156,0
"<anonymized_userid>",1,55619,9574,"Geert Wilders (PVV)",0.98327587730929,0.910076045627376,0
"<anonymized_userid>",1,55620,9575,"Geert Wilders (PVV)",0.983293556085919,0.910171102661597,0
"<anonymized_userid>",1,55621,9576,"Geert Wilders (PVV)",0.983311234862547,0.910266159695817,0
"<anonymized_userid>",1,55622,9577,"Geert Wilders (PVV)",0.983328913639176,0.910361216730038,0
"<anonymized_userid>",1,55623,9578,"Geert Wilders (PVV)",0.983346592415805,0.910456273764259,0
"<anonymized_userid>",1,55624,9579,"Geert Wilders (PVV)",0.983364271192434,0.910551330798479,0
"<anonymized_userid>",1,55625,9580,"Geert Wilders (PVV)",0.983381949969062,0.9106463878327,0
"<anonymized_userid>",1,55626,9581,"Geert Wilders (PVV)",0.983399628745691,0.91074144486692,0
"<anonymized_userid>",1,55627,9582,"Geert Wilders (PVV)",0.983417307522319,0.910836501901141,0
"<anonymized_userid>",1,55628,9583,"Geert Wilders (PVV)",0.983434986298948,0.910931558935361,0
"<anonymized_userid>",1,55629,9584,"Geert Wilders (PVV)",0.983452665075577,0.911026615969582,0
"<anonymized_userid>",1,55630,9585,"Geert Wilders (PVV)",0.983470343852205,0.911121673003802,0
"<anonymized_userid>",1,55631,9586,"Geert Wilders (PVV)",0.983488022628834,0.911216730038023,0
"<anonymized_userid>",1,55632,9587,"Geert Wilders (PVV)",0.983505701405463,0.911311787072243,0
"<anonymized_userid>",1,55633,9588,"Geert Wilders (PVV)",0.983523380182091,0.911406844106464,0
"<anonymized_userid>",1,55634,9589,"Geert Wilders (PVV)",0.98354105895872,0.911501901140684,0
"<anonymized_userid>",1,55635,9590,"Geert Wilders (PVV)",0.983558737735349,0.911596958174905,0
"<anonymized_userid>",1,55636,9591,"Geert Wilders (PVV)",0.983576416511977,0.911692015209125,0
"<anonymized_userid>",1,55637,9592,"Geert Wilders (PVV)",0.983594095288606,0.911787072243346,0
"<anonymized_userid>",1,55638,9593,"Geert Wilders (PVV)",0.983611774065235,0.911882129277567,0
"<anonymized_userid>",1,55639,9594,"Geert Wilders (PVV)",0.983629452841863,0.911977186311787,0
"<anonymized_userid>",1,55640,9595,"Geert Wilders (PVV)",0.983647131618492,0.912072243346008,0
"<anonymized_userid>",1,55641,9596,"Geert Wilders (PVV)",0.983664810395121,0.912167300380228,0
"<anonymized_userid>",1,55642,9597,"Geert Wilders (PVV)",0.983682489171749,0.912262357414449,0
"<anonymized_userid>",1,55643,9598,"Geert Wilders (PVV)",0.983700167948378,0.912357414448669,0
"<anonymized_userid>",1,55644,9599,"Geert Wilders (PVV)",0.983717846725007,0.91245247148289,0
"<anonymized_userid>",1,55645,9600,"Geert Wilders (PVV)",0.983735525501635,0.91254752851711,0
"<anonymized_userid>",1,55646,9601,"Geert Wilders (PVV)",0.983753204278264,0.912642585551331,0
"<anonymized_userid>",1,55647,9602,"Geert Wilders (PVV)",0.983770883054893,0.912737642585551,0
"<anonymized_userid>",1,55648,9603,"Geert Wilders (PVV)",0.983788561831521,0.912832699619772,0
"<anonymized_userid>",1,55649,9604,"Geert Wilders (PVV)",0.98380624060815,0.912927756653992,0
"<anonymized_userid>",1,55650,9605,"Geert Wilders (PVV)",0.983823919384779,0.913022813688213,0
"<anonymized_userid>",1,55651,9606,"Geert Wilders (PVV)",0.983841598161407,0.913117870722433,0
"<anonymized_userid>",1,55652,9607,"Geert Wilders (PVV)",0.983859276938036,0.913212927756654,0
"<anonymized_userid>",1,55653,9608,"Geert Wilders (PVV)",0.983876955714664,0.913307984790874,0
"<anonymized_userid>",1,55654,9609,"Geert Wilders (PVV)",0.983894634491293,0.913403041825095,0
"<anonymized_userid>",1,55655,9610,"Geert Wilders (PVV)",0.983912313267922,0.913498098859316,0
"<anonymized_userid>",1,55656,9611,"Geert Wilders (PVV)",0.983929992044551,0.913593155893536,0
"<anonymized_userid>",1,55657,9612,"Geert Wilders (PVV)",0.983947670821179,0.913688212927757,0
"<anonymized_userid>",1,55658,9613,"Geert Wilders (PVV)",0.983965349597808,0.913783269961977,0
"<anonymized_userid>",1,55659,9614,"Geert Wilders (PVV)",0.983983028374437,0.913878326996198,0
"<anonymized_userid>",1,55660,9615,"Geert Wilders (PVV)",0.984000707151065,0.913973384030418,0
"<anonymized_userid>",1,55661,9616,"Geert Wilders (PVV)",0.984018385927694,0.914068441064639,0
"<anonymized_userid>",1,55662,9617,"Geert Wilders (PVV)",0.984036064704322,0.914163498098859,0
"<anonymized_userid>",1,55663,9618,"Geert Wilders (PVV)",0.984053743480951,0.91425855513308,0
"<anonymized_userid>",1,55664,9619,"Geert Wilders (PVV)",0.98407142225758,0.9143536121673,0
"<anonymized_userid>",1,55665,9620,"Geert Wilders (PVV)",0.984089101034208,0.914448669201521,0
"<anonymized_userid>",1,55666,9621,"Geert Wilders (PVV)",0.984106779810837,0.914543726235741,0
"<anonymized_userid>",1,55667,9622,"Geert Wilders (PVV)",0.984124458587466,0.914638783269962,0
"<anonymized_userid>",1,55668,9623,"Geert Wilders (PVV)",0.984142137364094,0.914733840304182,0
"<anonymized_userid>",1,55669,9624,"Geert Wilders (PVV)",0.984159816140723,0.914828897338403,0
"<anonymized_userid>",1,55670,9625,"Geert Wilders (PVV)",0.984177494917352,0.914923954372624,0
"<anonymized_userid>",1,55671,9626,"Geert Wilders (PVV)",0.98419517369398,0.915019011406844,0
"<anonymized_userid>",1,55672,9627,"Geert Wilders (PVV)",0.984212852470609,0.915114068441065,0
"<anonymized_userid>",1,55673,9628,"Geert Wilders (PVV)",0.984230531247238,0.915209125475285,0
"<anonymized_userid>",1,55674,9629,"Geert Wilders (PVV)",0.984248210023866,0.915304182509506,0
"<anonymized_userid>",1,55675,9630,"Geert Wilders (PVV)",0.984265888800495,0.915399239543726,0
"<anonymized_userid>",1,55676,9631,"Geert Wilders (PVV)",0.984283567577124,0.915494296577947,0
"<anonymized_userid>",1,55677,9632,"Geert Wilders (PVV)",0.984301246353752,0.915589353612167,0
"<anonymized_userid>",1,55678,9633,"Geert Wilders (PVV)",0.984318925130381,0.915684410646388,0
"<anonymized_userid>",1,55679,9634,"Geert Wilders (PVV)",0.98433660390701,0.915779467680608,0
"<anonymized_userid>",1,55680,9635,"Geert Wilders (PVV)",0.984354282683638,0.915874524714829,0
"<anonymized_userid>",1,55681,9636,"Geert Wilders (PVV)",0.984371961460267,0.915969581749049,0
"<anonymized_userid>",1,55682,9637,"Geert Wilders (PVV)",0.984389640236896,0.91606463878327,0
"<anonymized_userid>",1,55683,9638,"Geert Wilders (PVV)",0.984407319013524,0.91615969581749,0
"<anonymized_userid>",1,55684,9639,"Geert Wilders (PVV)",0.984424997790153,0.916254752851711,0
"<anonymized_userid>",1,55685,9640,"Geert Wilders (PVV)",0.984442676566782,0.916349809885932,0
"<anonymized_userid>",1,55686,9641,"Geert Wilders (PVV)",0.98446035534341,0.916444866920152,0
"<anonymized_userid>",1,55687,9642,"Geert Wilders (PVV)",0.984478034120039,0.916539923954373,0
"<anonymized_userid>",1,55688,9643,"Geert Wilders (PVV)",0.984495712896668,0.916634980988593,0
"<anonymized_userid>",1,55689,9644,"Geert Wilders (PVV)",0.984513391673296,0.916730038022814,0
"<anonymized_userid>",1,55690,9645,"Geert Wilders (PVV)",0.984531070449925,0.916825095057034,0
"<anonymized_userid>",1,55691,9646,"Geert Wilders (PVV)",0.984548749226554,0.916920152091255,0
"<anonymized_userid>",1,55692,9647,"Geert Wilders (PVV)",0.984566428003182,0.917015209125475,0
"<anonymized_userid>",1,55693,9648,"Geert Wilders (PVV)",0.984584106779811,0.917110266159696,0
"<anonymized_userid>",1,55694,9649,"Geert Wilders (PVV)",0.98460178555644,0.917205323193916,0
"<anonymized_userid>",1,55695,9650,"Geert Wilders (PVV)",0.984619464333068,0.917300380228137,0
"<anonymized_userid>",1,55696,9651,"Geert Wilders (PVV)",0.984637143109697,0.917395437262357,0
"<anonymized_userid>",1,55697,9652,"Geert Wilders (PVV)",0.984654821886325,0.917490494296578,0
"<anonymized_userid>",1,55698,9653,"Geert Wilders (PVV)",0.984672500662954,0.917585551330798,0
"<anonymized_userid>",1,55699,9654,"Geert Wilders (PVV)",0.984690179439583,0.917680608365019,0
"<anonymized_userid>",1,55700,9655,"Geert Wilders (PVV)",0.984707858216211,0.917775665399239,0
"<anonymized_userid>",1,55701,9656,"Geert Wilders (PVV)",0.98472553699284,0.91787072243346,0
"<anonymized_userid>",1,55702,9657,"Geert Wilders (PVV)",0.984743215769469,0.917965779467681,0
"<anonymized_userid>",1,55703,9658,"Geert Wilders (PVV)",0.984760894546097,0.918060836501901,0
"<anonymized_userid>",1,55704,9659,"Geert Wilders (PVV)",0.984778573322726,0.918155893536122,0
"<anonymized_userid>",1,55705,9660,"Geert Wilders (PVV)",0.984796252099355,0.918250950570342,0
"<anonymized_userid>",1,55706,9661,"Geert Wilders (PVV)",0.984813930875983,0.918346007604563,0
"<anonymized_userid>",1,55707,9662,"Geert Wilders (PVV)",0.984831609652612,0.918441064638783,0
"<anonymized_userid>",1,55708,9663,"Geert Wilders (PVV)",0.984849288429241,0.918536121673004,0
"<anonymized_userid>",1,55709,9664,"Geert Wilders (PVV)",0.984866967205869,0.918631178707224,0
"<anonymized_userid>",1,55710,9665,"Geert Wilders (PVV)",0.984884645982498,0.918726235741445,0
"<anonymized_userid>",1,55711,9666,"Geert Wilders (PVV)",0.984902324759127,0.918821292775665,0
"<anonymized_userid>",1,55712,9667,"Geert Wilders (PVV)",0.984920003535755,0.918916349809886,0
"<anonymized_userid>",1,55713,9668,"Geert Wilders (PVV)",0.984937682312384,0.919011406844106,0
"<anonymized_userid>",1,55714,9669,"Geert Wilders (PVV)",0.984955361089013,0.919106463878327,0
"<anonymized_userid>",1,55715,9670,"Geert Wilders (PVV)",0.984973039865641,0.919201520912547,0
"<anonymized_userid>",1,55716,9671,"Geert Wilders (PVV)",0.98499071864227,0.919296577946768,0
"<anonymized_userid>",1,55717,9672,"Geert Wilders (PVV)",0.985008397418899,0.919391634980989,0
"<anonymized_userid>",1,55718,9673,"Geert Wilders (PVV)",0.985026076195527,0.919486692015209,0
"<anonymized_userid>",1,55719,9674,"Geert Wilders (PVV)",0.985043754972156,0.91958174904943,0
"<anonymized_userid>",1,55720,9675,"Geert Wilders (PVV)",0.985061433748785,0.91967680608365,0
"<anonymized_userid>",1,55721,9676,"Geert Wilders (PVV)",0.985079112525413,0.919771863117871,0
"<anonymized_userid>",1,55722,9677,"Geert Wilders (PVV)",0.985096791302042,0.919866920152091,0
"<anonymized_userid>",1,55723,9678,"Geert Wilders (PVV)",0.985114470078671,0.919961977186312,0
"<anonymized_userid>",1,55724,9679,"Geert Wilders (PVV)",0.985132148855299,0.920057034220532,0
"<anonymized_userid>",1,55725,9680,"Geert Wilders (PVV)",0.985149827631928,0.920152091254753,0
"<anonymized_userid>",1,55726,9681,"Geert Wilders (PVV)",0.985167506408557,0.920247148288973,0
"<anonymized_userid>",1,55727,9682,"Geert Wilders (PVV)",0.985185185185185,0.920342205323194,0
"<anonymized_userid>",1,55728,9683,"Geert Wilders (PVV)",0.985202863961814,0.920437262357414,0
"<anonymized_userid>",1,55729,9684,"Geert Wilders (PVV)",0.985220542738443,0.920532319391635,0
"<anonymized_userid>",1,55730,9685,"Geert Wilders (PVV)",0.985238221515071,0.920627376425855,0
"<anonymized_userid>",1,55731,9686,"Geert Wilders (PVV)",0.9852559002917,0.920722433460076,0
"<anonymized_userid>",1,55732,9687,"Geert Wilders (PVV)",0.985273579068328,0.920817490494297,0
"<anonymized_userid>",1,55733,9688,"Geert Wilders (PVV)",0.985291257844957,0.920912547528517,0
"<anonymized_userid>",1,55734,9689,"Geert Wilders (PVV)",0.985308936621586,0.921007604562738,0
"<anonymized_userid>",1,55735,9690,"Geert Wilders (PVV)",0.985326615398214,0.921102661596958,0
"<anonymized_userid>",1,55736,9691,"Geert Wilders (PVV)",0.985344294174843,0.921197718631179,0
"<anonymized_userid>",1,55737,9692,"Geert Wilders (PVV)",0.985361972951472,0.921292775665399,0
"<anonymized_userid>",1,55738,9693,"Geert Wilders (PVV)",0.9853796517281,0.92138783269962,0
"<anonymized_userid>",1,55739,9694,"Geert Wilders (PVV)",0.985397330504729,0.92148288973384,0
"<anonymized_userid>",1,55740,9695,"Geert Wilders (PVV)",0.985415009281358,0.921577946768061,0
"<anonymized_userid>",1,55741,9696,"Geert Wilders (PVV)",0.985432688057986,0.921673003802281,0
"<anonymized_userid>",1,55742,9697,"Geert Wilders (PVV)",0.985450366834615,0.921768060836502,0
"<anonymized_userid>",1,55743,9698,"Geert Wilders (PVV)",0.985468045611244,0.921863117870722,0
"<anonymized_userid>",1,55744,9699,"Geert Wilders (PVV)",0.985485724387872,0.921958174904943,0
"<anonymized_userid>",1,55745,9700,"Geert Wilders (PVV)",0.985503403164501,0.922053231939164,0
"<anonymized_userid>",1,55746,9701,"Geert Wilders (PVV)",0.98552108194113,0.922148288973384,0
"<anonymized_userid>",1,55747,9702,"Geert Wilders (PVV)",0.985538760717758,0.922243346007605,0
"<anonymized_userid>",1,55748,9703,"Geert Wilders (PVV)",0.985556439494387,0.922338403041825,0
"<anonymized_userid>",1,55749,9704,"Geert Wilders (PVV)",0.985574118271016,0.922433460076046,0
"<anonymized_userid>",1,55750,9705,"Geert Wilders (PVV)",0.985591797047644,0.922528517110266,0
"<anonymized_userid>",1,55751,9706,"Geert Wilders (PVV)",0.985609475824273,0.922623574144487,0
"<anonymized_userid>",1,55752,9707,"Geert Wilders (PVV)",0.985627154600902,0.922718631178707,0
"<anonymized_userid>",1,55753,9708,"Geert Wilders (PVV)",0.98564483337753,0.922813688212928,0
"<anonymized_userid>",1,55754,9709,"Geert Wilders (PVV)",0.985662512154159,0.922908745247148,0
"<anonymized_userid>",1,55755,9710,"Geert Wilders (PVV)",0.985680190930788,0.923003802281369,0
"<anonymized_userid>",1,55756,9711,"Geert Wilders (PVV)",0.985697869707416,0.923098859315589,0
"<anonymized_userid>",1,55757,9712,"Geert Wilders (PVV)",0.985715548484045,0.92319391634981,0
"<anonymized_userid>",1,55758,9713,"Geert Wilders (PVV)",0.985733227260674,0.92328897338403,0
"<anonymized_userid>",1,55759,9714,"Geert Wilders (PVV)",0.985750906037302,0.923384030418251,0
"<anonymized_userid>",1,55760,9715,"Geert Wilders (PVV)",0.985768584813931,0.923479087452472,0
"<anonymized_userid>",1,55761,9716,"Geert Wilders (PVV)",0.98578626359056,0.923574144486692,0
"<anonymized_userid>",1,55762,9717,"Geert Wilders (PVV)",0.985803942367188,0.923669201520913,0
"<anonymized_userid>",1,55763,9718,"Geert Wilders (PVV)",0.985821621143817,0.923764258555133,0
"<anonymized_userid>",1,55764,9719,"Geert Wilders (PVV)",0.985839299920445,0.923859315589354,0
"<anonymized_userid>",1,55765,9720,"Geert Wilders (PVV)",0.985856978697074,0.923954372623574,0
"<anonymized_userid>",1,55766,9721,"Geert Wilders (PVV)",0.985874657473703,0.924049429657795,0
"<anonymized_userid>",1,55767,9722,"Geert Wilders (PVV)",0.985892336250331,0.924144486692015,0
"<anonymized_userid>",1,55768,9723,"Geert Wilders (PVV)",0.98591001502696,0.924239543726236,0
"<anonymized_userid>",1,55769,9724,"Geert Wilders (PVV)",0.985927693803589,0.924334600760456,0
"<anonymized_userid>",1,55770,9725,"Geert Wilders (PVV)",0.985945372580217,0.924429657794677,0
"<anonymized_userid>",1,55771,9726,"Geert Wilders (PVV)",0.985963051356846,0.924524714828897,0
"<anonymized_userid>",1,55772,9727,"Geert Wilders (PVV)",0.985980730133475,0.924619771863118,0
"<anonymized_userid>",1,55773,9728,"Geert Wilders (PVV)",0.985998408910103,0.924714828897338,0
"<anonymized_userid>",1,55774,9729,"Geert Wilders (PVV)",0.986016087686732,0.924809885931559,0
"<anonymized_userid>",1,55775,9730,"Geert Wilders (PVV)",0.986033766463361,0.92490494296578,0
"<anonymized_userid>",1,55776,9731,"Geert Wilders (PVV)",0.986051445239989,0.925,0
"<anonymized_userid>",1,55777,9732,"Geert Wilders (PVV)",0.986069124016618,0.925095057034221,0
"<anonymized_userid>",1,55778,9733,"Geert Wilders (PVV)",0.986086802793247,0.925190114068441,0
"<anonymized_userid>",1,55779,9734,"Geert Wilders (PVV)",0.986104481569875,0.925285171102662,0
"<anonymized_userid>",1,55780,9735,"Geert Wilders (PVV)",0.986122160346504,0.925380228136882,0
"<anonymized_userid>",1,55781,9736,"Geert Wilders (PVV)",0.986139839123133,0.925475285171103,0
"<anonymized_userid>",1,55782,9737,"Geert Wilders (PVV)",0.986157517899761,0.925570342205323,0
"<anonymized_userid>",1,55783,9738,"Geert Wilders (PVV)",0.98617519667639,0.925665399239544,0
"<anonymized_userid>",1,55784,9739,"Geert Wilders (PVV)",0.986192875453019,0.925760456273764,0
"<anonymized_userid>",1,55785,9740,"Geert Wilders (PVV)",0.986210554229647,0.925855513307985,0
"<anonymized_userid>",1,55786,9741,"Geert Wilders (PVV)",0.986228233006276,0.925950570342205,0
"<anonymized_userid>",1,55787,9742,"Geert Wilders (PVV)",0.986245911782905,0.926045627376426,0
"<anonymized_userid>",1,55788,9743,"Geert Wilders (PVV)",0.986263590559533,0.926140684410646,0
"<anonymized_userid>",1,55789,9744,"Geert Wilders (PVV)",0.986281269336162,0.926235741444867,0
"<anonymized_userid>",1,55790,9745,"Geert Wilders (PVV)",0.986298948112791,0.926330798479088,0
"<anonymized_userid>",1,55791,9746,"Geert Wilders (PVV)",0.986316626889419,0.926425855513308,0
"<anonymized_userid>",1,55792,9747,"Geert Wilders (PVV)",0.986334305666048,0.926520912547529,0
"<anonymized_userid>",1,55793,9748,"Geert Wilders (PVV)",0.986351984442677,0.926615969581749,0
"<anonymized_userid>",1,55794,9749,"Geert Wilders (PVV)",0.986369663219305,0.92671102661597,0
"<anonymized_userid>",1,55795,9750,"Geert Wilders (PVV)",0.986387341995934,0.92680608365019,0
"<anonymized_userid>",1,55796,9751,"Geert Wilders (PVV)",0.986405020772563,0.926901140684411,0
"<anonymized_userid>",1,55797,9752,"Geert Wilders (PVV)",0.986422699549191,0.926996197718631,0
"<anonymized_userid>",1,55798,9753,"Geert Wilders (PVV)",0.98644037832582,0.927091254752852,0
"<anonymized_userid>",1,55799,9754,"Geert Wilders (PVV)",0.986458057102448,0.927186311787072,0
"<anonymized_userid>",1,55800,9755,"Geert Wilders (PVV)",0.986475735879077,0.927281368821293,0
"<anonymized_userid>",1,55801,9756,"Geert Wilders (PVV)",0.986493414655706,0.927376425855513,0
"<anonymized_userid>",1,55802,9757,"Geert Wilders (PVV)",0.986511093432334,0.927471482889734,0
"<anonymized_userid>",1,55803,9758,"Geert Wilders (PVV)",0.986528772208963,0.927566539923954,0
"<anonymized_userid>",1,55804,9759,"Geert Wilders (PVV)",0.986546450985592,0.927661596958175,0
"<anonymized_userid>",1,55805,9760,"Geert Wilders (PVV)",0.98656412976222,0.927756653992395,0
"<anonymized_userid>",1,55806,9761,"Geert Wilders (PVV)",0.986581808538849,0.927851711026616,0
"<anonymized_userid>",1,55807,9762,"Geert Wilders (PVV)",0.986599487315478,0.927946768060837,0
"<anonymized_userid>",1,55808,9763,"Geert Wilders (PVV)",0.986617166092106,0.928041825095057,0
"<anonymized_userid>",1,55809,9764,"Geert Wilders (PVV)",0.986634844868735,0.928136882129278,0
"<anonymized_userid>",1,55810,9765,"Geert Wilders (PVV)",0.986652523645364,0.928231939163498,0
"<anonymized_userid>",1,55811,9766,"Geert Wilders (PVV)",0.986670202421992,0.928326996197719,0
"<anonymized_userid>",1,55812,9767,"Geert Wilders (PVV)",0.986687881198621,0.928422053231939,0
"<anonymized_userid>",1,55813,9768,"Geert Wilders (PVV)",0.98670555997525,0.92851711026616,0
"<anonymized_userid>",1,55814,9769,"Geert Wilders (PVV)",0.986723238751878,0.92861216730038,0
"<anonymized_userid>",1,55815,9770,"Geert Wilders (PVV)",0.986740917528507,0.928707224334601,0
"<anonymized_userid>",1,55816,9771,"Geert Wilders (PVV)",0.986758596305136,0.928802281368821,0
"<anonymized_userid>",1,55817,9772,"Geert Wilders (PVV)",0.986776275081764,0.928897338403042,0
"<anonymized_userid>",1,55818,9773,"Geert Wilders (PVV)",0.986793953858393,0.928992395437262,0
"<anonymized_userid>",1,55819,9774,"Geert Wilders (PVV)",0.986811632635022,0.929087452471483,0
"<anonymized_userid>",1,55820,9775,"Geert Wilders (PVV)",0.98682931141165,0.929182509505703,0
"<anonymized_userid>",1,55821,9776,"Geert Wilders (PVV)",0.986846990188279,0.929277566539924,0
"<anonymized_userid>",1,55822,9777,"Geert Wilders (PVV)",0.986864668964908,0.929372623574145,0
"<anonymized_userid>",1,55823,9778,"Geert Wilders (PVV)",0.986882347741536,0.929467680608365,0
"<anonymized_userid>",1,55824,9779,"Geert Wilders (PVV)",0.986900026518165,0.929562737642586,0
"<anonymized_userid>",1,55825,9780,"Geert Wilders (PVV)",0.986917705294794,0.929657794676806,0
"<anonymized_userid>",1,55826,9781,"Geert Wilders (PVV)",0.986935384071422,0.929752851711027,0
"<anonymized_userid>",1,55827,9782,"Geert Wilders (PVV)",0.986953062848051,0.929847908745247,0
"<anonymized_userid>",1,55828,9783,"Geert Wilders (PVV)",0.98697074162468,0.929942965779468,0
"<anonymized_userid>",1,55829,9784,"Geert Wilders (PVV)",0.986988420401308,0.930038022813688,0
"<anonymized_userid>",1,55830,9785,"Geert Wilders (PVV)",0.987006099177937,0.930133079847909,0
"<anonymized_userid>",1,55831,9786,"Geert Wilders (PVV)",0.987023777954566,0.930228136882129,0
"<anonymized_userid>",1,55832,9787,"Geert Wilders (PVV)",0.987041456731194,0.93032319391635,0
"<anonymized_userid>",1,55833,9788,"Geert Wilders (PVV)",0.987059135507823,0.93041825095057,0
"<anonymized_userid>",1,55834,9789,"Geert Wilders (PVV)",0.987076814284451,0.930513307984791,0
"<anonymized_userid>",1,55835,9790,"Geert Wilders (PVV)",0.98709449306108,0.930608365019011,0
"<anonymized_userid>",1,55836,9791,"Geert Wilders (PVV)",0.987112171837709,0.930703422053232,0
"<anonymized_userid>",1,55837,9792,"Geert Wilders (PVV)",0.987129850614337,0.930798479087453,0
"<anonymized_userid>",1,55838,9793,"Geert Wilders (PVV)",0.987147529390966,0.930893536121673,0
"<anonymized_userid>",1,55839,9794,"Geert Wilders (PVV)",0.987165208167595,0.930988593155894,0
"<anonymized_userid>",1,55840,9795,"Geert Wilders (PVV)",0.987182886944224,0.931083650190114,0
"<anonymized_userid>",1,55841,9796,"Geert Wilders (PVV)",0.987200565720852,0.931178707224335,0
"<anonymized_userid>",1,55842,9797,"Geert Wilders (PVV)",0.987218244497481,0.931273764258555,0
"<anonymized_userid>",1,55843,9798,"Geert Wilders (PVV)",0.987235923274109,0.931368821292776,0
"<anonymized_userid>",1,55844,9799,"Geert Wilders (PVV)",0.987253602050738,0.931463878326996,0
"<anonymized_userid>",1,55845,9800,"Geert Wilders (PVV)",0.987271280827367,0.931558935361217,0
"<anonymized_userid>",1,55846,9801,"Geert Wilders (PVV)",0.987288959603995,0.931653992395437,0
"<anonymized_userid>",1,55847,9802,"Geert Wilders (PVV)",0.987306638380624,0.931749049429658,0
"<anonymized_userid>",1,55848,9803,"Geert Wilders (PVV)",0.987324317157253,0.931844106463878,0
"<anonymized_userid>",1,55849,9804,"Geert Wilders (PVV)",0.987341995933881,0.931939163498099,0
"<anonymized_userid>",1,55850,9805,"Geert Wilders (PVV)",0.98735967471051,0.932034220532319,0
"<anonymized_userid>",1,55851,9806,"Geert Wilders (PVV)",0.987377353487139,0.93212927756654,0
"<anonymized_userid>",1,55852,9807,"Geert Wilders (PVV)",0.987395032263767,0.93222433460076,0
"<anonymized_userid>",1,55853,9808,"Geert Wilders (PVV)",0.987412711040396,0.932319391634981,0
"<anonymized_userid>",1,55854,9809,"Geert Wilders (PVV)",0.987430389817025,0.932414448669202,0
"<anonymized_userid>",1,55855,9810,"Geert Wilders (PVV)",0.987448068593653,0.932509505703422,0
"<anonymized_userid>",1,55856,9811,"Geert Wilders (PVV)",0.987465747370282,0.932604562737643,0
"<anonymized_userid>",1,55857,9812,"Geert Wilders (PVV)",0.987483426146911,0.932699619771863,0
"<anonymized_userid>",1,55858,9813,"Geert Wilders (PVV)",0.987501104923539,0.932794676806084,0
"<anonymized_userid>",1,55859,9814,"Geert Wilders (PVV)",0.987518783700168,0.932889733840304,0
"<anonymized_userid>",1,55860,9815,"Geert Wilders (PVV)",0.987536462476797,0.932984790874525,0
"<anonymized_userid>",1,55861,9816,"Geert Wilders (PVV)",0.987554141253425,0.933079847908745,0
"<anonymized_userid>",1,55862,9817,"Geert Wilders (PVV)",0.987571820030054,0.933174904942966,0
"<anonymized_userid>",1,55863,9818,"Geert Wilders (PVV)",0.987589498806683,0.933269961977186,0
"<anonymized_userid>",1,55864,9819,"Geert Wilders (PVV)",0.987607177583311,0.933365019011407,0
"<anonymized_userid>",1,55865,9820,"Geert Wilders (PVV)",0.98762485635994,0.933460076045627,0
"<anonymized_userid>",1,55866,9821,"Geert Wilders (PVV)",0.987642535136569,0.933555133079848,0
"<anonymized_userid>",1,55867,9822,"Geert Wilders (PVV)",0.987660213913197,0.933650190114068,0
"<anonymized_userid>",1,55868,9823,"Geert Wilders (PVV)",0.987677892689826,0.933745247148289,0
"<anonymized_userid>",1,55869,9824,"Geert Wilders (PVV)",0.987695571466454,0.93384030418251,0
"<anonymized_userid>",1,55870,9825,"Geert Wilders (PVV)",0.987713250243083,0.93393536121673,0
"<anonymized_userid>",1,55871,9826,"Geert Wilders (PVV)",0.987730929019712,0.934030418250951,0
"<anonymized_userid>",1,55872,9827,"Geert Wilders (PVV)",0.98774860779634,0.934125475285171,0
"<anonymized_userid>",1,55873,9828,"Geert Wilders (PVV)",0.987766286572969,0.934220532319392,0
"<anonymized_userid>",1,55874,9829,"Geert Wilders (PVV)",0.987783965349598,0.934315589353612,0
"<anonymized_userid>",1,55875,9830,"Geert Wilders (PVV)",0.987801644126227,0.934410646387833,0
"<anonymized_userid>",1,55876,9831,"Geert Wilders (PVV)",0.987819322902855,0.934505703422053,0
"<anonymized_userid>",1,55877,9832,"Geert Wilders (PVV)",0.987837001679484,0.934600760456274,0
"<anonymized_userid>",1,55878,9833,"Geert Wilders (PVV)",0.987854680456112,0.934695817490494,0
"<anonymized_userid>",1,55879,9834,"Geert Wilders (PVV)",0.987872359232741,0.934790874524715,0
"<anonymized_userid>",1,55880,9835,"Geert Wilders (PVV)",0.98789003800937,0.934885931558935,0
"<anonymized_userid>",1,55881,9836,"Geert Wilders (PVV)",0.987907716785998,0.934980988593156,0
"<anonymized_userid>",1,55882,9837,"Geert Wilders (PVV)",0.987925395562627,0.935076045627376,0
"<anonymized_userid>",1,55883,9838,"Geert Wilders (PVV)",0.987943074339256,0.935171102661597,0
"<anonymized_userid>",1,55884,9839,"Geert Wilders (PVV)",0.987960753115884,0.935266159695818,0
"<anonymized_userid>",1,55885,9840,"Geert Wilders (PVV)",0.987978431892513,0.935361216730038,0
"<anonymized_userid>",1,55886,9841,"Geert Wilders (PVV)",0.987996110669142,0.935456273764259,0
"<anonymized_userid>",1,55887,9842,"Geert Wilders (PVV)",0.98801378944577,0.935551330798479,0
"<anonymized_userid>",1,55888,9843,"Geert Wilders (PVV)",0.988031468222399,0.9356463878327,0
"<anonymized_userid>",1,55889,9844,"Geert Wilders (PVV)",0.988049146999028,0.93574144486692,0
"<anonymized_userid>",1,55890,9845,"Geert Wilders (PVV)",0.988066825775656,0.935836501901141,0
"<anonymized_userid>",1,55891,9846,"Geert Wilders (PVV)",0.988084504552285,0.935931558935361,0
"<anonymized_userid>",1,55892,9847,"Geert Wilders (PVV)",0.988102183328914,0.936026615969582,0
"<anonymized_userid>",1,55893,9848,"Geert Wilders (PVV)",0.988119862105542,0.936121673003802,0
"<anonymized_userid>",1,55894,9849,"Geert Wilders (PVV)",0.988137540882171,0.936216730038023,0
"<anonymized_userid>",1,55895,9850,"Geert Wilders (PVV)",0.9881552196588,0.936311787072243,0
"<anonymized_userid>",1,55896,9851,"Geert Wilders (PVV)",0.988172898435428,0.936406844106464,0
"<anonymized_userid>",1,55897,9852,"Geert Wilders (PVV)",0.988190577212057,0.936501901140684,0
"<anonymized_userid>",1,55898,9853,"Geert Wilders (PVV)",0.988208255988686,0.936596958174905,0
"<anonymized_userid>",1,55899,9854,"Geert Wilders (PVV)",0.988225934765314,0.936692015209125,0
"<anonymized_userid>",1,55900,9855,"Geert Wilders (PVV)",0.988243613541943,0.936787072243346,0
"<anonymized_userid>",1,55901,9856,"Geert Wilders (PVV)",0.988261292318572,0.936882129277567,0
"<anonymized_userid>",1,55902,9857,"Geert Wilders (PVV)",0.9882789710952,0.936977186311787,0
"<anonymized_userid>",1,55903,9858,"Geert Wilders (PVV)",0.988296649871829,0.937072243346008,0
"<anonymized_userid>",1,55904,9859,"Geert Wilders (PVV)",0.988314328648457,0.937167300380228,0
"<anonymized_userid>",1,55905,9860,"Geert Wilders (PVV)",0.988332007425086,0.937262357414449,0
"<anonymized_userid>",1,55906,9861,"Geert Wilders (PVV)",0.988349686201715,0.937357414448669,0
"<anonymized_userid>",1,55907,9862,"Geert Wilders (PVV)",0.988367364978344,0.93745247148289,0
"<anonymized_userid>",1,55908,9863,"Geert Wilders (PVV)",0.988385043754972,0.93754752851711,0
"<anonymized_userid>",1,55909,9864,"Geert Wilders (PVV)",0.988402722531601,0.937642585551331,0
"<anonymized_userid>",1,55910,9865,"Geert Wilders (PVV)",0.98842040130823,0.937737642585551,0
"<anonymized_userid>",1,55911,9866,"Geert Wilders (PVV)",0.988438080084858,0.937832699619772,0
"<anonymized_userid>",1,55912,9867,"Geert Wilders (PVV)",0.988455758861487,0.937927756653992,0
"<anonymized_userid>",1,55913,9868,"Geert Wilders (PVV)",0.988473437638115,0.938022813688213,0
"<anonymized_userid>",1,55914,9869,"Geert Wilders (PVV)",0.988491116414744,0.938117870722433,0
"<anonymized_userid>",1,55915,9870,"Geert Wilders (PVV)",0.988508795191373,0.938212927756654,0
"<anonymized_userid>",1,55916,9871,"Geert Wilders (PVV)",0.988526473968001,0.938307984790875,0
"<anonymized_userid>",1,55917,9872,"Geert Wilders (PVV)",0.98854415274463,0.938403041825095,0
"<anonymized_userid>",1,55918,9873,"Geert Wilders (PVV)",0.988561831521259,0.938498098859316,0
"<anonymized_userid>",1,55919,9874,"Geert Wilders (PVV)",0.988579510297887,0.938593155893536,0
"<anonymized_userid>",1,55920,9875,"Geert Wilders (PVV)",0.988597189074516,0.938688212927757,0
"<anonymized_userid>",1,55921,9876,"Geert Wilders (PVV)",0.988614867851145,0.938783269961977,0
"<anonymized_userid>",1,55922,9877,"Geert Wilders (PVV)",0.988632546627773,0.938878326996198,0
"<anonymized_userid>",1,55923,9878,"Geert Wilders (PVV)",0.988650225404402,0.938973384030418,0
"<anonymized_userid>",1,55924,9879,"Geert Wilders (PVV)",0.988667904181031,0.939068441064639,0
"<anonymized_userid>",1,55925,9880,"Geert Wilders (PVV)",0.988685582957659,0.939163498098859,0
"<anonymized_userid>",1,55926,9881,"Geert Wilders (PVV)",0.988703261734288,0.93925855513308,0
"<anonymized_userid>",1,55927,9882,"Geert Wilders (PVV)",0.988720940510917,0.9393536121673,0
"<anonymized_userid>",1,55928,9883,"Geert Wilders (PVV)",0.988738619287545,0.939448669201521,0
"<anonymized_userid>",1,55929,9884,"Geert Wilders (PVV)",0.988756298064174,0.939543726235741,0
"<anonymized_userid>",1,55930,9885,"Geert Wilders (PVV)",0.988773976840803,0.939638783269962,0
"<anonymized_userid>",1,55931,9886,"Geert Wilders (PVV)",0.988791655617431,0.939733840304182,0
"<anonymized_userid>",1,55932,9887,"Geert Wilders (PVV)",0.98880933439406,0.939828897338403,0
"<anonymized_userid>",1,55933,9888,"Geert Wilders (PVV)",0.988827013170689,0.939923954372624,0
"<anonymized_userid>",1,55934,9889,"Geert Wilders (PVV)",0.988844691947317,0.940019011406844,0
"<anonymized_userid>",1,55935,9890,"Geert Wilders (PVV)",0.988862370723946,0.940114068441065,0
"<anonymized_userid>",1,55936,9891,"Geert Wilders (PVV)",0.988880049500575,0.940209125475285,0
"<anonymized_userid>",1,55937,9892,"Geert Wilders (PVV)",0.988897728277203,0.940304182509506,0
"<anonymized_userid>",1,55938,9893,"Geert Wilders (PVV)",0.988915407053832,0.940399239543726,0
"<anonymized_userid>",1,55939,9894,"Geert Wilders (PVV)",0.988933085830461,0.940494296577947,0
"<anonymized_userid>",1,55940,9895,"Geert Wilders (PVV)",0.988950764607089,0.940589353612167,0
"<anonymized_userid>",1,55941,9896,"Geert Wilders (PVV)",0.988968443383718,0.940684410646388,0
"<anonymized_userid>",1,55942,9897,"Geert Wilders (PVV)",0.988986122160347,0.940779467680608,0
"<anonymized_userid>",1,55943,9898,"Geert Wilders (PVV)",0.989003800936975,0.940874524714829,0
"<anonymized_userid>",1,55944,9899,"Geert Wilders (PVV)",0.989021479713604,0.940969581749049,0
"<anonymized_userid>",1,55945,9900,"Geert Wilders (PVV)",0.989039158490232,0.94106463878327,0
"<anonymized_userid>",1,55946,9901,"Geert Wilders (PVV)",0.989056837266861,0.94115969581749,0
"<anonymized_userid>",1,55947,9902,"Geert Wilders (PVV)",0.98907451604349,0.941254752851711,0
"<anonymized_userid>",1,55948,9903,"Geert Wilders (PVV)",0.989092194820118,0.941349809885932,0
"<anonymized_userid>",1,55949,9904,"Geert Wilders (PVV)",0.989109873596747,0.941444866920152,0
"<anonymized_userid>",1,55950,9905,"Geert Wilders (PVV)",0.989127552373376,0.941539923954373,0
"<anonymized_userid>",1,55951,9906,"Geert Wilders (PVV)",0.989145231150004,0.941634980988593,0
"<anonymized_userid>",1,55952,9907,"Geert Wilders (PVV)",0.989162909926633,0.941730038022814,0
"<anonymized_userid>",1,55953,9908,"Geert Wilders (PVV)",0.989180588703262,0.941825095057034,0
"<anonymized_userid>",1,55954,9909,"Geert Wilders (PVV)",0.98919826747989,0.941920152091255,0
"<anonymized_userid>",1,55955,9910,"Geert Wilders (PVV)",0.989215946256519,0.942015209125475,0
"<anonymized_userid>",1,55956,9911,"Geert Wilders (PVV)",0.989233625033148,0.942110266159696,0
"<anonymized_userid>",1,55957,9912,"Geert Wilders (PVV)",0.989251303809776,0.942205323193916,0
"<anonymized_userid>",1,55958,9913,"Geert Wilders (PVV)",0.989268982586405,0.942300380228137,0
"<anonymized_userid>",1,55959,9914,"Geert Wilders (PVV)",0.989286661363034,0.942395437262357,0
"<anonymized_userid>",1,55960,9915,"Geert Wilders (PVV)",0.989304340139662,0.942490494296578,0
"<anonymized_userid>",1,55961,9916,"Geert Wilders (PVV)",0.989322018916291,0.942585551330798,0
"<anonymized_userid>",1,55962,9917,"Geert Wilders (PVV)",0.98933969769292,0.942680608365019,0
"<anonymized_userid>",1,55963,9918,"Geert Wilders (PVV)",0.989357376469548,0.94277566539924,0
"<anonymized_userid>",1,55964,9919,"Geert Wilders (PVV)",0.989375055246177,0.94287072243346,0
"<anonymized_userid>",1,55965,9920,"Geert Wilders (PVV)",0.989392734022806,0.942965779467681,0
"<anonymized_userid>",1,55966,9921,"Geert Wilders (PVV)",0.989410412799434,0.943060836501901,0
"<anonymized_userid>",1,55967,9922,"Geert Wilders (PVV)",0.989428091576063,0.943155893536122,0
"<anonymized_userid>",1,55968,9923,"Geert Wilders (PVV)",0.989445770352692,0.943250950570342,0
"<anonymized_userid>",1,55969,9924,"Geert Wilders (PVV)",0.98946344912932,0.943346007604563,0
"<anonymized_userid>",1,55970,9925,"Geert Wilders (PVV)",0.989481127905949,0.943441064638783,0
"<anonymized_userid>",1,55971,9926,"Geert Wilders (PVV)",0.989498806682578,0.943536121673004,0
"<anonymized_userid>",1,55972,9927,"Geert Wilders (PVV)",0.989516485459206,0.943631178707224,0
"<anonymized_userid>",1,55973,9928,"Geert Wilders (PVV)",0.989534164235835,0.943726235741445,0
"<anonymized_userid>",1,55974,9929,"Geert Wilders (PVV)",0.989551843012464,0.943821292775665,0
"<anonymized_userid>",1,55975,9930,"Geert Wilders (PVV)",0.989569521789092,0.943916349809886,0
"<anonymized_userid>",1,55976,9931,"Geert Wilders (PVV)",0.989587200565721,0.944011406844106,0
"<anonymized_userid>",1,55977,9932,"Geert Wilders (PVV)",0.98960487934235,0.944106463878327,0
"<anonymized_userid>",1,55978,9933,"Geert Wilders (PVV)",0.989622558118978,0.944201520912547,0
"<anonymized_userid>",1,55979,9934,"Geert Wilders (PVV)",0.989640236895607,0.944296577946768,0
"<anonymized_userid>",1,55980,9935,"Geert Wilders (PVV)",0.989657915672235,0.944391634980989,0
"<anonymized_userid>",1,55981,9936,"Geert Wilders (PVV)",0.989675594448864,0.944486692015209,0
"<anonymized_userid>",1,55982,9937,"Geert Wilders (PVV)",0.989693273225493,0.94458174904943,0
"<anonymized_userid>",1,55983,9938,"Geert Wilders (PVV)",0.989710952002121,0.94467680608365,0
"<anonymized_userid>",1,55984,9939,"Geert Wilders (PVV)",0.98972863077875,0.944771863117871,0
"<anonymized_userid>",1,55985,9940,"Geert Wilders (PVV)",0.989746309555379,0.944866920152091,0
"<anonymized_userid>",1,55986,9941,"Geert Wilders (PVV)",0.989763988332007,0.944961977186312,0
"<anonymized_userid>",1,55987,9942,"Geert Wilders (PVV)",0.989781667108636,0.945057034220532,0
"<anonymized_userid>",1,55988,9943,"Geert Wilders (PVV)",0.989799345885265,0.945152091254753,0
"<anonymized_userid>",1,55989,9944,"Geert Wilders (PVV)",0.989817024661893,0.945247148288973,0
"<anonymized_userid>",1,55990,9945,"Geert Wilders (PVV)",0.989834703438522,0.945342205323194,0
"<anonymized_userid>",1,55991,9946,"Geert Wilders (PVV)",0.989852382215151,0.945437262357414,0
"<anonymized_userid>",1,55992,9947,"Geert Wilders (PVV)",0.989870060991779,0.945532319391635,0
"<anonymized_userid>",1,55993,9948,"Geert Wilders (PVV)",0.989887739768408,0.945627376425855,0
"<anonymized_userid>",1,55994,9949,"Geert Wilders (PVV)",0.989905418545037,0.945722433460076,0
"<anonymized_userid>",1,55995,9950,"Geert Wilders (PVV)",0.989923097321665,0.945817490494297,0
"<anonymized_userid>",1,55996,9951,"Geert Wilders (PVV)",0.989940776098294,0.945912547528517,0
"<anonymized_userid>",1,55997,9952,"Geert Wilders (PVV)",0.989958454874923,0.946007604562738,0
"<anonymized_userid>",1,55998,9953,"Geert Wilders (PVV)",0.989976133651551,0.946102661596958,0
"<anonymized_userid>",1,55999,9954,"Geert Wilders (PVV)",0.98999381242818,0.946197718631179,0
"<anonymized_userid>",1,56000,9955,"Geert Wilders (PVV)",0.990011491204809,0.946292775665399,0
"<anonymized_userid>",1,56001,9956,"Geert Wilders (PVV)",0.990029169981437,0.94638783269962,0
"<anonymized_userid>",1,56002,9957,"Geert Wilders (PVV)",0.990046848758066,0.94648288973384,0
"<anonymized_userid>",1,56003,9958,"Geert Wilders (PVV)",0.990064527534695,0.946577946768061,0
"<anonymized_userid>",1,56004,9959,"Geert Wilders (PVV)",0.990082206311323,0.946673003802281,0
"<anonymized_userid>",1,56005,9960,"Geert Wilders (PVV)",0.990099885087952,0.946768060836502,0
"<anonymized_userid>",1,56006,9961,"Geert Wilders (PVV)",0.990117563864581,0.946863117870722,0
"<anonymized_userid>",1,56007,9962,"Geert Wilders (PVV)",0.990135242641209,0.946958174904943,0
"<anonymized_userid>",1,56008,9963,"Geert Wilders (PVV)",0.990152921417838,0.947053231939163,0
"<anonymized_userid>",1,56009,9964,"Geert Wilders (PVV)",0.990170600194467,0.947148288973384,0
"<anonymized_userid>",1,56010,9965,"Geert Wilders (PVV)",0.990188278971095,0.947243346007605,0
"<anonymized_userid>",1,56011,9966,"Geert Wilders (PVV)",0.990205957747724,0.947338403041825,0
"<anonymized_userid>",1,56012,9967,"Geert Wilders (PVV)",0.990223636524353,0.947433460076046,0
"<anonymized_userid>",1,56013,9968,"Geert Wilders (PVV)",0.990241315300981,0.947528517110266,0
"<anonymized_userid>",1,56014,9969,"Geert Wilders (PVV)",0.99025899407761,0.947623574144487,0
"<anonymized_userid>",1,56015,9970,"Geert Wilders (PVV)",0.990276672854238,0.947718631178707,0
"<anonymized_userid>",1,56016,9971,"Geert Wilders (PVV)",0.990294351630867,0.947813688212928,0
"<anonymized_userid>",1,56017,9972,"Geert Wilders (PVV)",0.990312030407496,0.947908745247148,0
"<anonymized_userid>",1,56018,9973,"Geert Wilders (PVV)",0.990329709184124,0.948003802281369,0
"<anonymized_userid>",1,56019,9974,"Geert Wilders (PVV)",0.990347387960753,0.948098859315589,0
"<anonymized_userid>",1,56020,9975,"Geert Wilders (PVV)",0.990365066737382,0.94819391634981,0
"<anonymized_userid>",1,56021,9976,"Geert Wilders (PVV)",0.99038274551401,0.94828897338403,0
"<anonymized_userid>",1,56022,9977,"Geert Wilders (PVV)",0.990400424290639,0.948384030418251,0
"<anonymized_userid>",1,56023,9978,"Geert Wilders (PVV)",0.990418103067268,0.948479087452471,0
"<anonymized_userid>",1,56024,9979,"Geert Wilders (PVV)",0.990435781843896,0.948574144486692,0
"<anonymized_userid>",1,56025,9980,"Geert Wilders (PVV)",0.990453460620525,0.948669201520912,0
"<anonymized_userid>",1,56026,9981,"Geert Wilders (PVV)",0.990471139397154,0.948764258555133,0
"<anonymized_userid>",1,56027,9982,"Geert Wilders (PVV)",0.990488818173782,0.948859315589354,0
"<anonymized_userid>",1,56028,9983,"Geert Wilders (PVV)",0.990506496950411,0.948954372623574,0
"<anonymized_userid>",1,56029,9984,"Geert Wilders (PVV)",0.99052417572704,0.949049429657795,0
"<anonymized_userid>",1,56030,9985,"Geert Wilders (PVV)",0.990541854503668,0.949144486692015,0
"<anonymized_userid>",1,56031,9986,"Geert Wilders (PVV)",0.990559533280297,0.949239543726236,0
"<anonymized_userid>",1,56032,9987,"Geert Wilders (PVV)",0.990577212056926,0.949334600760456,0
"<anonymized_userid>",1,56033,9988,"Geert Wilders (PVV)",0.990594890833554,0.949429657794677,0
"<anonymized_userid>",1,56034,9989,"Geert Wilders (PVV)",0.990612569610183,0.949524714828897,0
"<anonymized_userid>",1,56035,9990,"Geert Wilders (PVV)",0.990630248386812,0.949619771863118,0
"<anonymized_userid>",1,56036,9991,"Geert Wilders (PVV)",0.99064792716344,0.949714828897338,0
"<anonymized_userid>",1,56037,9992,"Geert Wilders (PVV)",0.990665605940069,0.949809885931559,0
"<anonymized_userid>",1,56038,9993,"Geert Wilders (PVV)",0.990683284716698,0.949904942965779,0
"<anonymized_userid>",1,56039,9994,"Geert Wilders (PVV)",0.990700963493326,0.95,0
"<anonymized_userid>",1,56040,9995,"Geert Wilders (PVV)",0.990718642269955,0.95009505703422,0
"<anonymized_userid>",1,56041,9996,"Geert Wilders (PVV)",0.990736321046584,0.950190114068441,0
"<anonymized_userid>",1,56042,9997,"Geert Wilders (PVV)",0.990753999823212,0.950285171102662,0
"<anonymized_userid>",1,56043,9998,"Geert Wilders (PVV)",0.990771678599841,0.950380228136882,0
"<anonymized_userid>",1,56044,9999,"Geert Wilders (PVV)",0.99078935737647,0.950475285171103,0
"<anonymized_userid>",1,56045,10000,"Geert Wilders (PVV)",0.990807036153098,0.950570342205323,0
"<anonymized_userid>",1,56046,10001,"Geert Wilders (PVV)",0.990824714929727,0.950665399239544,0
"<anonymized_userid>",1,56047,10002,"Geert Wilders (PVV)",0.990842393706356,0.950760456273764,0
"<anonymized_userid>",1,56048,10003,"Geert Wilders (PVV)",0.990860072482984,0.950855513307985,0
"<anonymized_userid>",1,56049,10004,"Geert Wilders (PVV)",0.990877751259613,0.950950570342205,0
"<anonymized_userid>",1,56050,10005,"Geert Wilders (PVV)",0.990895430036241,0.951045627376426,0
"<anonymized_userid>",1,56051,10006,"Geert Wilders (PVV)",0.99091310881287,0.951140684410646,0
"<anonymized_userid>",1,56052,10007,"Geert Wilders (PVV)",0.990930787589499,0.951235741444867,0
"<anonymized_userid>",1,56053,10008,"Geert Wilders (PVV)",0.990948466366127,0.951330798479087,0
"<anonymized_userid>",1,56054,10009,"Geert Wilders (PVV)",0.990966145142756,0.951425855513308,0
"<anonymized_userid>",1,56055,10010,"Geert Wilders (PVV)",0.990983823919385,0.951520912547528,0
"<anonymized_userid>",1,56056,10011,"Geert Wilders (PVV)",0.991001502696013,0.951615969581749,0
"<anonymized_userid>",1,56057,10012,"Geert Wilders (PVV)",0.991019181472642,0.95171102661597,0
"<anonymized_userid>",1,56058,10013,"Geert Wilders (PVV)",0.991036860249271,0.95180608365019,0
"<anonymized_userid>",1,56059,10014,"Geert Wilders (PVV)",0.991054539025899,0.951901140684411,0
"<anonymized_userid>",1,56060,10015,"Geert Wilders (PVV)",0.991072217802528,0.951996197718631,0
"<anonymized_userid>",1,56061,10016,"Geert Wilders (PVV)",0.991089896579157,0.952091254752852,0
"<anonymized_userid>",1,56062,10017,"Geert Wilders (PVV)",0.991107575355785,0.952186311787072,0
"<anonymized_userid>",1,56063,10018,"Geert Wilders (PVV)",0.991125254132414,0.952281368821293,0
"<anonymized_userid>",1,56064,10019,"Geert Wilders (PVV)",0.991142932909043,0.952376425855513,0
"<anonymized_userid>",1,56065,10020,"Geert Wilders (PVV)",0.991160611685671,0.952471482889734,0
"<anonymized_userid>",1,56066,10021,"Geert Wilders (PVV)",0.9911782904623,0.952566539923954,0
"<anonymized_userid>",1,56067,10022,"Geert Wilders (PVV)",0.991195969238929,0.952661596958175,0
"<anonymized_userid>",1,56068,10023,"Geert Wilders (PVV)",0.991213648015557,0.952756653992395,0
"<anonymized_userid>",1,56069,10024,"Geert Wilders (PVV)",0.991231326792186,0.952851711026616,0
"<anonymized_userid>",1,56070,10025,"Geert Wilders (PVV)",0.991249005568815,0.952946768060836,0
"<anonymized_userid>",1,56071,10026,"Geert Wilders (PVV)",0.991266684345443,0.953041825095057,0
"<anonymized_userid>",1,56072,10027,"Geert Wilders (PVV)",0.991284363122072,0.953136882129278,0
"<anonymized_userid>",1,56073,10028,"Geert Wilders (PVV)",0.991302041898701,0.953231939163498,0
"<anonymized_userid>",1,56074,10029,"Geert Wilders (PVV)",0.991319720675329,0.953326996197719,0
"<anonymized_userid>",1,56075,10030,"Geert Wilders (PVV)",0.991337399451958,0.953422053231939,0
"<anonymized_userid>",1,56076,10031,"Geert Wilders (PVV)",0.991355078228587,0.95351711026616,0
"<anonymized_userid>",1,56077,10032,"Geert Wilders (PVV)",0.991372757005215,0.95361216730038,0
"<anonymized_userid>",1,56078,10033,"Geert Wilders (PVV)",0.991390435781844,0.953707224334601,0
"<anonymized_userid>",1,56079,10034,"Geert Wilders (PVV)",0.991408114558473,0.953802281368821,0
"<anonymized_userid>",1,56080,10035,"Geert Wilders (PVV)",0.991425793335101,0.953897338403042,0
"<anonymized_userid>",1,56081,10036,"Geert Wilders (PVV)",0.99144347211173,0.953992395437262,0
"<anonymized_userid>",1,56082,10037,"Geert Wilders (PVV)",0.991461150888359,0.954087452471483,0
"<anonymized_userid>",1,56083,10038,"Geert Wilders (PVV)",0.991478829664987,0.954182509505703,0
"<anonymized_userid>",1,56084,10039,"Geert Wilders (PVV)",0.991496508441616,0.954277566539924,0
"<anonymized_userid>",1,56085,10040,"Geert Wilders (PVV)",0.991514187218244,0.954372623574145,0
"<anonymized_userid>",1,56086,10041,"Geert Wilders (PVV)",0.991531865994873,0.954467680608365,0
"<anonymized_userid>",1,56087,10042,"Geert Wilders (PVV)",0.991549544771502,0.954562737642586,0
"<anonymized_userid>",1,56088,10043,"Geert Wilders (PVV)",0.99156722354813,0.954657794676806,0
"<anonymized_userid>",1,56089,10044,"Geert Wilders (PVV)",0.991584902324759,0.954752851711027,0
"<anonymized_userid>",1,56090,10045,"Geert Wilders (PVV)",0.991602581101388,0.954847908745247,0
"<anonymized_userid>",1,56091,10046,"Geert Wilders (PVV)",0.991620259878016,0.954942965779468,0
"<anonymized_userid>",1,56092,10047,"Geert Wilders (PVV)",0.991637938654645,0.955038022813688,0
"<anonymized_userid>",1,56093,10048,"Geert Wilders (PVV)",0.991655617431274,0.955133079847909,0
"<anonymized_userid>",1,56094,10049,"Geert Wilders (PVV)",0.991673296207902,0.955228136882129,0
"<anonymized_userid>",1,56095,10050,"Geert Wilders (PVV)",0.991690974984531,0.95532319391635,0
"<anonymized_userid>",1,56096,10051,"Geert Wilders (PVV)",0.99170865376116,0.95541825095057,0
"<anonymized_userid>",1,56097,10052,"Geert Wilders (PVV)",0.991726332537788,0.955513307984791,0
"<anonymized_userid>",1,56098,10053,"Geert Wilders (PVV)",0.991744011314417,0.955608365019011,0
"<anonymized_userid>",1,56099,10054,"Geert Wilders (PVV)",0.991761690091046,0.955703422053232,0
"<anonymized_userid>",1,56100,10055,"Geert Wilders (PVV)",0.991779368867674,0.955798479087453,0
"<anonymized_userid>",1,56101,10056,"Geert Wilders (PVV)",0.991797047644303,0.955893536121673,0
"<anonymized_userid>",1,56102,10057,"Geert Wilders (PVV)",0.991814726420932,0.955988593155894,0
"<anonymized_userid>",1,56103,10058,"Geert Wilders (PVV)",0.99183240519756,0.956083650190114,0
"<anonymized_userid>",1,56104,10059,"Geert Wilders (PVV)",0.991850083974189,0.956178707224335,0
"<anonymized_userid>",1,56105,10060,"Geert Wilders (PVV)",0.991867762750818,0.956273764258555,0
"<anonymized_userid>",1,56106,10061,"Geert Wilders (PVV)",0.991885441527446,0.956368821292776,0
"<anonymized_userid>",1,56107,10062,"Geert Wilders (PVV)",0.991903120304075,0.956463878326996,0
"<anonymized_userid>",1,56108,10063,"Geert Wilders (PVV)",0.991920799080704,0.956558935361217,0
"<anonymized_userid>",1,56109,10064,"Geert Wilders (PVV)",0.991938477857332,0.956653992395437,0
"<anonymized_userid>",1,56110,10065,"Geert Wilders (PVV)",0.991956156633961,0.956749049429658,0
"<anonymized_userid>",1,56111,10066,"Geert Wilders (PVV)",0.99197383541059,0.956844106463878,0
"<anonymized_userid>",1,56112,10067,"Geert Wilders (PVV)",0.991991514187218,0.956939163498099,0
"<anonymized_userid>",1,56113,10068,"Geert Wilders (PVV)",0.992009192963847,0.957034220532319,0
"<anonymized_userid>",1,56114,10069,"Geert Wilders (PVV)",0.992026871740476,0.95712927756654,0
"<anonymized_userid>",1,56115,10070,"Geert Wilders (PVV)",0.992044550517104,0.957224334600761,0
"<anonymized_userid>",1,56116,10071,"Geert Wilders (PVV)",0.992062229293733,0.957319391634981,0
"<anonymized_userid>",1,56117,10072,"Geert Wilders (PVV)",0.992079908070362,0.957414448669202,0
"<anonymized_userid>",1,56118,10073,"Geert Wilders (PVV)",0.99209758684699,0.957509505703422,0
"<anonymized_userid>",1,56119,10074,"Geert Wilders (PVV)",0.992115265623619,0.957604562737643,0
"<anonymized_userid>",1,56120,10075,"Geert Wilders (PVV)",0.992132944400247,0.957699619771863,0
"<anonymized_userid>",1,56121,10076,"Geert Wilders (PVV)",0.992150623176876,0.957794676806084,0
"<anonymized_userid>",1,56122,10077,"Geert Wilders (PVV)",0.992168301953505,0.957889733840304,0
"<anonymized_userid>",1,56123,10078,"Geert Wilders (PVV)",0.992185980730133,0.957984790874525,0
"<anonymized_userid>",1,56124,10079,"Geert Wilders (PVV)",0.992203659506762,0.958079847908745,0
"<anonymized_userid>",1,56125,10080,"Geert Wilders (PVV)",0.992221338283391,0.958174904942966,0
"<anonymized_userid>",1,56126,10081,"Geert Wilders (PVV)",0.992239017060019,0.958269961977186,0
"<anonymized_userid>",1,56127,10082,"Geert Wilders (PVV)",0.992256695836648,0.958365019011407,0
"<anonymized_userid>",1,56128,10083,"Geert Wilders (PVV)",0.992274374613277,0.958460076045627,0
"<anonymized_userid>",1,56129,10084,"Geert Wilders (PVV)",0.992292053389905,0.958555133079848,0
"<anonymized_userid>",1,56130,10085,"Geert Wilders (PVV)",0.992309732166534,0.958650190114068,0
"<anonymized_userid>",1,56131,10086,"Geert Wilders (PVV)",0.992327410943163,0.958745247148289,0
"<anonymized_userid>",1,56132,10087,"Geert Wilders (PVV)",0.992345089719791,0.95884030418251,0
"<anonymized_userid>",1,56133,10088,"Geert Wilders (PVV)",0.99236276849642,0.95893536121673,0
"<anonymized_userid>",1,56134,10089,"Geert Wilders (PVV)",0.992380447273049,0.959030418250951,0
"<anonymized_userid>",1,56135,10090,"Geert Wilders (PVV)",0.992398126049677,0.959125475285171,0
"<anonymized_userid>",1,56136,10091,"Geert Wilders (PVV)",0.992415804826306,0.959220532319392,0
"<anonymized_userid>",1,56137,10092,"Geert Wilders (PVV)",0.992433483602935,0.959315589353612,0
"<anonymized_userid>",1,56138,10093,"Geert Wilders (PVV)",0.992451162379563,0.959410646387833,0
"<anonymized_userid>",1,56139,10094,"Geert Wilders (PVV)",0.992468841156192,0.959505703422053,0
"<anonymized_userid>",1,56140,10095,"Geert Wilders (PVV)",0.992486519932821,0.959600760456274,0
"<anonymized_userid>",1,56141,10096,"Geert Wilders (PVV)",0.992504198709449,0.959695817490494,0
"<anonymized_userid>",1,56142,10097,"Geert Wilders (PVV)",0.992521877486078,0.959790874524715,0
"<anonymized_userid>",1,56143,10098,"Geert Wilders (PVV)",0.992539556262707,0.959885931558935,0
"<anonymized_userid>",1,56144,10099,"Geert Wilders (PVV)",0.992557235039335,0.959980988593156,0
"<anonymized_userid>",1,56145,10100,"Geert Wilders (PVV)",0.992574913815964,0.960076045627376,0
"<anonymized_userid>",1,56146,10101,"Geert Wilders (PVV)",0.992592592592593,0.960171102661597,0
"<anonymized_userid>",1,56147,10102,"Geert Wilders (PVV)",0.992610271369221,0.960266159695818,0
"<anonymized_userid>",1,56148,10103,"Geert Wilders (PVV)",0.99262795014585,0.960361216730038,0
"<anonymized_userid>",1,56149,10104,"Geert Wilders (PVV)",0.992645628922479,0.960456273764259,0
"<anonymized_userid>",1,56150,10105,"Geert Wilders (PVV)",0.992663307699107,0.960551330798479,0
"<anonymized_userid>",1,56151,10106,"Geert Wilders (PVV)",0.992680986475736,0.9606463878327,0
"<anonymized_userid>",1,56152,10107,"Geert Wilders (PVV)",0.992698665252364,0.96074144486692,0
"<anonymized_userid>",1,56153,10108,"Geert Wilders (PVV)",0.992716344028993,0.960836501901141,0
"<anonymized_userid>",1,56154,10109,"Geert Wilders (PVV)",0.992734022805622,0.960931558935361,0
"<anonymized_userid>",1,56155,10110,"Geert Wilders (PVV)",0.99275170158225,0.961026615969582,0
"<anonymized_userid>",1,56156,10111,"Geert Wilders (PVV)",0.992769380358879,0.961121673003802,0
"<anonymized_userid>",1,56157,10112,"Geert Wilders (PVV)",0.992787059135508,0.961216730038023,0
"<anonymized_userid>",1,56158,10113,"Geert Wilders (PVV)",0.992804737912137,0.961311787072243,0
"<anonymized_userid>",1,56159,10114,"Geert Wilders (PVV)",0.992822416688765,0.961406844106464,0
"<anonymized_userid>",1,56160,10115,"Geert Wilders (PVV)",0.992840095465394,0.961501901140684,0
"<anonymized_userid>",1,56161,10116,"Geert Wilders (PVV)",0.992857774242022,0.961596958174905,0
"<anonymized_userid>",1,56162,10117,"Geert Wilders (PVV)",0.992875453018651,0.961692015209126,0
"<anonymized_userid>",1,56163,10118,"Geert Wilders (PVV)",0.99289313179528,0.961787072243346,0
"<anonymized_userid>",1,56164,10119,"Geert Wilders (PVV)",0.992910810571908,0.961882129277567,0
"<anonymized_userid>",1,56165,10120,"Geert Wilders (PVV)",0.992928489348537,0.961977186311787,0
"<anonymized_userid>",1,56166,10121,"Geert Wilders (PVV)",0.992946168125166,0.962072243346008,0
"<anonymized_userid>",1,56167,10122,"Geert Wilders (PVV)",0.992963846901794,0.962167300380228,0
"<anonymized_userid>",1,56168,10123,"Geert Wilders (PVV)",0.992981525678423,0.962262357414449,0
"<anonymized_userid>",1,56169,10124,"Geert Wilders (PVV)",0.992999204455052,0.962357414448669,0
"<anonymized_userid>",1,56170,10125,"Geert Wilders (PVV)",0.99301688323168,0.96245247148289,0
"<anonymized_userid>",1,56171,10126,"Geert Wilders (PVV)",0.993034562008309,0.96254752851711,0
"<anonymized_userid>",1,56172,10127,"Geert Wilders (PVV)",0.993052240784938,0.962642585551331,0
"<anonymized_userid>",1,56173,10128,"Geert Wilders (PVV)",0.993069919561566,0.962737642585551,0
"<anonymized_userid>",1,56174,10129,"Geert Wilders (PVV)",0.993087598338195,0.962832699619772,0
"<anonymized_userid>",1,56175,10130,"Geert Wilders (PVV)",0.993105277114824,0.962927756653992,0
"<anonymized_userid>",1,56176,10131,"Geert Wilders (PVV)",0.993122955891452,0.963022813688213,0
"<anonymized_userid>",1,56177,10132,"Geert Wilders (PVV)",0.993140634668081,0.963117870722433,0
"<anonymized_userid>",1,56178,10133,"Geert Wilders (PVV)",0.99315831344471,0.963212927756654,0
"<anonymized_userid>",1,56179,10134,"Geert Wilders (PVV)",0.993175992221338,0.963307984790875,0
"<anonymized_userid>",1,56180,10135,"Geert Wilders (PVV)",0.993193670997967,0.963403041825095,0
"<anonymized_userid>",1,56181,10136,"Geert Wilders (PVV)",0.993211349774596,0.963498098859316,0
"<anonymized_userid>",1,56182,10137,"Geert Wilders (PVV)",0.993229028551224,0.963593155893536,0
"<anonymized_userid>",1,56183,10138,"Geert Wilders (PVV)",0.993246707327853,0.963688212927757,0
"<anonymized_userid>",1,56184,10139,"Geert Wilders (PVV)",0.993264386104482,0.963783269961977,0
"<anonymized_userid>",1,56185,10140,"Geert Wilders (PVV)",0.99328206488111,0.963878326996198,0
"<anonymized_userid>",1,56186,10141,"Geert Wilders (PVV)",0.993299743657739,0.963973384030418,0
"<anonymized_userid>",1,56187,10142,"Geert Wilders (PVV)",0.993317422434367,0.964068441064639,0
"<anonymized_userid>",1,56188,10143,"Geert Wilders (PVV)",0.993335101210996,0.964163498098859,0
"<anonymized_userid>",1,56189,10144,"Geert Wilders (PVV)",0.993352779987625,0.96425855513308,0
"<anonymized_userid>",1,56190,10145,"Geert Wilders (PVV)",0.993370458764254,0.9643536121673,0
"<anonymized_userid>",1,56191,10146,"Geert Wilders (PVV)",0.993388137540882,0.964448669201521,0
"<anonymized_userid>",1,56192,10147,"Geert Wilders (PVV)",0.993405816317511,0.964543726235741,0
"<anonymized_userid>",1,56193,10148,"Geert Wilders (PVV)",0.99342349509414,0.964638783269962,0
"<anonymized_userid>",1,56194,10149,"Geert Wilders (PVV)",0.993441173870768,0.964733840304183,0
"<anonymized_userid>",1,56195,10150,"Geert Wilders (PVV)",0.993458852647397,0.964828897338403,0
"<anonymized_userid>",1,56196,10151,"Geert Wilders (PVV)",0.993476531424025,0.964923954372624,0
"<anonymized_userid>",1,56197,10152,"Geert Wilders (PVV)",0.993494210200654,0.965019011406844,0
"<anonymized_userid>",1,56198,10153,"Geert Wilders (PVV)",0.993511888977283,0.965114068441065,0
"<anonymized_userid>",1,56199,10154,"Geert Wilders (PVV)",0.993529567753911,0.965209125475285,0
"<anonymized_userid>",1,56200,10155,"Geert Wilders (PVV)",0.99354724653054,0.965304182509506,0
"<anonymized_userid>",1,56201,10156,"Geert Wilders (PVV)",0.993564925307169,0.965399239543726,0
"<anonymized_userid>",1,56202,10157,"Geert Wilders (PVV)",0.993582604083797,0.965494296577947,0
"<anonymized_userid>",1,56203,10158,"Geert Wilders (PVV)",0.993600282860426,0.965589353612167,0
"<anonymized_userid>",1,56204,10159,"Geert Wilders (PVV)",0.993617961637055,0.965684410646388,0
"<anonymized_userid>",1,56205,10160,"Geert Wilders (PVV)",0.993635640413683,0.965779467680608,0
"<anonymized_userid>",1,56206,10161,"Geert Wilders (PVV)",0.993653319190312,0.965874524714829,0
"<anonymized_userid>",1,56207,10162,"Geert Wilders (PVV)",0.993670997966941,0.965969581749049,0
"<anonymized_userid>",1,56208,10163,"Geert Wilders (PVV)",0.993688676743569,0.96606463878327,0
"<anonymized_userid>",1,56209,10164,"Geert Wilders (PVV)",0.993706355520198,0.966159695817491,0
"<anonymized_userid>",1,56210,10165,"Geert Wilders (PVV)",0.993724034296827,0.966254752851711,0
"<anonymized_userid>",1,56211,10166,"Geert Wilders (PVV)",0.993741713073455,0.966349809885932,0
"<anonymized_userid>",1,56212,10167,"Geert Wilders (PVV)",0.993759391850084,0.966444866920152,0
"<anonymized_userid>",1,56213,10168,"Geert Wilders (PVV)",0.993777070626713,0.966539923954373,0
"<anonymized_userid>",1,56214,10169,"Geert Wilders (PVV)",0.993794749403341,0.966634980988593,0
"<anonymized_userid>",1,56215,10170,"Geert Wilders (PVV)",0.99381242817997,0.966730038022814,0
"<anonymized_userid>",1,56216,10171,"Geert Wilders (PVV)",0.993830106956599,0.966825095057034,0
"<anonymized_userid>",1,56217,10172,"Geert Wilders (PVV)",0.993847785733227,0.966920152091255,0
"<anonymized_userid>",1,56218,10173,"Geert Wilders (PVV)",0.993865464509856,0.967015209125475,0
"<anonymized_userid>",1,56219,10174,"Geert Wilders (PVV)",0.993883143286485,0.967110266159696,0
"<anonymized_userid>",1,56220,10175,"Geert Wilders (PVV)",0.993900822063113,0.967205323193916,0
"<anonymized_userid>",1,56221,10176,"Geert Wilders (PVV)",0.993918500839742,0.967300380228137,0
"<anonymized_userid>",1,56222,10177,"Geert Wilders (PVV)",0.993936179616371,0.967395437262357,0
"<anonymized_userid>",1,56223,10178,"Geert Wilders (PVV)",0.993953858392999,0.967490494296578,0
"<anonymized_userid>",1,56224,10179,"Geert Wilders (PVV)",0.993971537169628,0.967585551330798,0
"<anonymized_userid>",1,56225,10180,"Geert Wilders (PVV)",0.993989215946257,0.967680608365019,0
"<anonymized_userid>",1,56226,10181,"Geert Wilders (PVV)",0.994006894722885,0.96777566539924,0
"<anonymized_userid>",1,56227,10182,"Geert Wilders (PVV)",0.994024573499514,0.96787072243346,0
"<anonymized_userid>",1,56228,10183,"Geert Wilders (PVV)",0.994042252276143,0.967965779467681,0
"<anonymized_userid>",1,56229,10184,"Geert Wilders (PVV)",0.994059931052771,0.968060836501901,0
"<anonymized_userid>",1,56230,10185,"Geert Wilders (PVV)",0.9940776098294,0.968155893536122,0
"<anonymized_userid>",1,56231,10186,"Geert Wilders (PVV)",0.994095288606028,0.968250950570342,0
"<anonymized_userid>",1,56232,10187,"Geert Wilders (PVV)",0.994112967382657,0.968346007604563,0
"<anonymized_userid>",1,56233,10188,"Geert Wilders (PVV)",0.994130646159286,0.968441064638783,0
"<anonymized_userid>",1,56234,10189,"Geert Wilders (PVV)",0.994148324935914,0.968536121673004,0
"<anonymized_userid>",1,56235,10190,"Geert Wilders (PVV)",0.994166003712543,0.968631178707224,0
"<anonymized_userid>",1,56236,10191,"Geert Wilders (PVV)",0.994183682489172,0.968726235741445,0
"<anonymized_userid>",1,56237,10192,"Geert Wilders (PVV)",0.9942013612658,0.968821292775665,0
"<anonymized_userid>",1,56238,10193,"Geert Wilders (PVV)",0.994219040042429,0.968916349809886,0
"<anonymized_userid>",1,56239,10194,"Geert Wilders (PVV)",0.994236718819058,0.969011406844106,0
"<anonymized_userid>",1,56240,10195,"Geert Wilders (PVV)",0.994254397595686,0.969106463878327,0
"<anonymized_userid>",1,56241,10196,"Geert Wilders (PVV)",0.994272076372315,0.969201520912548,0
"<anonymized_userid>",1,56242,10197,"Geert Wilders (PVV)",0.994289755148944,0.969296577946768,0
"<anonymized_userid>",1,56243,10198,"Geert Wilders (PVV)",0.994307433925572,0.969391634980989,0
"<anonymized_userid>",1,56244,10199,"Geert Wilders (PVV)",0.994325112702201,0.969486692015209,0
"<anonymized_userid>",1,56245,10200,"Geert Wilders (PVV)",0.99434279147883,0.96958174904943,0
"<anonymized_userid>",1,56246,10201,"Geert Wilders (PVV)",0.994360470255458,0.96967680608365,0
"<anonymized_userid>",1,56247,10202,"Geert Wilders (PVV)",0.994378149032087,0.969771863117871,0
"<anonymized_userid>",1,56248,10203,"Geert Wilders (PVV)",0.994395827808716,0.969866920152091,0
"<anonymized_userid>",1,56249,10204,"Geert Wilders (PVV)",0.994413506585344,0.969961977186312,0
"<anonymized_userid>",1,56250,10205,"Geert Wilders (PVV)",0.994431185361973,0.970057034220532,0
"<anonymized_userid>",1,56251,10206,"Geert Wilders (PVV)",0.994448864138602,0.970152091254753,0
"<anonymized_userid>",1,56252,10207,"Geert Wilders (PVV)",0.99446654291523,0.970247148288973,0
"<anonymized_userid>",1,56253,10208,"Geert Wilders (PVV)",0.994484221691859,0.970342205323194,0
"<anonymized_userid>",1,56254,10209,"Geert Wilders (PVV)",0.994501900468488,0.970437262357414,0
"<anonymized_userid>",1,56255,10210,"Geert Wilders (PVV)",0.994519579245116,0.970532319391635,0
"<anonymized_userid>",1,56256,10211,"Geert Wilders (PVV)",0.994537258021745,0.970627376425856,0
"<anonymized_userid>",1,56257,10212,"Geert Wilders (PVV)",0.994554936798374,0.970722433460076,0
"<anonymized_userid>",1,56258,10213,"Geert Wilders (PVV)",0.994572615575002,0.970817490494297,0
"<anonymized_userid>",1,56259,10214,"Geert Wilders (PVV)",0.994590294351631,0.970912547528517,0
"<anonymized_userid>",1,56260,10215,"Geert Wilders (PVV)",0.99460797312826,0.971007604562738,0
"<anonymized_userid>",1,56261,10216,"Geert Wilders (PVV)",0.994625651904888,0.971102661596958,0
"<anonymized_userid>",1,56262,10217,"Geert Wilders (PVV)",0.994643330681517,0.971197718631179,0
"<anonymized_userid>",1,56263,10218,"Geert Wilders (PVV)",0.994661009458146,0.971292775665399,0
"<anonymized_userid>",1,56264,10219,"Geert Wilders (PVV)",0.994678688234774,0.97138783269962,0
"<anonymized_userid>",1,56265,10220,"Geert Wilders (PVV)",0.994696367011403,0.97148288973384,0
"<anonymized_userid>",1,56266,10221,"Geert Wilders (PVV)",0.994714045788031,0.971577946768061,0
"<anonymized_userid>",1,56267,10222,"Geert Wilders (PVV)",0.99473172456466,0.971673003802281,0
"<anonymized_userid>",1,56268,10223,"Geert Wilders (PVV)",0.994749403341289,0.971768060836502,0
"<anonymized_userid>",1,56269,10224,"Geert Wilders (PVV)",0.994767082117917,0.971863117870722,0
"<anonymized_userid>",1,56270,10225,"Geert Wilders (PVV)",0.994784760894546,0.971958174904943,0
"<anonymized_userid>",1,56271,10226,"Geert Wilders (PVV)",0.994802439671175,0.972053231939163,0
"<anonymized_userid>",1,56272,10227,"Geert Wilders (PVV)",0.994820118447803,0.972148288973384,0
"<anonymized_userid>",1,56273,10228,"Geert Wilders (PVV)",0.994837797224432,0.972243346007605,0
"<anonymized_userid>",1,56274,10229,"Geert Wilders (PVV)",0.994855476001061,0.972338403041825,0
"<anonymized_userid>",1,56275,10230,"Geert Wilders (PVV)",0.994873154777689,0.972433460076046,0
"<anonymized_userid>",1,56276,10231,"Geert Wilders (PVV)",0.994890833554318,0.972528517110266,0
"<anonymized_userid>",1,56277,10232,"Geert Wilders (PVV)",0.994908512330947,0.972623574144487,0
"<anonymized_userid>",1,56278,10233,"Geert Wilders (PVV)",0.994926191107575,0.972718631178707,0
"<anonymized_userid>",1,56279,10234,"Geert Wilders (PVV)",0.994943869884204,0.972813688212928,0
"<anonymized_userid>",1,56280,10235,"Geert Wilders (PVV)",0.994961548660833,0.972908745247148,0
"<anonymized_userid>",1,56281,10236,"Geert Wilders (PVV)",0.994979227437461,0.973003802281369,0
"<anonymized_userid>",1,56282,10237,"Geert Wilders (PVV)",0.99499690621409,0.973098859315589,0
"<anonymized_userid>",1,56283,10238,"Geert Wilders (PVV)",0.995014584990719,0.97319391634981,0
"<anonymized_userid>",1,56284,10239,"Geert Wilders (PVV)",0.995032263767347,0.97328897338403,0
"<anonymized_userid>",1,56285,10240,"Geert Wilders (PVV)",0.995049942543976,0.973384030418251,0
"<anonymized_userid>",1,56286,10241,"Geert Wilders (PVV)",0.995067621320605,0.973479087452471,0
"<anonymized_userid>",1,56287,10242,"Geert Wilders (PVV)",0.995085300097233,0.973574144486692,0
"<anonymized_userid>",1,56288,10243,"Geert Wilders (PVV)",0.995102978873862,0.973669201520913,0
"<anonymized_userid>",1,56289,10244,"Geert Wilders (PVV)",0.995120657650491,0.973764258555133,0
"<anonymized_userid>",1,56290,10245,"Geert Wilders (PVV)",0.995138336427119,0.973859315589354,0
"<anonymized_userid>",1,56291,10246,"Geert Wilders (PVV)",0.995156015203748,0.973954372623574,0
"<anonymized_userid>",1,56292,10247,"Geert Wilders (PVV)",0.995173693980377,0.974049429657795,0
"<anonymized_userid>",1,56293,10248,"Geert Wilders (PVV)",0.995191372757005,0.974144486692015,0
"<anonymized_userid>",1,56294,10249,"Geert Wilders (PVV)",0.995209051533634,0.974239543726236,0
"<anonymized_userid>",1,56295,10250,"Geert Wilders (PVV)",0.995226730310263,0.974334600760456,0
"<anonymized_userid>",1,56296,10251,"Geert Wilders (PVV)",0.995244409086891,0.974429657794677,0
"<anonymized_userid>",1,56297,10252,"Geert Wilders (PVV)",0.99526208786352,0.974524714828897,0
"<anonymized_userid>",1,56298,10253,"Geert Wilders (PVV)",0.995279766640148,0.974619771863118,0
"<anonymized_userid>",1,56299,10254,"Geert Wilders (PVV)",0.995297445416777,0.974714828897338,0
"<anonymized_userid>",1,56300,10255,"Geert Wilders (PVV)",0.995315124193406,0.974809885931559,0
"<anonymized_userid>",1,56301,10256,"Geert Wilders (PVV)",0.995332802970034,0.974904942965779,0
"<anonymized_userid>",1,56302,10257,"Geert Wilders (PVV)",0.995350481746663,0.975,0
"<anonymized_userid>",1,56303,10258,"Geert Wilders (PVV)",0.995368160523292,0.975095057034221,0
"<anonymized_userid>",1,56304,10259,"Geert Wilders (PVV)",0.99538583929992,0.975190114068441,0
"<anonymized_userid>",1,56305,10260,"Geert Wilders (PVV)",0.995403518076549,0.975285171102662,0
"<anonymized_userid>",1,56306,10261,"Geert Wilders (PVV)",0.995421196853178,0.975380228136882,0
"<anonymized_userid>",1,56307,10262,"Geert Wilders (PVV)",0.995438875629806,0.975475285171103,0
"<anonymized_userid>",1,56308,10263,"Geert Wilders (PVV)",0.995456554406435,0.975570342205323,0
"<anonymized_userid>",1,56309,10264,"Geert Wilders (PVV)",0.995474233183064,0.975665399239544,0
"<anonymized_userid>",1,56310,10265,"Geert Wilders (PVV)",0.995491911959692,0.975760456273764,0
"<anonymized_userid>",1,56311,10266,"Geert Wilders (PVV)",0.995509590736321,0.975855513307985,0
"<anonymized_userid>",1,56312,10267,"Geert Wilders (PVV)",0.99552726951295,0.975950570342205,0
"<anonymized_userid>",1,56313,10268,"Geert Wilders (PVV)",0.995544948289578,0.976045627376426,0
"<anonymized_userid>",1,56314,10269,"Geert Wilders (PVV)",0.995562627066207,0.976140684410646,0
"<anonymized_userid>",1,56315,10270,"Geert Wilders (PVV)",0.995580305842836,0.976235741444867,0
"<anonymized_userid>",1,56316,10271,"Geert Wilders (PVV)",0.995597984619464,0.976330798479087,0
"<anonymized_userid>",1,56317,10272,"Geert Wilders (PVV)",0.995615663396093,0.976425855513308,0
"<anonymized_userid>",1,56318,10273,"Geert Wilders (PVV)",0.995633342172722,0.976520912547528,0
"<anonymized_userid>",1,56319,10274,"Geert Wilders (PVV)",0.99565102094935,0.976615969581749,0
"<anonymized_userid>",1,56320,10275,"Geert Wilders (PVV)",0.995668699725979,0.97671102661597,0
"<anonymized_userid>",1,56321,10276,"Geert Wilders (PVV)",0.995686378502608,0.97680608365019,0
"<anonymized_userid>",1,56322,10277,"Geert Wilders (PVV)",0.995704057279236,0.976901140684411,0
"<anonymized_userid>",1,56323,10278,"Geert Wilders (PVV)",0.995721736055865,0.976996197718631,0
"<anonymized_userid>",1,56324,10279,"Geert Wilders (PVV)",0.995739414832494,0.977091254752852,0
"<anonymized_userid>",1,56325,10280,"Geert Wilders (PVV)",0.995757093609122,0.977186311787072,0
"<anonymized_userid>",1,56326,10281,"Geert Wilders (PVV)",0.995774772385751,0.977281368821293,0
"<anonymized_userid>",1,56327,10282,"Geert Wilders (PVV)",0.99579245116238,0.977376425855513,0
"<anonymized_userid>",1,56328,10283,"Geert Wilders (PVV)",0.995810129939008,0.977471482889734,0
"<anonymized_userid>",1,56329,10284,"Geert Wilders (PVV)",0.995827808715637,0.977566539923954,0
"<anonymized_userid>",1,56330,10285,"Geert Wilders (PVV)",0.995845487492266,0.977661596958175,0
"<anonymized_userid>",1,56331,10286,"Geert Wilders (PVV)",0.995863166268894,0.977756653992395,0
"<anonymized_userid>",1,56332,10287,"Geert Wilders (PVV)",0.995880845045523,0.977851711026616,0
"<anonymized_userid>",1,56333,10288,"Geert Wilders (PVV)",0.995898523822151,0.977946768060836,0
"<anonymized_userid>",1,56334,10289,"Geert Wilders (PVV)",0.99591620259878,0.978041825095057,0
"<anonymized_userid>",1,56335,10290,"Geert Wilders (PVV)",0.995933881375409,0.978136882129278,0
"<anonymized_userid>",1,56336,10291,"Geert Wilders (PVV)",0.995951560152037,0.978231939163498,0
"<anonymized_userid>",1,56337,10292,"Geert Wilders (PVV)",0.995969238928666,0.978326996197719,0
"<anonymized_userid>",1,56338,10293,"Geert Wilders (PVV)",0.995986917705295,0.978422053231939,0
"<anonymized_userid>",1,56339,10294,"Geert Wilders (PVV)",0.996004596481923,0.97851711026616,0
"<anonymized_userid>",1,56340,10295,"Geert Wilders (PVV)",0.996022275258552,0.97861216730038,0
"<anonymized_userid>",1,56341,10296,"Geert Wilders (PVV)",0.996039954035181,0.978707224334601,0
"<anonymized_userid>",1,56342,10297,"Geert Wilders (PVV)",0.996057632811809,0.978802281368821,0
"<anonymized_userid>",1,56343,10298,"Geert Wilders (PVV)",0.996075311588438,0.978897338403042,0
"<anonymized_userid>",1,56344,10299,"Geert Wilders (PVV)",0.996092990365067,0.978992395437262,0
"<anonymized_userid>",1,56345,10300,"Geert Wilders (PVV)",0.996110669141695,0.979087452471483,0
"<anonymized_userid>",1,56346,10301,"Geert Wilders (PVV)",0.996128347918324,0.979182509505703,0
"<anonymized_userid>",1,56347,10302,"Geert Wilders (PVV)",0.996146026694953,0.979277566539924,0
"<anonymized_userid>",1,56348,10303,"Geert Wilders (PVV)",0.996163705471581,0.979372623574144,0
"<anonymized_userid>",1,56349,10304,"Geert Wilders (PVV)",0.99618138424821,0.979467680608365,0
"<anonymized_userid>",1,56350,10305,"Geert Wilders (PVV)",0.996199063024839,0.979562737642586,0
"<anonymized_userid>",1,56351,10306,"Geert Wilders (PVV)",0.996216741801467,0.979657794676806,0
"<anonymized_userid>",1,56352,10307,"Geert Wilders (PVV)",0.996234420578096,0.979752851711027,0
"<anonymized_userid>",1,56353,10308,"Geert Wilders (PVV)",0.996252099354725,0.979847908745247,0
"<anonymized_userid>",1,56354,10309,"Geert Wilders (PVV)",0.996269778131353,0.979942965779468,0
"<anonymized_userid>",1,56355,10310,"Geert Wilders (PVV)",0.996287456907982,0.980038022813688,0
"<anonymized_userid>",1,56356,10311,"Geert Wilders (PVV)",0.996305135684611,0.980133079847909,0
"<anonymized_userid>",1,56357,10312,"Geert Wilders (PVV)",0.996322814461239,0.980228136882129,0
"<anonymized_userid>",1,56358,10313,"Geert Wilders (PVV)",0.996340493237868,0.98032319391635,0
"<anonymized_userid>",1,56359,10314,"Geert Wilders (PVV)",0.996358172014497,0.98041825095057,0
"<anonymized_userid>",1,56360,10315,"Geert Wilders (PVV)",0.996375850791125,0.980513307984791,0
"<anonymized_userid>",1,56361,10316,"Geert Wilders (PVV)",0.996393529567754,0.980608365019011,0
"<anonymized_userid>",1,56362,10317,"Geert Wilders (PVV)",0.996411208344383,0.980703422053232,0
"<anonymized_userid>",1,56363,10318,"Geert Wilders (PVV)",0.996428887121011,0.980798479087452,0
"<anonymized_userid>",1,56364,10319,"Geert Wilders (PVV)",0.99644656589764,0.980893536121673,0
"<anonymized_userid>",1,56365,10320,"Geert Wilders (PVV)",0.996464244674269,0.980988593155893,0
"<anonymized_userid>",1,56366,10321,"Geert Wilders (PVV)",0.996481923450897,0.981083650190114,0
"<anonymized_userid>",1,56367,10322,"Geert Wilders (PVV)",0.996499602227526,0.981178707224335,0
"<anonymized_userid>",1,56368,10323,"Geert Wilders (PVV)",0.996517281004154,0.981273764258555,0
"<anonymized_userid>",1,56369,10324,"Geert Wilders (PVV)",0.996534959780783,0.981368821292776,0
"<anonymized_userid>",1,56370,10325,"Geert Wilders (PVV)",0.996552638557412,0.981463878326996,0
"<anonymized_userid>",1,56371,10326,"Geert Wilders (PVV)",0.99657031733404,0.981558935361217,0
"<anonymized_userid>",1,56372,10327,"Geert Wilders (PVV)",0.996587996110669,0.981653992395437,0
"<anonymized_userid>",1,56373,10328,"Geert Wilders (PVV)",0.996605674887298,0.981749049429658,0
"<anonymized_userid>",1,56374,10329,"Geert Wilders (PVV)",0.996623353663926,0.981844106463878,0
"<anonymized_userid>",1,56375,10330,"Geert Wilders (PVV)",0.996641032440555,0.981939163498099,0
"<anonymized_userid>",1,56376,10331,"Geert Wilders (PVV)",0.996658711217184,0.982034220532319,0
"<anonymized_userid>",1,56377,10332,"Geert Wilders (PVV)",0.996676389993812,0.98212927756654,0
"<anonymized_userid>",1,56378,10333,"Geert Wilders (PVV)",0.996694068770441,0.98222433460076,0
"<anonymized_userid>",1,56379,10334,"Geert Wilders (PVV)",0.99671174754707,0.982319391634981,0
"<anonymized_userid>",1,56380,10335,"Geert Wilders (PVV)",0.996729426323698,0.982414448669201,0
"<anonymized_userid>",1,56381,10336,"Geert Wilders (PVV)",0.996747105100327,0.982509505703422,0
"<anonymized_userid>",1,56382,10337,"Geert Wilders (PVV)",0.996764783876956,0.982604562737643,0
"<anonymized_userid>",1,56383,10338,"Geert Wilders (PVV)",0.996782462653584,0.982699619771863,0
"<anonymized_userid>",1,56384,10339,"Geert Wilders (PVV)",0.996800141430213,0.982794676806084,0
"<anonymized_userid>",1,56385,10340,"Geert Wilders (PVV)",0.996817820206842,0.982889733840304,0
"<anonymized_userid>",1,56386,10341,"Geert Wilders (PVV)",0.99683549898347,0.982984790874525,0
"<anonymized_userid>",1,56387,10342,"Geert Wilders (PVV)",0.996853177760099,0.983079847908745,0
"<anonymized_userid>",1,56388,10343,"Geert Wilders (PVV)",0.996870856536728,0.983174904942966,0
"<anonymized_userid>",1,56389,10344,"Geert Wilders (PVV)",0.996888535313356,0.983269961977186,0
"<anonymized_userid>",1,56390,10345,"Geert Wilders (PVV)",0.996906214089985,0.983365019011407,0
"<anonymized_userid>",1,56391,10346,"Geert Wilders (PVV)",0.996923892866614,0.983460076045627,0
"<anonymized_userid>",1,56392,10347,"Geert Wilders (PVV)",0.996941571643242,0.983555133079848,0
"<anonymized_userid>",1,56393,10348,"Geert Wilders (PVV)",0.996959250419871,0.983650190114068,0
"<anonymized_userid>",1,56394,10349,"Geert Wilders (PVV)",0.9969769291965,0.983745247148289,0
"<anonymized_userid>",1,56395,10350,"Geert Wilders (PVV)",0.996994607973128,0.983840304182509,0
"<anonymized_userid>",1,56396,10351,"Geert Wilders (PVV)",0.997012286749757,0.98393536121673,0
"<anonymized_userid>",1,56397,10352,"Geert Wilders (PVV)",0.997029965526386,0.984030418250951,0
"<anonymized_userid>",1,56398,10353,"Geert Wilders (PVV)",0.997047644303014,0.984125475285171,0
"<anonymized_userid>",1,56399,10354,"Geert Wilders (PVV)",0.997065323079643,0.984220532319392,0
"<anonymized_userid>",1,56400,10355,"Geert Wilders (PVV)",0.997083001856272,0.984315589353612,0
"<anonymized_userid>",1,56401,10356,"Geert Wilders (PVV)",0.9971006806329,0.984410646387833,0
"<anonymized_userid>",1,56402,10357,"Geert Wilders (PVV)",0.997118359409529,0.984505703422053,0
"<anonymized_userid>",1,56403,10358,"Geert Wilders (PVV)",0.997136038186157,0.984600760456274,0
"<anonymized_userid>",1,56404,10359,"Geert Wilders (PVV)",0.997153716962786,0.984695817490494,0
"<anonymized_userid>",1,56405,10360,"Geert Wilders (PVV)",0.997171395739415,0.984790874524715,0
"<anonymized_userid>",1,56406,10361,"Geert Wilders (PVV)",0.997189074516043,0.984885931558935,0
"<anonymized_userid>",1,56407,10362,"Geert Wilders (PVV)",0.997206753292672,0.984980988593156,0
"<anonymized_userid>",1,56408,10363,"Geert Wilders (PVV)",0.997224432069301,0.985076045627376,0
"<anonymized_userid>",1,56409,10364,"Geert Wilders (PVV)",0.99724211084593,0.985171102661597,0
"<anonymized_userid>",1,56410,10365,"Geert Wilders (PVV)",0.997259789622558,0.985266159695818,0
"<anonymized_userid>",1,56411,10366,"Geert Wilders (PVV)",0.997277468399187,0.985361216730038,0
"<anonymized_userid>",1,56412,10367,"Geert Wilders (PVV)",0.997295147175815,0.985456273764259,0
"<anonymized_userid>",1,56413,10368,"Geert Wilders (PVV)",0.997312825952444,0.985551330798479,0
"<anonymized_userid>",1,56414,10369,"Geert Wilders (PVV)",0.997330504729073,0.9856463878327,0
"<anonymized_userid>",1,56415,10370,"Geert Wilders (PVV)",0.997348183505701,0.98574144486692,0
"<anonymized_userid>",1,56416,10371,"Geert Wilders (PVV)",0.99736586228233,0.985836501901141,0
"<anonymized_userid>",1,56417,10372,"Geert Wilders (PVV)",0.997383541058959,0.985931558935361,0
"<anonymized_userid>",1,56418,10373,"Geert Wilders (PVV)",0.997401219835587,0.986026615969582,0
"<anonymized_userid>",1,56419,10374,"Geert Wilders (PVV)",0.997418898612216,0.986121673003802,0
"<anonymized_userid>",1,56420,10375,"Geert Wilders (PVV)",0.997436577388845,0.986216730038023,0
"<anonymized_userid>",1,56421,10376,"Geert Wilders (PVV)",0.997454256165473,0.986311787072243,0
"<anonymized_userid>",1,56422,10377,"Geert Wilders (PVV)",0.997471934942102,0.986406844106464,0
"<anonymized_userid>",1,56423,10378,"Geert Wilders (PVV)",0.997489613718731,0.986501901140684,0
"<anonymized_userid>",1,56424,10379,"Geert Wilders (PVV)",0.997507292495359,0.986596958174905,0
"<anonymized_userid>",1,56425,10380,"Geert Wilders (PVV)",0.997524971271988,0.986692015209126,0
"<anonymized_userid>",1,56426,10381,"Geert Wilders (PVV)",0.997542650048617,0.986787072243346,0
"<anonymized_userid>",1,56427,10382,"Geert Wilders (PVV)",0.997560328825245,0.986882129277567,0
"<anonymized_userid>",1,56428,10383,"Geert Wilders (PVV)",0.997578007601874,0.986977186311787,0
"<anonymized_userid>",1,56429,10384,"Geert Wilders (PVV)",0.997595686378503,0.987072243346008,0
"<anonymized_userid>",1,56430,10385,"Geert Wilders (PVV)",0.997613365155131,0.987167300380228,0
"<anonymized_userid>",1,56431,10386,"Geert Wilders (PVV)",0.99763104393176,0.987262357414449,0
"<anonymized_userid>",1,56432,10387,"Geert Wilders (PVV)",0.997648722708389,0.987357414448669,0
"<anonymized_userid>",1,56433,10388,"Geert Wilders (PVV)",0.997666401485017,0.98745247148289,0
"<anonymized_userid>",1,56434,10389,"Geert Wilders (PVV)",0.997684080261646,0.98754752851711,0
"<anonymized_userid>",1,56435,10390,"Geert Wilders (PVV)",0.997701759038275,0.987642585551331,0
"<anonymized_userid>",1,56436,10391,"Geert Wilders (PVV)",0.997719437814903,0.987737642585551,0
"<anonymized_userid>",1,56437,10392,"Geert Wilders (PVV)",0.997737116591532,0.987832699619772,0
"<anonymized_userid>",1,56438,10393,"Geert Wilders (PVV)",0.99775479536816,0.987927756653992,0
"<anonymized_userid>",1,56439,10394,"Geert Wilders (PVV)",0.997772474144789,0.988022813688213,0
"<anonymized_userid>",1,56440,10395,"Geert Wilders (PVV)",0.997790152921418,0.988117870722434,0
"<anonymized_userid>",1,56441,10396,"Geert Wilders (PVV)",0.997807831698047,0.988212927756654,0
"<anonymized_userid>",1,56442,10397,"Geert Wilders (PVV)",0.997825510474675,0.988307984790875,0
"<anonymized_userid>",1,56443,10398,"Geert Wilders (PVV)",0.997843189251304,0.988403041825095,0
"<anonymized_userid>",1,56444,10399,"Geert Wilders (PVV)",0.997860868027933,0.988498098859316,0
"<anonymized_userid>",1,56445,10400,"Geert Wilders (PVV)",0.997878546804561,0.988593155893536,0
"<anonymized_userid>",1,56446,10401,"Geert Wilders (PVV)",0.99789622558119,0.988688212927757,0
"<anonymized_userid>",1,56447,10402,"Geert Wilders (PVV)",0.997913904357818,0.988783269961977,0
"<anonymized_userid>",1,56448,10403,"Geert Wilders (PVV)",0.997931583134447,0.988878326996198,0
"<anonymized_userid>",1,56449,10404,"Geert Wilders (PVV)",0.997949261911076,0.988973384030418,0
"<anonymized_userid>",1,56450,10405,"Geert Wilders (PVV)",0.997966940687704,0.989068441064639,0
"<anonymized_userid>",1,56451,10406,"Geert Wilders (PVV)",0.997984619464333,0.989163498098859,0
"<anonymized_userid>",1,56452,10407,"Geert Wilders (PVV)",0.998002298240962,0.98925855513308,0
"<anonymized_userid>",1,56453,10408,"Geert Wilders (PVV)",0.99801997701759,0.9893536121673,0
"<anonymized_userid>",1,56454,10409,"Geert Wilders (PVV)",0.998037655794219,0.989448669201521,0
"<anonymized_userid>",1,56455,10410,"Geert Wilders (PVV)",0.998055334570848,0.989543726235741,0
"<anonymized_userid>",1,56456,10411,"Geert Wilders (PVV)",0.998073013347476,0.989638783269962,0
"<anonymized_userid>",1,56457,10412,"Geert Wilders (PVV)",0.998090692124105,0.989733840304183,0
"<anonymized_userid>",1,56458,10413,"Geert Wilders (PVV)",0.998108370900734,0.989828897338403,0
"<anonymized_userid>",1,56459,10414,"Geert Wilders (PVV)",0.998126049677362,0.989923954372624,0
"<anonymized_userid>",1,56460,10415,"Geert Wilders (PVV)",0.998143728453991,0.990019011406844,0
"<anonymized_userid>",1,56461,10416,"Geert Wilders (PVV)",0.99816140723062,0.990114068441065,0
"<anonymized_userid>",1,56462,10417,"Geert Wilders (PVV)",0.998179086007248,0.990209125475285,0
"<anonymized_userid>",1,56463,10418,"Geert Wilders (PVV)",0.998196764783877,0.990304182509506,0
"<anonymized_userid>",1,56464,10419,"Geert Wilders (PVV)",0.998214443560506,0.990399239543726,0
"<anonymized_userid>",1,56465,10420,"Geert Wilders (PVV)",0.998232122337134,0.990494296577947,0
"<anonymized_userid>",1,56466,10421,"Geert Wilders (PVV)",0.998249801113763,0.990589353612167,0
"<anonymized_userid>",1,56467,10422,"Geert Wilders (PVV)",0.998267479890392,0.990684410646388,0
"<anonymized_userid>",1,56468,10423,"Geert Wilders (PVV)",0.99828515866702,0.990779467680608,0
"<anonymized_userid>",1,56469,10424,"Geert Wilders (PVV)",0.998302837443649,0.990874524714829,0
"<anonymized_userid>",1,56470,10425,"Geert Wilders (PVV)",0.998320516220278,0.990969581749049,0
"<anonymized_userid>",1,56471,10426,"Geert Wilders (PVV)",0.998338194996906,0.99106463878327,0
"<anonymized_userid>",1,56472,10427,"Geert Wilders (PVV)",0.998355873773535,0.991159695817491,0
"<anonymized_userid>",1,56473,10428,"Geert Wilders (PVV)",0.998373552550164,0.991254752851711,0
"<anonymized_userid>",1,56474,10429,"Geert Wilders (PVV)",0.998391231326792,0.991349809885932,0
"<anonymized_userid>",1,56475,10430,"Geert Wilders (PVV)",0.998408910103421,0.991444866920152,0
"<anonymized_userid>",1,56476,10431,"Geert Wilders (PVV)",0.99842658888005,0.991539923954373,0
"<anonymized_userid>",1,56477,10432,"Geert Wilders (PVV)",0.998444267656678,0.991634980988593,0
"<anonymized_userid>",1,56478,10433,"Geert Wilders (PVV)",0.998461946433307,0.991730038022814,0
"<anonymized_userid>",1,56479,10434,"Geert Wilders (PVV)",0.998479625209935,0.991825095057034,0
"<anonymized_userid>",1,56480,10435,"Geert Wilders (PVV)",0.998497303986564,0.991920152091255,0
"<anonymized_userid>",1,56481,10436,"Geert Wilders (PVV)",0.998514982763193,0.992015209125475,0
"<anonymized_userid>",1,56482,10437,"Geert Wilders (PVV)",0.998532661539821,0.992110266159696,0
"<anonymized_userid>",1,56483,10438,"Geert Wilders (PVV)",0.99855034031645,0.992205323193916,0
"<anonymized_userid>",1,56484,10439,"Geert Wilders (PVV)",0.998568019093079,0.992300380228137,0
"<anonymized_userid>",1,56485,10440,"Geert Wilders (PVV)",0.998585697869707,0.992395437262357,0
"<anonymized_userid>",1,56486,10441,"Geert Wilders (PVV)",0.998603376646336,0.992490494296578,0
"<anonymized_userid>",1,56487,10442,"Geert Wilders (PVV)",0.998621055422965,0.992585551330799,0
"<anonymized_userid>",1,56488,10443,"Geert Wilders (PVV)",0.998638734199593,0.992680608365019,0
"<anonymized_userid>",1,56489,10444,"Geert Wilders (PVV)",0.998656412976222,0.99277566539924,0
"<anonymized_userid>",1,56490,10445,"Geert Wilders (PVV)",0.998674091752851,0.99287072243346,0
"<anonymized_userid>",1,56491,10446,"Geert Wilders (PVV)",0.998691770529479,0.992965779467681,0
"<anonymized_userid>",1,56492,10447,"Geert Wilders (PVV)",0.998709449306108,0.993060836501901,0
"<anonymized_userid>",1,56493,10448,"Geert Wilders (PVV)",0.998727128082737,0.993155893536122,0
"<anonymized_userid>",1,56494,10449,"Geert Wilders (PVV)",0.998744806859365,0.993250950570342,0
"<anonymized_userid>",1,56495,10450,"Geert Wilders (PVV)",0.998762485635994,0.993346007604563,0
"<anonymized_userid>",1,56496,10451,"Geert Wilders (PVV)",0.998780164412623,0.993441064638783,0
"<anonymized_userid>",1,56497,10452,"Geert Wilders (PVV)",0.998797843189251,0.993536121673004,0
"<anonymized_userid>",1,56498,10453,"Geert Wilders (PVV)",0.99881552196588,0.993631178707224,0
"<anonymized_userid>",1,56499,10454,"Geert Wilders (PVV)",0.998833200742509,0.993726235741445,0
"<anonymized_userid>",1,56500,10455,"Geert Wilders (PVV)",0.998850879519137,0.993821292775665,0
"<anonymized_userid>",1,56501,10456,"Geert Wilders (PVV)",0.998868558295766,0.993916349809886,0
"<anonymized_userid>",1,56502,10457,"Geert Wilders (PVV)",0.998886237072395,0.994011406844106,0
"<anonymized_userid>",1,56503,10458,"Geert Wilders (PVV)",0.998903915849023,0.994106463878327,0
"<anonymized_userid>",1,56504,10459,"Geert Wilders (PVV)",0.998921594625652,0.994201520912548,0
"<anonymized_userid>",1,56505,10460,"Geert Wilders (PVV)",0.998939273402281,0.994296577946768,0
"<anonymized_userid>",1,56506,10461,"Geert Wilders (PVV)",0.998956952178909,0.994391634980989,0
"<anonymized_userid>",1,56507,10462,"Geert Wilders (PVV)",0.998974630955538,0.994486692015209,0
"<anonymized_userid>",1,56508,10463,"Geert Wilders (PVV)",0.998992309732167,0.99458174904943,0
"<anonymized_userid>",1,56509,10464,"Geert Wilders (PVV)",0.999009988508795,0.99467680608365,0
"<anonymized_userid>",1,56510,10465,"Geert Wilders (PVV)",0.999027667285424,0.994771863117871,0
"<anonymized_userid>",1,56511,10466,"Geert Wilders (PVV)",0.999045346062053,0.994866920152091,0
"<anonymized_userid>",1,56512,10467,"Geert Wilders (PVV)",0.999063024838681,0.994961977186312,0
"<anonymized_userid>",1,56513,10468,"Geert Wilders (PVV)",0.99908070361531,0.995057034220532,0
"<anonymized_userid>",1,56514,10469,"Geert Wilders (PVV)",0.999098382391938,0.995152091254753,0
"<anonymized_userid>",1,56515,10470,"Geert Wilders (PVV)",0.999116061168567,0.995247148288973,0
"<anonymized_userid>",1,56516,10471,"Geert Wilders (PVV)",0.999133739945196,0.995342205323194,0
"<anonymized_userid>",1,56517,10472,"Geert Wilders (PVV)",0.999151418721824,0.995437262357414,0
"<anonymized_userid>",1,56518,10473,"Geert Wilders (PVV)",0.999169097498453,0.995532319391635,0
"<anonymized_userid>",1,56519,10474,"Geert Wilders (PVV)",0.999186776275082,0.995627376425856,0
"<anonymized_userid>",1,56520,10475,"Geert Wilders (PVV)",0.99920445505171,0.995722433460076,0
"<anonymized_userid>",1,56521,10476,"Geert Wilders (PVV)",0.999222133828339,0.995817490494297,0
"<anonymized_userid>",1,56522,10477,"Geert Wilders (PVV)",0.999239812604968,0.995912547528517,0
"<anonymized_userid>",1,56523,10478,"Geert Wilders (PVV)",0.999257491381596,0.996007604562738,0
"<anonymized_userid>",1,56524,10479,"Geert Wilders (PVV)",0.999275170158225,0.996102661596958,0
"<anonymized_userid>",1,56525,10480,"Geert Wilders (PVV)",0.999292848934854,0.996197718631179,0
"<anonymized_userid>",1,56526,10481,"Geert Wilders (PVV)",0.999310527711482,0.996292775665399,0
"<anonymized_userid>",1,56527,10482,"Geert Wilders (PVV)",0.999328206488111,0.99638783269962,0
"<anonymized_userid>",1,56528,10483,"Geert Wilders (PVV)",0.99934588526474,0.99648288973384,0
"<anonymized_userid>",1,56529,10484,"Geert Wilders (PVV)",0.999363564041368,0.996577946768061,0
"<anonymized_userid>",1,56530,10485,"Geert Wilders (PVV)",0.999381242817997,0.996673003802281,0
"<anonymized_userid>",1,56531,10486,"Geert Wilders (PVV)",0.999398921594626,0.996768060836502,0
"<anonymized_userid>",1,56532,10487,"Geert Wilders (PVV)",0.999416600371254,0.996863117870722,0
"<anonymized_userid>",1,56533,10488,"Geert Wilders (PVV)",0.999434279147883,0.996958174904943,0
"<anonymized_userid>",1,56534,10489,"Geert Wilders (PVV)",0.999451957924512,0.997053231939164,0
"<anonymized_userid>",1,56535,10490,"Geert Wilders (PVV)",0.99946963670114,0.997148288973384,0
"<anonymized_userid>",1,56536,10491,"Geert Wilders (PVV)",0.999487315477769,0.997243346007605,0
"<anonymized_userid>",1,56537,10492,"Geert Wilders (PVV)",0.999504994254398,0.997338403041825,0
"<anonymized_userid>",1,56538,10493,"Geert Wilders (PVV)",0.999522673031026,0.997433460076046,0
"<anonymized_userid>",1,56539,10494,"Geert Wilders (PVV)",0.999540351807655,0.997528517110266,0
"<anonymized_userid>",1,56540,10495,"Geert Wilders (PVV)",0.999558030584284,0.997623574144487,0
"<anonymized_userid>",1,56541,10496,"Geert Wilders (PVV)",0.999575709360912,0.997718631178707,0
"<anonymized_userid>",1,56542,10497,"Geert Wilders (PVV)",0.999593388137541,0.997813688212928,0
"<anonymized_userid>",1,56543,10498,"Geert Wilders (PVV)",0.99961106691417,0.997908745247148,0
"<anonymized_userid>",1,56544,10499,"Geert Wilders (PVV)",0.999628745690798,0.998003802281369,0
"<anonymized_userid>",1,56545,10500,"Geert Wilders (PVV)",0.999646424467427,0.998098859315589,0
"<anonymized_userid>",1,56546,10501,"Geert Wilders (PVV)",0.999664103244056,0.99819391634981,0
"<anonymized_userid>",1,56547,10502,"Geert Wilders (PVV)",0.999681782020684,0.99828897338403,0
"<anonymized_userid>",1,56548,10503,"Geert Wilders (PVV)",0.999699460797313,0.998384030418251,0
"<anonymized_userid>",1,56549,10504,"Geert Wilders (PVV)",0.999717139573941,0.998479087452471,0
"<anonymized_userid>",1,56550,10505,"Geert Wilders (PVV)",0.99973481835057,0.998574144486692,0
"<anonymized_userid>",1,56551,10506,"Geert Wilders (PVV)",0.999752497127199,0.998669201520913,0
"<anonymized_userid>",1,56552,10507,"Geert Wilders (PVV)",0.999770175903827,0.998764258555133,0
"<anonymized_userid>",1,56553,10508,"Geert Wilders (PVV)",0.999787854680456,0.998859315589354,0
"<anonymized_userid>",1,56554,10509,"Geert Wilders (PVV)",0.999805533457085,0.998954372623574,0
"<anonymized_userid>",1,56555,10510,"Geert Wilders (PVV)",0.999823212233713,0.999049429657795,0
"<anonymized_userid>",1,56556,10511,"Geert Wilders (PVV)",0.999840891010342,0.999144486692015,0
"<anonymized_userid>",1,56557,10512,"Geert Wilders (PVV)",0.999858569786971,0.999239543726236,0
"<anonymized_userid>",1,56558,10513,"Geert Wilders (PVV)",0.999876248563599,0.999334600760456,0
"<anonymized_userid>",1,56559,10514,"Geert Wilders (PVV)",0.999893927340228,0.999429657794677,0
"<anonymized_userid>",1,56560,10515,"Geert Wilders (PVV)",0.999911606116857,0.999524714828897,0
"<anonymized_userid>",1,56561,10516,"Geert Wilders (PVV)",0.999929284893485,0.999619771863118,0
"<anonymized_userid>",1,56562,10517,"Geert Wilders (PVV)",0.999946963670114,0.999714828897338,0
"<anonymized_userid>",1,56563,10518,"Geert Wilders (PVV)",0.999964642446743,0.999809885931559,0
"<anonymized_userid>",1,56564,10519,"Geert Wilders (PVV)",0.999982321223371,0.999904942965779,0
"<anonymized_userid>",1,56565,10520,"Geert Wilders (PVV)",1,1,0
"<anonymized_userid>",367,367,1,"Thierry Baudet (FvD)",0.00485616746500119,0.000106826193782716,0
"<anonymized_userid>",322,689,2,"Thierry Baudet (FvD)",0.0091168920528224,0.000213652387565431,0
"<anonymized_userid>",314,1003,3,"Thierry Baudet (FvD)",0.0132717601291449,0.000320478581348147,0
"<anonymized_userid>",314,1317,4,"Thierry Baudet (FvD)",0.0174266282054675,0.000427304775130862,0
"<anonymized_userid>",300,1617,5,"Thierry Baudet (FvD)",0.0213962473866674,0.000534130968913578,0
"<anonymized_userid>",298,1915,6,"Thierry Baudet (FvD)",0.0253394024399926,0.000640957162696293,0
"<anonymized_userid>",295,2210,7,"Thierry Baudet (FvD)",0.0292428613015058,0.000747783356479009,0
"<anonymized_userid>",287,2497,8,"Thierry Baudet (FvD)",0.0330404636515204,0.000854609550261724,0
"<anonymized_userid>",268,2765,9,"Thierry Baudet (FvD)",0.0365866567867256,0.00096143574404444,0
"<anonymized_userid>",251,3016,10,"Thierry Baudet (FvD)",0.0399079048349962,0.00106826193782716,0
"<anonymized_userid>",225,3241,11,"Thierry Baudet (FvD)",0.0428851192208961,0.00117508813160987,0
"<anonymized_userid>",217,3458,12,"Thierry Baudet (FvD)",0.0457564770952973,0.00128191432539259,0
"<anonymized_userid>",210,3668,13,"Thierry Baudet (FvD)",0.0485352105221372,0.0013887405191753,0
"<anonymized_userid>",206,3874,14,"Thierry Baudet (FvD)",0.0512610156932278,0.00149556671295802,0
"<anonymized_userid>",204,4078,15,"Thierry Baudet (FvD)",0.0539603567364437,0.00160239290674073,0
"<anonymized_userid>",204,4282,16,"Thierry Baudet (FvD)",0.0566596977796597,0.00170921910052345,0
"<anonymized_userid>",203,4485,17,"Thierry Baudet (FvD)",0.0593458067589383,0.00181604529430616,0
"<anonymized_userid>",203,4688,18,"Thierry Baudet (FvD)",0.0620319157382168,0.00192287148808888,0
"<anonymized_userid>",202,4890,19,"Thierry Baudet (FvD)",0.0647047926535581,0.00202969768187159,0
"<anonymized_userid>",200,5090,20,"Thierry Baudet (FvD)",0.0673512054410247,0.00213652387565431,0
"<anonymized_userid>",199,5289,21,"Thierry Baudet (FvD)",0.0699843861645539,0.00224335006943703,0
"<anonymized_userid>",189,5478,22,"Thierry Baudet (FvD)",0.0724852462487099,0.00235017626321974,0
"<anonymized_userid>",189,5667,23,"Thierry Baudet (FvD)",0.0749861063328658,0.00245700245700246,0
"<anonymized_userid>",187,5854,24,"Thierry Baudet (FvD)",0.0774605022891471,0.00256382865078517,0
"<anonymized_userid>",180,6034,25,"Thierry Baudet (FvD)",0.079842273797867,0.00267065484456789,0
"<anonymized_userid>",174,6208,26,"Thierry Baudet (FvD)",0.0821446529229629,0.0027774810383506,0
"<anonymized_userid>",170,6378,27,"Thierry Baudet (FvD)",0.0843941037923095,0.00288430723213332,0
"<anonymized_userid>",168,6546,28,"Thierry Baudet (FvD)",0.0866170905337815,0.00299113342591603,0
"<anonymized_userid>",167,6713,29,"Thierry Baudet (FvD)",0.0888268452113161,0.00309795961969875,0
"<anonymized_userid>",167,6880,30,"Thierry Baudet (FvD)",0.0910365998888507,0.00320478581348147,0
"<anonymized_userid>",166,7046,31,"Thierry Baudet (FvD)",0.0932331225024479,0.00331161200726418,0
"<anonymized_userid>",161,7207,32,"Thierry Baudet (FvD)",0.0953634847963585,0.0034184382010469,0
"<anonymized_userid>",161,7368,33,"Thierry Baudet (FvD)",0.0974938470902691,0.00352526439482961,0
"<anonymized_userid>",157,7525,34,"Thierry Baudet (FvD)",0.0995712811284304,0.00363209058861233,0
"<anonymized_userid>",157,7682,35,"Thierry Baudet (FvD)",0.101648715166592,0.00373891678239504,0
"<anonymized_userid>",156,7838,36,"Thierry Baudet (FvD)",0.103712917140816,0.00384574297617776,0
"<anonymized_userid>",155,7993,37,"Thierry Baudet (FvD)",0.105763887051102,0.00395256916996047,0
"<anonymized_userid>",154,8147,38,"Thierry Baudet (FvD)",0.107801624897452,0.00405939536374319,0
"<anonymized_userid>",146,8293,39,"Thierry Baudet (FvD)",0.109733506232302,0.00416622155752591,0
"<anonymized_userid>",143,8436,40,"Thierry Baudet (FvD)",0.111625691375341,0.00427304775130862,0
"<anonymized_userid>",143,8579,41,"Thierry Baudet (FvD)",0.113517876518379,0.00437987394509134,0
"<anonymized_userid>",142,8721,42,"Thierry Baudet (FvD)",0.115396829597481,0.00448670013887405,0
"<anonymized_userid>",141,8862,43,"Thierry Baudet (FvD)",0.117262550612645,0.00459352633265677,0
"<anonymized_userid>",140,9002,44,"Thierry Baudet (FvD)",0.119115039563871,0.00470035252643948,0
"<anonymized_userid>",139,9141,45,"Thierry Baudet (FvD)",0.12095429645116,0.0048071787202222,0
"<anonymized_userid>",137,9278,46,"Thierry Baudet (FvD)",0.122767089210575,0.00491400491400491,0
"<anonymized_userid>",136,9414,47,"Thierry Baudet (FvD)",0.124566649906052,0.00502083110778763,0
"<anonymized_userid>",135,9549,48,"Thierry Baudet (FvD)",0.126352978537592,0.00512765730157034,0
"<anonymized_userid>",134,9683,49,"Thierry Baudet (FvD)",0.128126075105195,0.00523448349535306,0
"<anonymized_userid>",134,9817,50,"Thierry Baudet (FvD)",0.129899171672798,0.00534130968913578,0
"<anonymized_userid>",133,9950,51,"Thierry Baudet (FvD)",0.131659036176463,0.00544813588291849,0
"<anonymized_userid>",133,10083,52,"Thierry Baudet (FvD)",0.133418900680128,0.00555496207670121,0
"<anonymized_userid>",131,10214,53,"Thierry Baudet (FvD)",0.135152301055919,0.00566178827048392,0
"<anonymized_userid>",131,10345,54,"Thierry Baudet (FvD)",0.136885701431709,0.00576861446426664,0
"<anonymized_userid>",130,10475,55,"Thierry Baudet (FvD)",0.138605869743563,0.00587544065804935,0
"<anonymized_userid>",129,10604,56,"Thierry Baudet (FvD)",0.140312805991479,0.00598226685183207,0
"<anonymized_userid>",129,10733,57,"Thierry Baudet (FvD)",0.142019742239395,0.00608909304561478,0
"<anonymized_userid>",124,10857,58,"Thierry Baudet (FvD)",0.143660518167624,0.0061959192393975,0
"<anonymized_userid>",123,10980,59,"Thierry Baudet (FvD)",0.145288062031916,0.00630274543318022,0
"<anonymized_userid>",122,11102,60,"Thierry Baudet (FvD)",0.14690237383227,0.00640957162696293,0
"<anonymized_userid>",122,11224,61,"Thierry Baudet (FvD)",0.148516685632625,0.00651639782074565,0
"<anonymized_userid>",121,11345,62,"Thierry Baudet (FvD)",0.150117765369042,0.00662322401452836,0
"<anonymized_userid>",119,11464,63,"Thierry Baudet (FvD)",0.151692380977585,0.00673005020831108,0
"<anonymized_userid>",118,11582,64,"Thierry Baudet (FvD)",0.15325376452219,0.00683687640209379,0
"<anonymized_userid>",117,11699,65,"Thierry Baudet (FvD)",0.154801916002858,0.00694370259587651,0
"<anonymized_userid>",117,11816,66,"Thierry Baudet (FvD)",0.156350067483526,0.00705052878965922,0
"<anonymized_userid>",116,11932,67,"Thierry Baudet (FvD)",0.157884986900257,0.00715735498344194,0
"<anonymized_userid>",116,12048,68,"Thierry Baudet (FvD)",0.159419906316987,0.00726418117722466,0
"<anonymized_userid>",115,12163,69,"Thierry Baudet (FvD)",0.160941593669781,0.00737100737100737,0
"<anonymized_userid>",114,12277,70,"Thierry Baudet (FvD)",0.162450048958637,0.00747783356479009,0
"<anonymized_userid>",114,12391,71,"Thierry Baudet (FvD)",0.163958504247493,0.0075846597585728,0
"<anonymized_userid>",113,12504,72,"Thierry Baudet (FvD)",0.165453727472411,0.00769148595235552,0
"<anonymized_userid>",112,12616,73,"Thierry Baudet (FvD)",0.166935718633392,0.00779831214613823,0
"<anonymized_userid>",109,12725,74,"Thierry Baudet (FvD)",0.168378013602562,0.00790513833992095,0
"<anonymized_userid>",109,12834,75,"Thierry Baudet (FvD)",0.169820308571731,0.00801196453370366,0
"<anonymized_userid>",109,12943,76,"Thierry Baudet (FvD)",0.1712626035409,0.00811879072748638,0
"<anonymized_userid>",108,13051,77,"Thierry Baudet (FvD)",0.172691666446132,0.0082256169212691,0
"<anonymized_userid>",108,13159,78,"Thierry Baudet (FvD)",0.174120729351364,0.00833244311505181,0
"<anonymized_userid>",108,13267,79,"Thierry Baudet (FvD)",0.175549792256596,0.00843926930883453,0
"<anonymized_userid>",108,13375,80,"Thierry Baudet (FvD)",0.176978855161828,0.00854609550261724,0
"<anonymized_userid>",108,13483,81,"Thierry Baudet (FvD)",0.17840791806706,0.00865292169639996,0
"<anonymized_userid>",108,13591,82,"Thierry Baudet (FvD)",0.179836980972292,0.00875974789018267,0
"<anonymized_userid>",106,13697,83,"Thierry Baudet (FvD)",0.181239579749649,0.00886657408396539,0
"<anonymized_userid>",105,13802,84,"Thierry Baudet (FvD)",0.182628946463069,0.0089734002777481,0
"<anonymized_userid>",104,13906,85,"Thierry Baudet (FvD)",0.184005081112552,0.00908022647153082,0
"<anonymized_userid>",104,14010,86,"Thierry Baudet (FvD)",0.185381215762035,0.00918705266531353,0
"<anonymized_userid>",104,14114,87,"Thierry Baudet (FvD)",0.186757350411517,0.00929387885909625,0
"<anonymized_userid>",103,14217,88,"Thierry Baudet (FvD)",0.188120252997062,0.00940070505287897,0
"<anonymized_userid>",103,14320,89,"Thierry Baudet (FvD)",0.189483155582608,0.00950753124666168,0
"<anonymized_userid>",102,14422,90,"Thierry Baudet (FvD)",0.190832826104216,0.0096143574404444,0
"<anonymized_userid>",102,14524,91,"Thierry Baudet (FvD)",0.192182496625824,0.00972118363422711,0
"<anonymized_userid>",102,14626,92,"Thierry Baudet (FvD)",0.193532167147432,0.00982800982800983,0
"<anonymized_userid>",101,14727,93,"Thierry Baudet (FvD)",0.194868605605102,0.00993483602179254,0
"<anonymized_userid>",101,14828,94,"Thierry Baudet (FvD)",0.196205044062773,0.0100416622155753,0
"<anonymized_userid>",101,14929,95,"Thierry Baudet (FvD)",0.197541482520444,0.010148488409358,0
"<anonymized_userid>",101,15030,96,"Thierry Baudet (FvD)",0.198877920978114,0.0102553146031407,0
"<anonymized_userid>",100,15130,97,"Thierry Baudet (FvD)",0.200201127371847,0.0103621407969234,0
"<anonymized_userid>",100,15230,98,"Thierry Baudet (FvD)",0.201524333765581,0.0104689669907061,0
"<anonymized_userid>",100,15330,99,"Thierry Baudet (FvD)",0.202847540159314,0.0105757931844888,0
"<anonymized_userid>",99,15429,100,"Thierry Baudet (FvD)",0.20415751448911,0.0106826193782716,0
"<anonymized_userid>",99,15528,101,"Thierry Baudet (FvD)",0.205467488818906,0.0107894455720543,0
"<anonymized_userid>",98,15626,102,"Thierry Baudet (FvD)",0.206764231084765,0.010896271765837,0
"<anonymized_userid>",98,15724,103,"Thierry Baudet (FvD)",0.208060973350623,0.0110030979596197,0
"<anonymized_userid>",98,15822,104,"Thierry Baudet (FvD)",0.209357715616482,0.0111099241534024,0
"<anonymized_userid>",97,15919,105,"Thierry Baudet (FvD)",0.210641225818403,0.0112167503471851,0
"<anonymized_userid>",96,16015,106,"Thierry Baudet (FvD)",0.211911503956387,0.0113235765409678,0
"<anonymized_userid>",96,16111,107,"Thierry Baudet (FvD)",0.213181782094371,0.0114304027347506,0
"<anonymized_userid>",95,16206,108,"Thierry Baudet (FvD)",0.214438828168418,0.0115372289285333,0
"<anonymized_userid>",95,16301,109,"Thierry Baudet (FvD)",0.215695874242464,0.011644055122316,0
"<anonymized_userid>",95,16396,110,"Thierry Baudet (FvD)",0.216952920316511,0.0117508813160987,0
"<anonymized_userid>",95,16491,111,"Thierry Baudet (FvD)",0.218209966390558,0.0118577075098814,0
"<anonymized_userid>",94,16585,112,"Thierry Baudet (FvD)",0.219453780400667,0.0119645337036641,0
"<anonymized_userid>",94,16679,113,"Thierry Baudet (FvD)",0.220697594410776,0.0120713598974469,0
"<anonymized_userid>",92,16771,114,"Thierry Baudet (FvD)",0.221914944293011,0.0121781860912296,0
"<anonymized_userid>",92,16863,115,"Thierry Baudet (FvD)",0.223132294175245,0.0122850122850123,0
"<anonymized_userid>",92,16955,116,"Thierry Baudet (FvD)",0.22434964405748,0.012391838478795,0
"<anonymized_userid>",92,17047,117,"Thierry Baudet (FvD)",0.225566993939715,0.0124986646725777,0
"<anonymized_userid>",91,17138,118,"Thierry Baudet (FvD)",0.226771111758012,0.0126054908663604,0
"<anonymized_userid>",91,17229,119,"Thierry Baudet (FvD)",0.227975229576309,0.0127123170601431,0
"<anonymized_userid>",90,17319,120,"Thierry Baudet (FvD)",0.229166115330669,0.0128191432539259,0
"<anonymized_userid>",90,17409,121,"Thierry Baudet (FvD)",0.230357001085029,0.0129259694477086,0
"<anonymized_userid>",90,17499,122,"Thierry Baudet (FvD)",0.231547886839389,0.0130327956414913,0
"<anonymized_userid>",89,17588,123,"Thierry Baudet (FvD)",0.232725540529812,0.013139621835274,0
"<anonymized_userid>",89,17677,124,"Thierry Baudet (FvD)",0.233903194220234,0.0132464480290567,0
"<anonymized_userid>",89,17766,125,"Thierry Baudet (FvD)",0.235080847910657,0.0133532742228394,0
"<anonymized_userid>",88,17854,126,"Thierry Baudet (FvD)",0.236245269537142,0.0134601004166222,0
"<anonymized_userid>",88,17942,127,"Thierry Baudet (FvD)",0.237409691163628,0.0135669266104049,0
"<anonymized_userid>",87,18029,128,"Thierry Baudet (FvD)",0.238560880726176,0.0136737528041876,0
"<anonymized_userid>",87,18116,129,"Thierry Baudet (FvD)",0.239712070288724,0.0137805789979703,0
"<anonymized_userid>",87,18203,130,"Thierry Baudet (FvD)",0.240863259851272,0.013887405191753,0
"<anonymized_userid>",87,18290,131,"Thierry Baudet (FvD)",0.24201444941382,0.0139942313855357,0
"<anonymized_userid>",87,18377,132,"Thierry Baudet (FvD)",0.243165638976368,0.0141010575793184,0
"<anonymized_userid>",86,18463,133,"Thierry Baudet (FvD)",0.244303596474978,0.0142078837731012,0
"<anonymized_userid>",85,18548,134,"Thierry Baudet (FvD)",0.245428321909651,0.0143147099668839,0
"<anonymized_userid>",85,18633,135,"Thierry Baudet (FvD)",0.246553047344325,0.0144215361606666,0
"<anonymized_userid>",85,18718,136,"Thierry Baudet (FvD)",0.247677772778998,0.0145283623544493,0
"<anonymized_userid>",84,18802,137,"Thierry Baudet (FvD)",0.248789266149734,0.014635188548232,0
"<anonymized_userid>",84,18886,138,"Thierry Baudet (FvD)",0.24990075952047,0.0147420147420147,0
"<anonymized_userid>",83,18969,139,"Thierry Baudet (FvD)",0.250999020827269,0.0148488409357975,0
"<anonymized_userid>",83,19052,140,"Thierry Baudet (FvD)",0.252097282134067,0.0149556671295802,0
"<anonymized_userid>",83,19135,141,"Thierry Baudet (FvD)",0.253195543440866,0.0150624933233629,0
"<anonymized_userid>",82,19217,142,"Thierry Baudet (FvD)",0.254280572683727,0.0151693195171456,0
"<anonymized_userid>",82,19299,143,"Thierry Baudet (FvD)",0.255365601926589,0.0152761457109283,0
"<anonymized_userid>",82,19381,144,"Thierry Baudet (FvD)",0.25645063116945,0.015382971904711,0
"<anonymized_userid>",82,19463,145,"Thierry Baudet (FvD)",0.257535660412311,0.0154897980984938,0
"<anonymized_userid>",81,19544,146,"Thierry Baudet (FvD)",0.258607457591235,0.0155966242922765,0
"<anonymized_userid>",80,19624,147,"Thierry Baudet (FvD)",0.259666022706222,0.0157034504860592,0
"<anonymized_userid>",80,19704,148,"Thierry Baudet (FvD)",0.260724587821208,0.0158102766798419,0
"<anonymized_userid>",79,19783,149,"Thierry Baudet (FvD)",0.261769920872258,0.0159171028736246,0
"<anonymized_userid>",78,19861,150,"Thierry Baudet (FvD)",0.26280202185937,0.0160239290674073,0
"<anonymized_userid>",78,19939,151,"Thierry Baudet (FvD)",0.263834122846482,0.01613075526119,0
"<anonymized_userid>",77,20016,152,"Thierry Baudet (FvD)",0.264852991769656,0.0162375814549728,0
"<anonymized_userid>",77,20093,153,"Thierry Baudet (FvD)",0.265871860692831,0.0163444076487555,0
"<anonymized_userid>",76,20169,154,"Thierry Baudet (FvD)",0.266877497552068,0.0164512338425382,0
"<anonymized_userid>",76,20245,155,"Thierry Baudet (FvD)",0.267883134411305,0.0165580600363209,0
"<anonymized_userid>",76,20321,156,"Thierry Baudet (FvD)",0.268888771270543,0.0166648862301036,0
"<anonymized_userid>",76,20397,157,"Thierry Baudet (FvD)",0.26989440812978,0.0167717124238863,0
"<anonymized_userid>",76,20473,158,"Thierry Baudet (FvD)",0.270900044989017,0.0168785386176691,0
"<anonymized_userid>",76,20549,159,"Thierry Baudet (FvD)",0.271905681848255,0.0169853648114518,0
"<anonymized_userid>",76,20625,160,"Thierry Baudet (FvD)",0.272911318707492,0.0170921910052345,0
"<anonymized_userid>",75,20700,161,"Thierry Baudet (FvD)",0.273903723502792,0.0171990171990172,0
"<anonymized_userid>",75,20775,162,"Thierry Baudet (FvD)",0.274896128298092,0.0173058433927999,0
"<anonymized_userid>",74,20849,163,"Thierry Baudet (FvD)",0.275875301029455,0.0174126695865826,0
"<anonymized_userid>",73,20922,164,"Thierry Baudet (FvD)",0.27684124169688,0.0175194957803653,0
"<anonymized_userid>",73,20995,165,"Thierry Baudet (FvD)",0.277807182364305,0.0176263219741481,0
"<anonymized_userid>",72,21067,166,"Thierry Baudet (FvD)",0.278759890967793,0.0177331481679308,0
"<anonymized_userid>",72,21139,167,"Thierry Baudet (FvD)",0.279712599571281,0.0178399743617135,0
"<anonymized_userid>",72,21211,168,"Thierry Baudet (FvD)",0.280665308174769,0.0179468005554962,0
"<anonymized_userid>",71,21282,169,"Thierry Baudet (FvD)",0.28160478471432,0.0180536267492789,0
"<anonymized_userid>",71,21353,170,"Thierry Baudet (FvD)",0.28254426125387,0.0181604529430616,0
"<anonymized_userid>",71,21424,171,"Thierry Baudet (FvD)",0.283483737793421,0.0182672791368444,0
"<anonymized_userid>",70,21494,172,"Thierry Baudet (FvD)",0.284409982269034,0.0183741053306271,0
"<anonymized_userid>",70,21564,173,"Thierry Baudet (FvD)",0.285336226744648,0.0184809315244098,0
"<anonymized_userid>",69,21633,174,"Thierry Baudet (FvD)",0.286249239156324,0.0185877577181925,0
"<anonymized_userid>",69,21702,175,"Thierry Baudet (FvD)",0.287162251568,0.0186945839119752,0
"<anonymized_userid>",69,21771,176,"Thierry Baudet (FvD)",0.288075263979676,0.0188014101057579,0
"<anonymized_userid>",69,21840,177,"Thierry Baudet (FvD)",0.288988276391352,0.0189082362995406,0
"<anonymized_userid>",68,21908,178,"Thierry Baudet (FvD)",0.28988805673909,0.0190150624933234,0
"<anonymized_userid>",68,21976,179,"Thierry Baudet (FvD)",0.290787837086829,0.0191218886871061,0
"<anonymized_userid>",68,22044,180,"Thierry Baudet (FvD)",0.291687617434567,0.0192287148808888,0
"<anonymized_userid>",68,22112,181,"Thierry Baudet (FvD)",0.292587397782306,0.0193355410746715,0
"<anonymized_userid>",68,22180,182,"Thierry Baudet (FvD)",0.293487178130045,0.0194423672684542,0
"<anonymized_userid>",68,22248,183,"Thierry Baudet (FvD)",0.294386958477783,0.0195491934622369,0
"<anonymized_userid>",67,22315,184,"Thierry Baudet (FvD)",0.295273506761585,0.0196560196560197,0
"<anonymized_userid>",67,22382,185,"Thierry Baudet (FvD)",0.296160055045386,0.0197628458498024,0
"<anonymized_userid>",67,22449,186,"Thierry Baudet (FvD)",0.297046603329187,0.0198696720435851,0
"<anonymized_userid>",67,22516,187,"Thierry Baudet (FvD)",0.297933151612989,0.0199764982373678,0
"<anonymized_userid>",67,22583,188,"Thierry Baudet (FvD)",0.29881969989679,0.0200833244311505,0
"<anonymized_userid>",67,22650,189,"Thierry Baudet (FvD)",0.299706248180591,0.0201901506249332,0
"<anonymized_userid>",67,22717,190,"Thierry Baudet (FvD)",0.300592796464393,0.020296976818716,0
"<anonymized_userid>",66,22783,191,"Thierry Baudet (FvD)",0.301466112684256,0.0204038030124987,0
"<anonymized_userid>",66,22849,192,"Thierry Baudet (FvD)",0.30233942890412,0.0205106292062814,0
"<anonymized_userid>",66,22915,193,"Thierry Baudet (FvD)",0.303212745123984,0.0206174554000641,0
"<anonymized_userid>",66,22981,194,"Thierry Baudet (FvD)",0.304086061343848,0.0207242815938468,0
"<anonymized_userid>",66,23047,195,"Thierry Baudet (FvD)",0.304959377563712,0.0208311077876295,0
"<anonymized_userid>",66,23113,196,"Thierry Baudet (FvD)",0.305832693783576,0.0209379339814122,0
"<anonymized_userid>",66,23179,197,"Thierry Baudet (FvD)",0.30670601000344,0.021044760175195,0
"<anonymized_userid>",65,23244,198,"Thierry Baudet (FvD)",0.307566094159367,0.0211515863689777,0
"<anonymized_userid>",65,23309,199,"Thierry Baudet (FvD)",0.308426178315294,0.0212584125627604,0
"<anonymized_userid>",65,23374,200,"Thierry Baudet (FvD)",0.30928626247122,0.0213652387565431,0
"<anonymized_userid>",65,23439,201,"Thierry Baudet (FvD)",0.310146346627147,0.0214720649503258,0
"<anonymized_userid>",65,23504,202,"Thierry Baudet (FvD)",0.311006430783074,0.0215788911441085,0
"<anonymized_userid>",65,23569,203,"Thierry Baudet (FvD)",0.311866514939,0.0216857173378912,0
"<anonymized_userid>",65,23634,204,"Thierry Baudet (FvD)",0.312726599094927,0.021792543531674,0
"<anonymized_userid>",64,23698,205,"Thierry Baudet (FvD)",0.313573451186916,0.0218993697254567,0
"<anonymized_userid>",64,23762,206,"Thierry Baudet (FvD)",0.314420303278905,0.0220061959192394,0
"<anonymized_userid>",63,23825,207,"Thierry Baudet (FvD)",0.315253923306957,0.0221130221130221,0
"<anonymized_userid>",63,23888,208,"Thierry Baudet (FvD)",0.316087543335009,0.0222198483068048,0
"<anonymized_userid>",63,23951,209,"Thierry Baudet (FvD)",0.316921163363061,0.0223266745005875,0
"<anonymized_userid>",63,24014,210,"Thierry Baudet (FvD)",0.317754783391113,0.0224335006943703,0
"<anonymized_userid>",63,24077,211,"Thierry Baudet (FvD)",0.318588403419165,0.022540326888153,0
"<anonymized_userid>",63,24140,212,"Thierry Baudet (FvD)",0.319422023447217,0.0226471530819357,0
"<anonymized_userid>",63,24203,213,"Thierry Baudet (FvD)",0.320255643475269,0.0227539792757184,0
"<anonymized_userid>",63,24266,214,"Thierry Baudet (FvD)",0.321089263503321,0.0228608054695011,0
"<anonymized_userid>",63,24329,215,"Thierry Baudet (FvD)",0.321922883531373,0.0229676316632838,0
"<anonymized_userid>",62,24391,216,"Thierry Baudet (FvD)",0.322743271495488,0.0230744578570666,0
"<anonymized_userid>",62,24453,217,"Thierry Baudet (FvD)",0.323563659459603,0.0231812840508493,0
"<anonymized_userid>",62,24515,218,"Thierry Baudet (FvD)",0.324384047423717,0.023288110244632,0
"<anonymized_userid>",62,24577,219,"Thierry Baudet (FvD)",0.325204435387832,0.0233949364384147,0
"<anonymized_userid>",62,24639,220,"Thierry Baudet (FvD)",0.326024823351946,0.0235017626321974,0
"<anonymized_userid>",62,24701,221,"Thierry Baudet (FvD)",0.326845211316061,0.0236085888259801,0
"<anonymized_userid>",62,24763,222,"Thierry Baudet (FvD)",0.327665599280176,0.0237154150197628,0
"<anonymized_userid>",61,24824,223,"Thierry Baudet (FvD)",0.328472755180353,0.0238222412135456,0
"<anonymized_userid>",61,24885,224,"Thierry Baudet (FvD)",0.32927991108053,0.0239290674073283,0
"<anonymized_userid>",60,24945,225,"Thierry Baudet (FvD)",0.33007383491677,0.024035893601111,0
"<anonymized_userid>",60,25005,226,"Thierry Baudet (FvD)",0.33086775875301,0.0241427197948937,0
"<anonymized_userid>",59,25064,227,"Thierry Baudet (FvD)",0.331648450525313,0.0242495459886764,0
"<anonymized_userid>",59,25123,228,"Thierry Baudet (FvD)",0.332429142297616,0.0243563721824591,0
"<anonymized_userid>",59,25182,229,"Thierry Baudet (FvD)",0.333209834069918,0.0244631983762419,0
"<anonymized_userid>",59,25241,230,"Thierry Baudet (FvD)",0.333990525842221,0.0245700245700246,0
"<anonymized_userid>",59,25300,231,"Thierry Baudet (FvD)",0.334771217614523,0.0246768507638073,0
"<anonymized_userid>",59,25359,232,"Thierry Baudet (FvD)",0.335551909386826,0.02478367695759,0
"<anonymized_userid>",58,25417,233,"Thierry Baudet (FvD)",0.336319369095191,0.0248905031513727,0
"<anonymized_userid>",58,25475,234,"Thierry Baudet (FvD)",0.337086828803557,0.0249973293451554,0
"<anonymized_userid>",58,25533,235,"Thierry Baudet (FvD)",0.337854288511922,0.0251041555389381,0
"<anonymized_userid>",58,25591,236,"Thierry Baudet (FvD)",0.338621748220287,0.0252109817327209,0
"<anonymized_userid>",58,25649,237,"Thierry Baudet (FvD)",0.339389207928653,0.0253178079265036,0
"<anonymized_userid>",58,25707,238,"Thierry Baudet (FvD)",0.340156667637018,0.0254246341202863,0
"<anonymized_userid>",58,25765,239,"Thierry Baudet (FvD)",0.340924127345383,0.025531460314069,0
"<anonymized_userid>",58,25823,240,"Thierry Baudet (FvD)",0.341691587053749,0.0256382865078517,0
"<anonymized_userid>",58,25881,241,"Thierry Baudet (FvD)",0.342459046762114,0.0257451127016344,0
"<anonymized_userid>",58,25939,242,"Thierry Baudet (FvD)",0.343226506470479,0.0258519388954172,0
"<anonymized_userid>",57,25996,243,"Thierry Baudet (FvD)",0.343980734114907,0.0259587650891999,0
"<anonymized_userid>",57,26053,244,"Thierry Baudet (FvD)",0.344734961759335,0.0260655912829826,0
"<anonymized_userid>",57,26110,245,"Thierry Baudet (FvD)",0.345489189403763,0.0261724174767653,0
"<anonymized_userid>",57,26167,246,"Thierry Baudet (FvD)",0.346243417048191,0.026279243670548,0
"<anonymized_userid>",57,26224,247,"Thierry Baudet (FvD)",0.346997644692619,0.0263860698643307,0
"<anonymized_userid>",57,26281,248,"Thierry Baudet (FvD)",0.347751872337047,0.0264928960581134,0
"<anonymized_userid>",56,26337,249,"Thierry Baudet (FvD)",0.348492867917538,0.0265997222518962,0
"<anonymized_userid>",56,26393,250,"Thierry Baudet (FvD)",0.349233863498028,0.0267065484456789,0
"<anonymized_userid>",56,26449,251,"Thierry Baudet (FvD)",0.349974859078519,0.0268133746394616,0
"<anonymized_userid>",56,26505,252,"Thierry Baudet (FvD)",0.35071585465901,0.0269202008332443,0
"<anonymized_userid>",56,26561,253,"Thierry Baudet (FvD)",0.3514568502395,0.027027027027027,0
"<anonymized_userid>",56,26617,254,"Thierry Baudet (FvD)",0.352197845819991,0.0271338532208097,0
"<anonymized_userid>",56,26673,255,"Thierry Baudet (FvD)",0.352938841400482,0.0272406794145925,0
"<anonymized_userid>",55,26728,256,"Thierry Baudet (FvD)",0.353666604917035,0.0273475056083752,0
"<anonymized_userid>",55,26783,257,"Thierry Baudet (FvD)",0.354394368433588,0.0274543318021579,0
"<anonymized_userid>",55,26838,258,"Thierry Baudet (FvD)",0.355122131950142,0.0275611579959406,0
"<anonymized_userid>",55,26893,259,"Thierry Baudet (FvD)",0.355849895466695,0.0276679841897233,0
"<anonymized_userid>",55,26948,260,"Thierry Baudet (FvD)",0.356577658983248,0.027774810383506,0
"<anonymized_userid>",54,27002,261,"Thierry Baudet (FvD)",0.357292190435864,0.0278816365772888,0
"<anonymized_userid>",54,27056,262,"Thierry Baudet (FvD)",0.35800672188848,0.0279884627710715,0
"<anonymized_userid>",54,27110,263,"Thierry Baudet (FvD)",0.358721253341096,0.0280952889648542,0
"<anonymized_userid>",54,27164,264,"Thierry Baudet (FvD)",0.359435784793712,0.0282021151586369,0
"<anonymized_userid>",54,27218,265,"Thierry Baudet (FvD)",0.360150316246328,0.0283089413524196,0
"<anonymized_userid>",54,27272,266,"Thierry Baudet (FvD)",0.360864847698944,0.0284157675462023,0
"<anonymized_userid>",53,27325,267,"Thierry Baudet (FvD)",0.361566147087623,0.028522593739985,0
"<anonymized_userid>",53,27378,268,"Thierry Baudet (FvD)",0.362267446476301,0.0286294199337678,0
"<anonymized_userid>",53,27431,269,"Thierry Baudet (FvD)",0.36296874586498,0.0287362461275505,0
"<anonymized_userid>",52,27483,270,"Thierry Baudet (FvD)",0.363656813189721,0.0288430723213332,0
"<anonymized_userid>",52,27535,271,"Thierry Baudet (FvD)",0.364344880514463,0.0289498985151159,0
"<anonymized_userid>",52,27587,272,"Thierry Baudet (FvD)",0.365032947839204,0.0290567247088986,0
"<anonymized_userid>",52,27639,273,"Thierry Baudet (FvD)",0.365721015163945,0.0291635509026813,0
"<anonymized_userid>",51,27690,274,"Thierry Baudet (FvD)",0.366395850424749,0.0292703770964641,0
"<anonymized_userid>",51,27741,275,"Thierry Baudet (FvD)",0.367070685685553,0.0293772032902468,0
"<anonymized_userid>",51,27792,276,"Thierry Baudet (FvD)",0.367745520946357,0.0294840294840295,0
"<anonymized_userid>",51,27843,277,"Thierry Baudet (FvD)",0.368420356207161,0.0295908556778122,0
"<anonymized_userid>",51,27894,278,"Thierry Baudet (FvD)",0.369095191467965,0.0296976818715949,0
"<anonymized_userid>",50,27944,279,"Thierry Baudet (FvD)",0.369756794664832,0.0298045080653776,0
"<anonymized_userid>",50,27994,280,"Thierry Baudet (FvD)",0.370418397861698,0.0299113342591603,0
"<anonymized_userid>",50,28044,281,"Thierry Baudet (FvD)",0.371080001058565,0.0300181604529431,0
"<anonymized_userid>",50,28094,282,"Thierry Baudet (FvD)",0.371741604255432,0.0301249866467258,0
"<anonymized_userid>",50,28144,283,"Thierry Baudet (FvD)",0.372403207452298,0.0302318128405085,0
"<anonymized_userid>",50,28194,284,"Thierry Baudet (FvD)",0.373064810649165,0.0303386390342912,0
"<anonymized_userid>",50,28244,285,"Thierry Baudet (FvD)",0.373726413846032,0.0304454652280739,0
"<anonymized_userid>",50,28294,286,"Thierry Baudet (FvD)",0.374388017042898,0.0305522914218566,0
"<anonymized_userid>",50,28344,287,"Thierry Baudet (FvD)",0.375049620239765,0.0306591176156394,0
"<anonymized_userid>",49,28393,288,"Thierry Baudet (FvD)",0.375697991372694,0.0307659438094221,0
"<anonymized_userid>",49,28442,289,"Thierry Baudet (FvD)",0.376346362505624,0.0308727700032048,0
"<anonymized_userid>",49,28491,290,"Thierry Baudet (FvD)",0.376994733638553,0.0309795961969875,0
"<anonymized_userid>",49,28540,291,"Thierry Baudet (FvD)",0.377643104771482,0.0310864223907702,0
"<anonymized_userid>",49,28589,292,"Thierry Baudet (FvD)",0.378291475904412,0.0311932485845529,0
"<anonymized_userid>",49,28638,293,"Thierry Baudet (FvD)",0.378939847037341,0.0313000747783357,0
"<anonymized_userid>",49,28687,294,"Thierry Baudet (FvD)",0.37958821817027,0.0314069009721184,0
"<anonymized_userid>",49,28736,295,"Thierry Baudet (FvD)",0.3802365893032,0.0315137271659011,0
"<anonymized_userid>",49,28785,296,"Thierry Baudet (FvD)",0.380884960436129,0.0316205533596838,0
"<anonymized_userid>",49,28834,297,"Thierry Baudet (FvD)",0.381533331569058,0.0317273795534665,0
"<anonymized_userid>",48,28882,298,"Thierry Baudet (FvD)",0.38216847063805,0.0318342057472492,0
"<anonymized_userid>",48,28930,299,"Thierry Baudet (FvD)",0.382803609707042,0.0319410319410319,0
"<anonymized_userid>",48,28978,300,"Thierry Baudet (FvD)",0.383438748776034,0.0320478581348147,0
"<anonymized_userid>",48,29026,301,"Thierry Baudet (FvD)",0.384073887845026,0.0321546843285974,0
"<anonymized_userid>",48,29074,302,"Thierry Baudet (FvD)",0.384709026914018,0.0322615105223801,0
"<anonymized_userid>",48,29122,303,"Thierry Baudet (FvD)",0.38534416598301,0.0323683367161628,0
"<anonymized_userid>",48,29170,304,"Thierry Baudet (FvD)",0.385979305052002,0.0324751629099455,0
"<anonymized_userid>",48,29218,305,"Thierry Baudet (FvD)",0.386614444120994,0.0325819891037282,0
"<anonymized_userid>",48,29266,306,"Thierry Baudet (FvD)",0.387249583189986,0.0326888152975109,0
"<anonymized_userid>",48,29314,307,"Thierry Baudet (FvD)",0.387884722258978,0.0327956414912937,0
"<anonymized_userid>",48,29362,308,"Thierry Baudet (FvD)",0.38851986132797,0.0329024676850764,0
"<anonymized_userid>",48,29410,309,"Thierry Baudet (FvD)",0.389155000396962,0.0330092938788591,0
"<anonymized_userid>",48,29458,310,"Thierry Baudet (FvD)",0.389790139465954,0.0331161200726418,0
"<anonymized_userid>",47,29505,311,"Thierry Baudet (FvD)",0.390412046471009,0.0332229462664245,0
"<anonymized_userid>",47,29552,312,"Thierry Baudet (FvD)",0.391033953476063,0.0333297724602072,0
"<anonymized_userid>",47,29599,313,"Thierry Baudet (FvD)",0.391655860481118,0.03343659865399,0
"<anonymized_userid>",47,29646,314,"Thierry Baudet (FvD)",0.392277767486172,0.0335434248477727,0
"<anonymized_userid>",47,29693,315,"Thierry Baudet (FvD)",0.392899674491227,0.0336502510415554,0
"<anonymized_userid>",47,29740,316,"Thierry Baudet (FvD)",0.393521581496282,0.0337570772353381,0
"<anonymized_userid>",47,29787,317,"Thierry Baudet (FvD)",0.394143488501336,0.0338639034291208,0
"<anonymized_userid>",47,29834,318,"Thierry Baudet (FvD)",0.394765395506391,0.0339707296229035,0
"<anonymized_userid>",46,29880,319,"Thierry Baudet (FvD)",0.395374070447508,0.0340775558166862,0
"<anonymized_userid>",46,29926,320,"Thierry Baudet (FvD)",0.395982745388626,0.034184382010469,0
"<anonymized_userid>",46,29972,321,"Thierry Baudet (FvD)",0.396591420329743,0.0342912082042517,0
"<anonymized_userid>",46,30018,322,"Thierry Baudet (FvD)",0.39720009527086,0.0343980343980344,0
"<anonymized_userid>",46,30064,323,"Thierry Baudet (FvD)",0.397808770211978,0.0345048605918171,0
"<anonymized_userid>",46,30110,324,"Thierry Baudet (FvD)",0.398417445153095,0.0346116867855998,0
"<anonymized_userid>",46,30156,325,"Thierry Baudet (FvD)",0.399026120094212,0.0347185129793825,0
"<anonymized_userid>",46,30202,326,"Thierry Baudet (FvD)",0.39963479503533,0.0348253391731653,0
"<anonymized_userid>",46,30248,327,"Thierry Baudet (FvD)",0.400243469976447,0.034932165366948,0
"<anonymized_userid>",46,30294,328,"Thierry Baudet (FvD)",0.400852144917564,0.0350389915607307,0
"<anonymized_userid>",45,30339,329,"Thierry Baudet (FvD)",0.401447587794744,0.0351458177545134,0
"<anonymized_userid>",45,30384,330,"Thierry Baudet (FvD)",0.402043030671924,0.0352526439482961,0
"<anonymized_userid>",45,30429,331,"Thierry Baudet (FvD)",0.402638473549104,0.0353594701420788,0
"<anonymized_userid>",45,30474,332,"Thierry Baudet (FvD)",0.403233916426284,0.0354662963358616,0
"<anonymized_userid>",45,30519,333,"Thierry Baudet (FvD)",0.403829359303464,0.0355731225296443,0
"<anonymized_userid>",45,30564,334,"Thierry Baudet (FvD)",0.404424802180644,0.035679948723427,0
"<anonymized_userid>",45,30609,335,"Thierry Baudet (FvD)",0.405020245057824,0.0357867749172097,0
"<anonymized_userid>",45,30654,336,"Thierry Baudet (FvD)",0.405615687935004,0.0358936011109924,0
"<anonymized_userid>",44,30698,337,"Thierry Baudet (FvD)",0.406197898748247,0.0360004273047751,0
"<anonymized_userid>",44,30742,338,"Thierry Baudet (FvD)",0.406780109561489,0.0361072534985578,0
"<anonymized_userid>",44,30786,339,"Thierry Baudet (FvD)",0.407362320374732,0.0362140796923406,0
"<anonymized_userid>",44,30830,340,"Thierry Baudet (FvD)",0.407944531187975,0.0363209058861233,0
"<anonymized_userid>",44,30874,341,"Thierry Baudet (FvD)",0.408526742001217,0.036427732079906,0
"<anonymized_userid>",44,30918,342,"Thierry Baudet (FvD)",0.40910895281446,0.0365345582736887,0
"<anonymized_userid>",44,30962,343,"Thierry Baudet (FvD)",0.409691163627703,0.0366413844674714,0
"<anonymized_userid>",43,31005,344,"Thierry Baudet (FvD)",0.410260142377008,0.0367482106612541,0
"<anonymized_userid>",43,31048,345,"Thierry Baudet (FvD)",0.410829121126313,0.0368550368550369,0
"<anonymized_userid>",43,31091,346,"Thierry Baudet (FvD)",0.411398099875619,0.0369618630488196,0
"<anonymized_userid>",43,31134,347,"Thierry Baudet (FvD)",0.411967078624924,0.0370686892426023,0
"<anonymized_userid>",43,31177,348,"Thierry Baudet (FvD)",0.412536057374229,0.037175515436385,0
"<anonymized_userid>",43,31220,349,"Thierry Baudet (FvD)",0.413105036123535,0.0372823416301677,0
"<anonymized_userid>",43,31263,350,"Thierry Baudet (FvD)",0.41367401487284,0.0373891678239504,0
"<anonymized_userid>",42,31305,351,"Thierry Baudet (FvD)",0.414229761558208,0.0374959940177331,0
"<anonymized_userid>",42,31347,352,"Thierry Baudet (FvD)",0.414785508243576,0.0376028202115159,0
"<anonymized_userid>",42,31389,353,"Thierry Baudet (FvD)",0.415341254928944,0.0377096464052986,0
"<anonymized_userid>",42,31431,354,"Thierry Baudet (FvD)",0.415897001614312,0.0378164725990813,0
"<anonymized_userid>",42,31473,355,"Thierry Baudet (FvD)",0.41645274829968,0.037923298792864,0
"<anonymized_userid>",42,31515,356,"Thierry Baudet (FvD)",0.417008494985048,0.0380301249866467,0
"<anonymized_userid>",42,31557,357,"Thierry Baudet (FvD)",0.417564241670416,0.0381369511804294,0
"<anonymized_userid>",42,31599,358,"Thierry Baudet (FvD)",0.418119988355784,0.0382437773742122,0
"<anonymized_userid>",42,31641,359,"Thierry Baudet (FvD)",0.418675735041152,0.0383506035679949,0
"<anonymized_userid>",42,31683,360,"Thierry Baudet (FvD)",0.41923148172652,0.0384574297617776,0
"<anonymized_userid>",42,31725,361,"Thierry Baudet (FvD)",0.419787228411888,0.0385642559555603,0
"<anonymized_userid>",42,31767,362,"Thierry Baudet (FvD)",0.420342975097256,0.038671082149343,0
"<anonymized_userid>",42,31809,363,"Thierry Baudet (FvD)",0.420898721782624,0.0387779083431257,0
"<anonymized_userid>",42,31851,364,"Thierry Baudet (FvD)",0.421454468467992,0.0388847345369085,0
"<anonymized_userid>",41,31892,365,"Thierry Baudet (FvD)",0.421996983089422,0.0389915607306912,0
"<anonymized_userid>",41,31933,366,"Thierry Baudet (FvD)",0.422539497710853,0.0390983869244739,0
"<anonymized_userid>",41,31974,367,"Thierry Baudet (FvD)",0.423082012332284,0.0392052131182566,0
"<anonymized_userid>",41,32015,368,"Thierry Baudet (FvD)",0.423624526953714,0.0393120393120393,0
"<anonymized_userid>",41,32056,369,"Thierry Baudet (FvD)",0.424167041575145,0.039418865505822,0
"<anonymized_userid>",41,32097,370,"Thierry Baudet (FvD)",0.424709556196576,0.0395256916996047,0
"<anonymized_userid>",41,32138,371,"Thierry Baudet (FvD)",0.425252070818006,0.0396325178933875,0
"<anonymized_userid>",41,32179,372,"Thierry Baudet (FvD)",0.425794585439437,0.0397393440871702,0
"<anonymized_userid>",41,32220,373,"Thierry Baudet (FvD)",0.426337100060868,0.0398461702809529,0
"<anonymized_userid>",41,32261,374,"Thierry Baudet (FvD)",0.426879614682298,0.0399529964747356,0
"<anonymized_userid>",41,32302,375,"Thierry Baudet (FvD)",0.427422129303729,0.0400598226685183,0
"<anonymized_userid>",41,32343,376,"Thierry Baudet (FvD)",0.427964643925159,0.040166648862301,0
"<anonymized_userid>",40,32383,377,"Thierry Baudet (FvD)",0.428493926482653,0.0402734750560838,0
"<anonymized_userid>",40,32423,378,"Thierry Baudet (FvD)",0.429023209040146,0.0403803012498665,0
"<anonymized_userid>",40,32463,379,"Thierry Baudet (FvD)",0.429552491597639,0.0404871274436492,0
"<anonymized_userid>",40,32503,380,"Thierry Baudet (FvD)",0.430081774155133,0.0405939536374319,0
"<anonymized_userid>",40,32543,381,"Thierry Baudet (FvD)",0.430611056712626,0.0407007798312146,0
"<anonymized_userid>",40,32583,382,"Thierry Baudet (FvD)",0.431140339270119,0.0408076060249973,0
"<anonymized_userid>",40,32623,383,"Thierry Baudet (FvD)",0.431669621827613,0.04091443221878,0
"<anonymized_userid>",40,32663,384,"Thierry Baudet (FvD)",0.432198904385106,0.0410212584125628,0
"<anonymized_userid>",40,32703,385,"Thierry Baudet (FvD)",0.432728186942599,0.0411280846063455,0
"<anonymized_userid>",40,32743,386,"Thierry Baudet (FvD)",0.433257469500093,0.0412349108001282,0
"<anonymized_userid>",40,32783,387,"Thierry Baudet (FvD)",0.433786752057586,0.0413417369939109,0
"<anonymized_userid>",40,32823,388,"Thierry Baudet (FvD)",0.434316034615079,0.0414485631876936,0
"<anonymized_userid>",40,32863,389,"Thierry Baudet (FvD)",0.434845317172573,0.0415553893814763,0
"<anonymized_userid>",39,32902,390,"Thierry Baudet (FvD)",0.435361367666129,0.0416622155752591,0
"<anonymized_userid>",39,32941,391,"Thierry Baudet (FvD)",0.435877418159685,0.0417690417690418,0
"<anonymized_userid>",39,32980,392,"Thierry Baudet (FvD)",0.436393468653241,0.0418758679628245,0
"<anonymized_userid>",39,33019,393,"Thierry Baudet (FvD)",0.436909519146797,0.0419826941566072,0
"<anonymized_userid>",39,33058,394,"Thierry Baudet (FvD)",0.437425569640353,0.0420895203503899,0
"<anonymized_userid>",39,33097,395,"Thierry Baudet (FvD)",0.437941620133908,0.0421963465441726,0
"<anonymized_userid>",39,33136,396,"Thierry Baudet (FvD)",0.438457670627464,0.0423031727379553,0
"<anonymized_userid>",39,33175,397,"Thierry Baudet (FvD)",0.43897372112102,0.0424099989317381,0
"<anonymized_userid>",39,33214,398,"Thierry Baudet (FvD)",0.439489771614576,0.0425168251255208,0
"<anonymized_userid>",39,33253,399,"Thierry Baudet (FvD)",0.440005822108132,0.0426236513193035,0
"<anonymized_userid>",39,33292,400,"Thierry Baudet (FvD)",0.440521872601688,0.0427304775130862,0
"<anonymized_userid>",38,33330,401,"Thierry Baudet (FvD)",0.441024691031307,0.0428373037068689,0
"<anonymized_userid>",38,33368,402,"Thierry Baudet (FvD)",0.441527509460926,0.0429441299006516,0
"<anonymized_userid>",38,33406,403,"Thierry Baudet (FvD)",0.442030327890544,0.0430509560944344,0
"<anonymized_userid>",38,33444,404,"Thierry Baudet (FvD)",0.442533146320163,0.0431577822882171,0
"<anonymized_userid>",38,33482,405,"Thierry Baudet (FvD)",0.443035964749782,0.0432646084819998,0
"<anonymized_userid>",38,33520,406,"Thierry Baudet (FvD)",0.4435387831794,0.0433714346757825,0
"<anonymized_userid>",38,33558,407,"Thierry Baudet (FvD)",0.444041601609019,0.0434782608695652,0
"<anonymized_userid>",38,33596,408,"Thierry Baudet (FvD)",0.444544420038638,0.0435850870633479,0
"<anonymized_userid>",38,33634,409,"Thierry Baudet (FvD)",0.445047238468256,0.0436919132571306,0
"<anonymized_userid>",38,33672,410,"Thierry Baudet (FvD)",0.445550056897875,0.0437987394509134,0
"<anonymized_userid>",38,33710,411,"Thierry Baudet (FvD)",0.446052875327494,0.0439055656446961,0
"<anonymized_userid>",38,33748,412,"Thierry Baudet (FvD)",0.446555693757112,0.0440123918384788,0
"<anonymized_userid>",38,33786,413,"Thierry Baudet (FvD)",0.447058512186731,0.0441192180322615,0
"<anonymized_userid>",38,33824,414,"Thierry Baudet (FvD)",0.44756133061635,0.0442260442260442,0
"<anonymized_userid>",38,33862,415,"Thierry Baudet (FvD)",0.448064149045968,0.0443328704198269,0
"<anonymized_userid>",38,33900,416,"Thierry Baudet (FvD)",0.448566967475587,0.0444396966136097,0
"<anonymized_userid>",38,33938,417,"Thierry Baudet (FvD)",0.449069785905206,0.0445465228073924,0
"<anonymized_userid>",38,33976,418,"Thierry Baudet (FvD)",0.449572604334824,0.0446533490011751,0
"<anonymized_userid>",38,34014,419,"Thierry Baudet (FvD)",0.450075422764443,0.0447601751949578,0
"<anonymized_userid>",38,34052,420,"Thierry Baudet (FvD)",0.450578241194061,0.0448670013887405,0
"<anonymized_userid>",38,34090,421,"Thierry Baudet (FvD)",0.45108105962368,0.0449738275825232,0
"<anonymized_userid>",38,34128,422,"Thierry Baudet (FvD)",0.451583878053299,0.0450806537763059,0
"<anonymized_userid>",38,34166,423,"Thierry Baudet (FvD)",0.452086696482917,0.0451874799700887,0
"<anonymized_userid>",37,34203,424,"Thierry Baudet (FvD)",0.452576282848599,0.0452943061638714,0
"<anonymized_userid>",37,34240,425,"Thierry Baudet (FvD)",0.45306586921428,0.0454011323576541,0
"<anonymized_userid>",37,34277,426,"Thierry Baudet (FvD)",0.453555455579961,0.0455079585514368,0
"<anonymized_userid>",37,34314,427,"Thierry Baudet (FvD)",0.454045041945643,0.0456147847452195,0
"<anonymized_userid>",37,34351,428,"Thierry Baudet (FvD)",0.454534628311324,0.0457216109390022,0
"<anonymized_userid>",37,34388,429,"Thierry Baudet (FvD)",0.455024214677005,0.045828437132785,0
"<anonymized_userid>",37,34425,430,"Thierry Baudet (FvD)",0.455513801042687,0.0459352633265677,0
"<anonymized_userid>",37,34462,431,"Thierry Baudet (FvD)",0.456003387408368,0.0460420895203504,0
"<anonymized_userid>",37,34499,432,"Thierry Baudet (FvD)",0.456492973774049,0.0461489157141331,0
"<anonymized_userid>",37,34536,433,"Thierry Baudet (FvD)",0.456982560139731,0.0462557419079158,0
"<anonymized_userid>",37,34573,434,"Thierry Baudet (FvD)",0.457472146505412,0.0463625681016985,0
"<anonymized_userid>",37,34610,435,"Thierry Baudet (FvD)",0.457961732871093,0.0464693942954813,0
"<anonymized_userid>",36,34646,436,"Thierry Baudet (FvD)",0.458438087172837,0.046576220489264,0
"<anonymized_userid>",36,34682,437,"Thierry Baudet (FvD)",0.458914441474581,0.0466830466830467,0
"<anonymized_userid>",36,34718,438,"Thierry Baudet (FvD)",0.459390795776325,0.0467898728768294,0
"<anonymized_userid>",36,34754,439,"Thierry Baudet (FvD)",0.459867150078069,0.0468966990706121,0
"<anonymized_userid>",36,34790,440,"Thierry Baudet (FvD)",0.460343504379813,0.0470035252643948,0
"<anonymized_userid>",36,34826,441,"Thierry Baudet (FvD)",0.460819858681557,0.0471103514581775,0
"<anonymized_userid>",36,34862,442,"Thierry Baudet (FvD)",0.461296212983301,0.0472171776519603,0
"<anonymized_userid>",36,34898,443,"Thierry Baudet (FvD)",0.461772567285045,0.047324003845743,0
"<anonymized_userid>",36,34934,444,"Thierry Baudet (FvD)",0.462248921586789,0.0474308300395257,0
"<anonymized_userid>",36,34970,445,"Thierry Baudet (FvD)",0.462725275888533,0.0475376562333084,0
"<anonymized_userid>",36,35006,446,"Thierry Baudet (FvD)",0.463201630190277,0.0476444824270911,0
"<anonymized_userid>",36,35042,447,"Thierry Baudet (FvD)",0.463677984492021,0.0477513086208738,0
"<anonymized_userid>",36,35078,448,"Thierry Baudet (FvD)",0.464154338793765,0.0478581348146566,0
"<anonymized_userid>",36,35114,449,"Thierry Baudet (FvD)",0.464630693095509,0.0479649610084393,0
"<anonymized_userid>",36,35150,450,"Thierry Baudet (FvD)",0.465107047397253,0.048071787202222,0
"<anonymized_userid>",36,35186,451,"Thierry Baudet (FvD)",0.465583401698997,0.0481786133960047,0
"<anonymized_userid>",36,35222,452,"Thierry Baudet (FvD)",0.466059756000741,0.0482854395897874,0
"<anonymized_userid>",36,35258,453,"Thierry Baudet (FvD)",0.466536110302485,0.0483922657835701,0
"<anonymized_userid>",35,35293,454,"Thierry Baudet (FvD)",0.466999232540292,0.0484990919773528,0
"<anonymized_userid>",35,35328,455,"Thierry Baudet (FvD)",0.467462354778098,0.0486059181711356,0
"<anonymized_userid>",35,35363,456,"Thierry Baudet (FvD)",0.467925477015905,0.0487127443649183,0
"<anonymized_userid>",35,35398,457,"Thierry Baudet (FvD)",0.468388599253712,0.048819570558701,0
"<anonymized_userid>",35,35433,458,"Thierry Baudet (FvD)",0.468851721491518,0.0489263967524837,0
"<anonymized_userid>",35,35468,459,"Thierry Baudet (FvD)",0.469314843729325,0.0490332229462664,0
"<anonymized_userid>",35,35503,460,"Thierry Baudet (FvD)",0.469777965967132,0.0491400491400491,0
"<anonymized_userid>",35,35538,461,"Thierry Baudet (FvD)",0.470241088204938,0.0492468753338319,0
"<anonymized_userid>",35,35573,462,"Thierry Baudet (FvD)",0.470704210442745,0.0493537015276146,0
"<anonymized_userid>",35,35608,463,"Thierry Baudet (FvD)",0.471167332680551,0.0494605277213973,0
"<anonymized_userid>",35,35643,464,"Thierry Baudet (FvD)",0.471630454918358,0.04956735391518,0
"<anonymized_userid>",34,35677,465,"Thierry Baudet (FvD)",0.472080345092227,0.0496741801089627,0
"<anonymized_userid>",34,35711,466,"Thierry Baudet (FvD)",0.472530235266097,0.0497810063027454,0
"<anonymized_userid>",34,35745,467,"Thierry Baudet (FvD)",0.472980125439966,0.0498878324965282,0
"<anonymized_userid>",34,35779,468,"Thierry Baudet (FvD)",0.473430015613835,0.0499946586903109,0
"<anonymized_userid>",34,35813,469,"Thierry Baudet (FvD)",0.473879905787705,0.0501014848840936,0
"<anonymized_userid>",34,35847,470,"Thierry Baudet (FvD)",0.474329795961574,0.0502083110778763,0
"<anonymized_userid>",34,35881,471,"Thierry Baudet (FvD)",0.474779686135443,0.050315137271659,0
"<anonymized_userid>",34,35915,472,"Thierry Baudet (FvD)",0.475229576309313,0.0504219634654417,0
"<anonymized_userid>",34,35949,473,"Thierry Baudet (FvD)",0.475679466483182,0.0505287896592244,0
"<anonymized_userid>",34,35983,474,"Thierry Baudet (FvD)",0.476129356657051,0.0506356158530072,0
"<anonymized_userid>",34,36017,475,"Thierry Baudet (FvD)",0.476579246830921,0.0507424420467899,0
"<anonymized_userid>",34,36051,476,"Thierry Baudet (FvD)",0.47702913700479,0.0508492682405726,0
"<anonymized_userid>",34,36085,477,"Thierry Baudet (FvD)",0.477479027178659,0.0509560944343553,0
"<anonymized_userid>",34,36119,478,"Thierry Baudet (FvD)",0.477928917352529,0.051062920628138,0
"<anonymized_userid>",34,36153,479,"Thierry Baudet (FvD)",0.478378807526398,0.0511697468219207,0
"<anonymized_userid>",34,36187,480,"Thierry Baudet (FvD)",0.478828697700267,0.0512765730157035,0
"<anonymized_userid>",33,36220,481,"Thierry Baudet (FvD)",0.479265355810199,0.0513833992094862,0
"<anonymized_userid>",33,36253,482,"Thierry Baudet (FvD)",0.479702013920131,0.0514902254032689,0
"<anonymized_userid>",33,36286,483,"Thierry Baudet (FvD)",0.480138672030063,0.0515970515970516,0
"<anonymized_userid>",33,36319,484,"Thierry Baudet (FvD)",0.480575330139995,0.0517038777908343,0
"<anonymized_userid>",33,36352,485,"Thierry Baudet (FvD)",0.481011988249927,0.051810703984617,0
"<anonymized_userid>",33,36385,486,"Thierry Baudet (FvD)",0.481448646359859,0.0519175301783997,0
"<anonymized_userid>",33,36418,487,"Thierry Baudet (FvD)",0.481885304469791,0.0520243563721825,0
"<anonymized_userid>",33,36451,488,"Thierry Baudet (FvD)",0.482321962579723,0.0521311825659652,0
"<anonymized_userid>",33,36484,489,"Thierry Baudet (FvD)",0.482758620689655,0.0522380087597479,0
"<anonymized_userid>",33,36517,490,"Thierry Baudet (FvD)",0.483195278799587,0.0523448349535306,0
"<anonymized_userid>",33,36550,491,"Thierry Baudet (FvD)",0.483631936909519,0.0524516611473133,0
"<anonymized_userid>",33,36583,492,"Thierry Baudet (FvD)",0.484068595019451,0.052558487341096,0
"<anonymized_userid>",33,36616,493,"Thierry Baudet (FvD)",0.484505253129383,0.0526653135348788,0
"<anonymized_userid>",33,36649,494,"Thierry Baudet (FvD)",0.484941911239315,0.0527721397286615,0
"<anonymized_userid>",33,36682,495,"Thierry Baudet (FvD)",0.485378569349247,0.0528789659224442,0
"<anonymized_userid>",33,36715,496,"Thierry Baudet (FvD)",0.485815227459179,0.0529857921162269,0
"<anonymized_userid>",33,36748,497,"Thierry Baudet (FvD)",0.486251885569111,0.0530926183100096,0
"<anonymized_userid>",33,36781,498,"Thierry Baudet (FvD)",0.486688543679043,0.0531994445037923,0
"<anonymized_userid>",33,36814,499,"Thierry Baudet (FvD)",0.487125201788975,0.053306270697575,0
"<anonymized_userid>",33,36847,500,"Thierry Baudet (FvD)",0.487561859898907,0.0534130968913578,0
"<anonymized_userid>",33,36880,501,"Thierry Baudet (FvD)",0.487998518008839,0.0535199230851405,0
"<anonymized_userid>",33,36913,502,"Thierry Baudet (FvD)",0.488435176118771,0.0536267492789232,0
"<anonymized_userid>",33,36946,503,"Thierry Baudet (FvD)",0.488871834228703,0.0537335754727059,0
"<anonymized_userid>",33,36979,504,"Thierry Baudet (FvD)",0.489308492338635,0.0538404016664886,0
"<anonymized_userid>",33,37012,505,"Thierry Baudet (FvD)",0.489745150448567,0.0539472278602713,0
"<anonymized_userid>",33,37045,506,"Thierry Baudet (FvD)",0.490181808558499,0.0540540540540541,0
"<anonymized_userid>",33,37078,507,"Thierry Baudet (FvD)",0.490618466668431,0.0541608802478368,0
"<anonymized_userid>",33,37111,508,"Thierry Baudet (FvD)",0.491055124778363,0.0542677064416195,0
"<anonymized_userid>",33,37144,509,"Thierry Baudet (FvD)",0.491491782888295,0.0543745326354022,0
"<anonymized_userid>",33,37177,510,"Thierry Baudet (FvD)",0.491928440998227,0.0544813588291849,0
"<anonymized_userid>",32,37209,511,"Thierry Baudet (FvD)",0.492351867044222,0.0545881850229676,0
"<anonymized_userid>",32,37241,512,"Thierry Baudet (FvD)",0.492775293090216,0.0546950112167503,0
"<anonymized_userid>",32,37273,513,"Thierry Baudet (FvD)",0.493198719136211,0.0548018374105331,0
"<anonymized_userid>",32,37305,514,"Thierry Baudet (FvD)",0.493622145182206,0.0549086636043158,0
"<anonymized_userid>",32,37337,515,"Thierry Baudet (FvD)",0.4940455712282,0.0550154897980985,0
"<anonymized_userid>",32,37369,516,"Thierry Baudet (FvD)",0.494468997274195,0.0551223159918812,0
"<anonymized_userid>",32,37401,517,"Thierry Baudet (FvD)",0.494892423320189,0.0552291421856639,0
"<anonymized_userid>",32,37433,518,"Thierry Baudet (FvD)",0.495315849366184,0.0553359683794466,0
"<anonymized_userid>",32,37465,519,"Thierry Baudet (FvD)",0.495739275412179,0.0554427945732294,0
"<anonymized_userid>",32,37497,520,"Thierry Baudet (FvD)",0.496162701458173,0.0555496207670121,0
"<anonymized_userid>",32,37529,521,"Thierry Baudet (FvD)",0.496586127504168,0.0556564469607948,0
"<anonymized_userid>",32,37561,522,"Thierry Baudet (FvD)",0.497009553550163,0.0557632731545775,0
"<anonymized_userid>",32,37593,523,"Thierry Baudet (FvD)",0.497432979596157,0.0558700993483602,0
"<anonymized_userid>",32,37625,524,"Thierry Baudet (FvD)",0.497856405642152,0.0559769255421429,0
"<anonymized_userid>",32,37657,525,"Thierry Baudet (FvD)",0.498279831688147,0.0560837517359256,0
"<anonymized_userid>",32,37689,526,"Thierry Baudet (FvD)",0.498703257734141,0.0561905779297084,0
"<anonymized_userid>",32,37721,527,"Thierry Baudet (FvD)",0.499126683780136,0.0562974041234911,0
"<anonymized_userid>",32,37753,528,"Thierry Baudet (FvD)",0.499550109826131,0.0564042303172738,0
"<anonymized_userid>",32,37785,529,"Thierry Baudet (FvD)",0.499973535872125,0.0565110565110565,0
"<anonymized_userid>",32,37817,530,"Thierry Baudet (FvD)",0.50039696191812,0.0566178827048392,0
"<anonymized_userid>",32,37849,531,"Thierry Baudet (FvD)",0.500820387964115,0.0567247088986219,0
"<anonymized_userid>",32,37881,532,"Thierry Baudet (FvD)",0.501243814010109,0.0568315350924047,0
"<anonymized_userid>",32,37913,533,"Thierry Baudet (FvD)",0.501667240056104,0.0569383612861874,0
"<anonymized_userid>",32,37945,534,"Thierry Baudet (FvD)",0.502090666102099,0.0570451874799701,0
"<anonymized_userid>",31,37976,535,"Thierry Baudet (FvD)",0.502500860084156,0.0571520136737528,0
"<anonymized_userid>",31,38007,536,"Thierry Baudet (FvD)",0.502911054066213,0.0572588398675355,0
"<anonymized_userid>",31,38038,537,"Thierry Baudet (FvD)",0.503321248048271,0.0573656660613182,0
"<anonymized_userid>",31,38069,538,"Thierry Baudet (FvD)",0.503731442030328,0.0574724922551009,0
"<anonymized_userid>",31,38100,539,"Thierry Baudet (FvD)",0.504141636012385,0.0575793184488837,0
"<anonymized_userid>",31,38131,540,"Thierry Baudet (FvD)",0.504551829994442,0.0576861446426664,0
"<anonymized_userid>",31,38162,541,"Thierry Baudet (FvD)",0.5049620239765,0.0577929708364491,0
"<anonymized_userid>",31,38193,542,"Thierry Baudet (FvD)",0.505372217958557,0.0578997970302318,0
"<anonymized_userid>",31,38224,543,"Thierry Baudet (FvD)",0.505782411940614,0.0580066232240145,0
"<anonymized_userid>",31,38255,544,"Thierry Baudet (FvD)",0.506192605922672,0.0581134494177972,0
"<anonymized_userid>",31,38286,545,"Thierry Baudet (FvD)",0.506602799904729,0.05822027561158,0
"<anonymized_userid>",31,38317,546,"Thierry Baudet (FvD)",0.507012993886786,0.0583271018053627,0
"<anonymized_userid>",31,38348,547,"Thierry Baudet (FvD)",0.507423187868844,0.0584339279991454,0
"<anonymized_userid>",31,38379,548,"Thierry Baudet (FvD)",0.507833381850901,0.0585407541929281,0
"<anonymized_userid>",31,38410,549,"Thierry Baudet (FvD)",0.508243575832958,0.0586475803867108,0
"<anonymized_userid>",31,38441,550,"Thierry Baudet (FvD)",0.508653769815016,0.0587544065804935,0
"<anonymized_userid>",31,38472,551,"Thierry Baudet (FvD)",0.509063963797073,0.0588612327742763,0
"<anonymized_userid>",31,38503,552,"Thierry Baudet (FvD)",0.50947415777913,0.058968058968059,0
"<anonymized_userid>",31,38534,553,"Thierry Baudet (FvD)",0.509884351761188,0.0590748851618417,0
"<anonymized_userid>",31,38565,554,"Thierry Baudet (FvD)",0.510294545743245,0.0591817113556244,0
"<anonymized_userid>",31,38596,555,"Thierry Baudet (FvD)",0.510704739725302,0.0592885375494071,0
"<anonymized_userid>",31,38627,556,"Thierry Baudet (FvD)",0.51111493370736,0.0593953637431898,0
"<anonymized_userid>",31,38658,557,"Thierry Baudet (FvD)",0.511525127689417,0.0595021899369725,0
"<anonymized_userid>",30,38688,558,"Thierry Baudet (FvD)",0.511922089607537,0.0596090161307553,0
"<anonymized_userid>",30,38718,559,"Thierry Baudet (FvD)",0.512319051525657,0.059715842324538,0
"<anonymized_userid>",30,38748,560,"Thierry Baudet (FvD)",0.512716013443777,0.0598226685183207,0
"<anonymized_userid>",30,38778,561,"Thierry Baudet (FvD)",0.513112975361897,0.0599294947121034,0
"<anonymized_userid>",30,38808,562,"Thierry Baudet (FvD)",0.513509937280017,0.0600363209058861,0
"<anonymized_userid>",30,38838,563,"Thierry Baudet (FvD)",0.513906899198137,0.0601431470996688,0
"<anonymized_userid>",30,38868,564,"Thierry Baudet (FvD)",0.514303861116257,0.0602499732934516,0
"<anonymized_userid>",30,38898,565,"Thierry Baudet (FvD)",0.514700823034377,0.0603567994872343,0
"<anonymized_userid>",30,38928,566,"Thierry Baudet (FvD)",0.515097784952497,0.060463625681017,0
"<anonymized_userid>",30,38958,567,"Thierry Baudet (FvD)",0.515494746870617,0.0605704518747997,0
"<anonymized_userid>",30,38988,568,"Thierry Baudet (FvD)",0.515891708788737,0.0606772780685824,0
"<anonymized_userid>",30,39018,569,"Thierry Baudet (FvD)",0.516288670706857,0.0607841042623651,0
"<anonymized_userid>",30,39048,570,"Thierry Baudet (FvD)",0.516685632624977,0.0608909304561478,0
"<anonymized_userid>",30,39078,571,"Thierry Baudet (FvD)",0.517082594543097,0.0609977566499306,0
"<anonymized_userid>",30,39108,572,"Thierry Baudet (FvD)",0.517479556461217,0.0611045828437133,0
"<anonymized_userid>",30,39138,573,"Thierry Baudet (FvD)",0.517876518379337,0.061211409037496,0
"<anonymized_userid>",30,39168,574,"Thierry Baudet (FvD)",0.518273480297457,0.0613182352312787,0
"<anonymized_userid>",30,39198,575,"Thierry Baudet (FvD)",0.518670442215577,0.0614250614250614,0
"<anonymized_userid>",30,39228,576,"Thierry Baudet (FvD)",0.519067404133697,0.0615318876188441,0
"<anonymized_userid>",30,39258,577,"Thierry Baudet (FvD)",0.519464366051817,0.0616387138126269,0
"<anonymized_userid>",30,39288,578,"Thierry Baudet (FvD)",0.519861327969937,0.0617455400064096,0
"<anonymized_userid>",30,39318,579,"Thierry Baudet (FvD)",0.520258289888057,0.0618523662001923,0
"<anonymized_userid>",30,39348,580,"Thierry Baudet (FvD)",0.520655251806177,0.061959192393975,0
"<anonymized_userid>",29,39377,581,"Thierry Baudet (FvD)",0.521038981660359,0.0620660185877577,0
"<anonymized_userid>",29,39406,582,"Thierry Baudet (FvD)",0.521422711514542,0.0621728447815404,0
"<anonymized_userid>",29,39435,583,"Thierry Baudet (FvD)",0.521806441368725,0.0622796709753232,0
"<anonymized_userid>",29,39464,584,"Thierry Baudet (FvD)",0.522190171222907,0.0623864971691059,0
"<anonymized_userid>",29,39493,585,"Thierry Baudet (FvD)",0.52257390107709,0.0624933233628886,0
"<anonymized_userid>",29,39522,586,"Thierry Baudet (FvD)",0.522957630931273,0.0626001495566713,0
"<anonymized_userid>",29,39551,587,"Thierry Baudet (FvD)",0.523341360785455,0.062706975750454,0
"<anonymized_userid>",29,39580,588,"Thierry Baudet (FvD)",0.523725090639638,0.0628138019442367,0
"<anonymized_userid>",29,39609,589,"Thierry Baudet (FvD)",0.524108820493821,0.0629206281380194,0
"<anonymized_userid>",29,39638,590,"Thierry Baudet (FvD)",0.524492550348003,0.0630274543318022,0
"<anonymized_userid>",29,39667,591,"Thierry Baudet (FvD)",0.524876280202186,0.0631342805255849,0
"<anonymized_userid>",29,39696,592,"Thierry Baudet (FvD)",0.525260010056369,0.0632411067193676,0
"<anonymized_userid>",29,39725,593,"Thierry Baudet (FvD)",0.525643739910551,0.0633479329131503,0
"<anonymized_userid>",28,39753,594,"Thierry Baudet (FvD)",0.526014237700797,0.063454759106933,0
"<anonymized_userid>",28,39781,595,"Thierry Baudet (FvD)",0.526384735491042,0.0635615853007157,0
"<anonymized_userid>",28,39809,596,"Thierry Baudet (FvD)",0.526755233281287,0.0636684114944985,0
"<anonymized_userid>",28,39837,597,"Thierry Baudet (FvD)",0.527125731071532,0.0637752376882812,0
"<anonymized_userid>",28,39865,598,"Thierry Baudet (FvD)",0.527496228861778,0.0638820638820639,0
"<anonymized_userid>",28,39893,599,"Thierry Baudet (FvD)",0.527866726652023,0.0639888900758466,0
"<anonymized_userid>",28,39921,600,"Thierry Baudet (FvD)",0.528237224442269,0.0640957162696293,0
"<anonymized_userid>",28,39949,601,"Thierry Baudet (FvD)",0.528607722232514,0.064202542463412,0
"<anonymized_userid>",28,39977,602,"Thierry Baudet (FvD)",0.528978220022759,0.0643093686571947,0
"<anonymized_userid>",28,40005,603,"Thierry Baudet (FvD)",0.529348717813005,0.0644161948509775,0
"<anonymized_userid>",28,40033,604,"Thierry Baudet (FvD)",0.52971921560325,0.0645230210447602,0
"<anonymized_userid>",28,40061,605,"Thierry Baudet (FvD)",0.530089713393495,0.0646298472385429,0
"<anonymized_userid>",28,40089,606,"Thierry Baudet (FvD)",0.53046021118374,0.0647366734323256,0
"<anonymized_userid>",28,40117,607,"Thierry Baudet (FvD)",0.530830708973986,0.0648434996261083,0
"<anonymized_userid>",28,40145,608,"Thierry Baudet (FvD)",0.531201206764231,0.064950325819891,0
"<anonymized_userid>",28,40173,609,"Thierry Baudet (FvD)",0.531571704554476,0.0650571520136737,0
"<anonymized_userid>",28,40201,610,"Thierry Baudet (FvD)",0.531942202344722,0.0651639782074565,0
"<anonymized_userid>",28,40229,611,"Thierry Baudet (FvD)",0.532312700134967,0.0652708044012392,0
"<anonymized_userid>",28,40257,612,"Thierry Baudet (FvD)",0.532683197925212,0.0653776305950219,0
"<anonymized_userid>",28,40285,613,"Thierry Baudet (FvD)",0.533053695715458,0.0654844567888046,0
"<anonymized_userid>",28,40313,614,"Thierry Baudet (FvD)",0.533424193505703,0.0655912829825873,0
"<anonymized_userid>",27,40340,615,"Thierry Baudet (FvD)",0.533781459232011,0.06569810917637,0
"<anonymized_userid>",27,40367,616,"Thierry Baudet (FvD)",0.534138724958319,0.0658049353701528,0
"<anonymized_userid>",27,40394,617,"Thierry Baudet (FvD)",0.534495990684627,0.0659117615639355,0
"<anonymized_userid>",27,40421,618,"Thierry Baudet (FvD)",0.534853256410935,0.0660185877577182,0
"<anonymized_userid>",27,40448,619,"Thierry Baudet (FvD)",0.535210522137243,0.0661254139515009,0
"<anonymized_userid>",27,40475,620,"Thierry Baudet (FvD)",0.535567787863551,0.0662322401452836,0
"<anonymized_userid>",27,40502,621,"Thierry Baudet (FvD)",0.535925053589859,0.0663390663390663,0
"<anonymized_userid>",27,40529,622,"Thierry Baudet (FvD)",0.536282319316167,0.066445892532849,0
"<anonymized_userid>",27,40556,623,"Thierry Baudet (FvD)",0.536639585042475,0.0665527187266318,0
"<anonymized_userid>",27,40583,624,"Thierry Baudet (FvD)",0.536996850768783,0.0666595449204145,0
"<anonymized_userid>",27,40610,625,"Thierry Baudet (FvD)",0.537354116495091,0.0667663711141972,0
"<anonymized_userid>",27,40637,626,"Thierry Baudet (FvD)",0.537711382221399,0.0668731973079799,0
"<anonymized_userid>",27,40664,627,"Thierry Baudet (FvD)",0.538068647947707,0.0669800235017626,0
"<anonymized_userid>",27,40691,628,"Thierry Baudet (FvD)",0.538425913674015,0.0670868496955453,0
"<anonymized_userid>",27,40718,629,"Thierry Baudet (FvD)",0.538783179400323,0.0671936758893281,0
"<anonymized_userid>",27,40745,630,"Thierry Baudet (FvD)",0.539140445126631,0.0673005020831108,0
"<anonymized_userid>",27,40772,631,"Thierry Baudet (FvD)",0.539497710852939,0.0674073282768935,0
"<anonymized_userid>",27,40799,632,"Thierry Baudet (FvD)",0.539854976579247,0.0675141544706762,0
"<anonymized_userid>",27,40826,633,"Thierry Baudet (FvD)",0.540212242305555,0.0676209806644589,0
"<anonymized_userid>",27,40853,634,"Thierry Baudet (FvD)",0.540569508031863,0.0677278068582416,0
"<anonymized_userid>",27,40880,635,"Thierry Baudet (FvD)",0.540926773758171,0.0678346330520244,0
"<anonymized_userid>",27,40907,636,"Thierry Baudet (FvD)",0.541284039484479,0.0679414592458071,0
"<anonymized_userid>",27,40934,637,"Thierry Baudet (FvD)",0.541641305210787,0.0680482854395898,0
"<anonymized_userid>",26,40960,638,"Thierry Baudet (FvD)",0.541985338873157,0.0681551116333725,0
"<anonymized_userid>",26,40986,639,"Thierry Baudet (FvD)",0.542329372535528,0.0682619378271552,0
"<anonymized_userid>",26,41012,640,"Thierry Baudet (FvD)",0.542673406197899,0.0683687640209379,0
"<anonymized_userid>",26,41038,641,"Thierry Baudet (FvD)",0.543017439860269,0.0684755902147206,0
"<anonymized_userid>",26,41064,642,"Thierry Baudet (FvD)",0.54336147352264,0.0685824164085034,0
"<anonymized_userid>",26,41090,643,"Thierry Baudet (FvD)",0.543705507185011,0.0686892426022861,0
"<anonymized_userid>",26,41116,644,"Thierry Baudet (FvD)",0.544049540847381,0.0687960687960688,0
"<anonymized_userid>",26,41142,645,"Thierry Baudet (FvD)",0.544393574509752,0.0689028949898515,0
"<anonymized_userid>",26,41168,646,"Thierry Baudet (FvD)",0.544737608172123,0.0690097211836342,0
"<anonymized_userid>",26,41194,647,"Thierry Baudet (FvD)",0.545081641834493,0.0691165473774169,0
"<anonymized_userid>",26,41220,648,"Thierry Baudet (FvD)",0.545425675496864,0.0692233735711997,0
"<anonymized_userid>",26,41246,649,"Thierry Baudet (FvD)",0.545769709159235,0.0693301997649824,0
"<anonymized_userid>",26,41272,650,"Thierry Baudet (FvD)",0.546113742821605,0.0694370259587651,0
"<anonymized_userid>",26,41298,651,"Thierry Baudet (FvD)",0.546457776483976,0.0695438521525478,0
"<anonymized_userid>",26,41324,652,"Thierry Baudet (FvD)",0.546801810146347,0.0696506783463305,0
"<anonymized_userid>",26,41350,653,"Thierry Baudet (FvD)",0.547145843808717,0.0697575045401132,0
"<anonymized_userid>",26,41376,654,"Thierry Baudet (FvD)",0.547489877471088,0.0698643307338959,0
"<anonymized_userid>",26,41402,655,"Thierry Baudet (FvD)",0.547833911133459,0.0699711569276787,0
"<anonymized_userid>",26,41428,656,"Thierry Baudet (FvD)",0.548177944795829,0.0700779831214614,0
"<anonymized_userid>",26,41454,657,"Thierry Baudet (FvD)",0.5485219784582,0.0701848093152441,0
"<anonymized_userid>",26,41480,658,"Thierry Baudet (FvD)",0.548866012120571,0.0702916355090268,0
"<anonymized_userid>",26,41506,659,"Thierry Baudet (FvD)",0.549210045782941,0.0703984617028095,0
"<anonymized_userid>",26,41532,660,"Thierry Baudet (FvD)",0.549554079445312,0.0705052878965922,0
"<anonymized_userid>",26,41558,661,"Thierry Baudet (FvD)",0.549898113107683,0.070612114090375,0
"<anonymized_userid>",26,41584,662,"Thierry Baudet (FvD)",0.550242146770053,0.0707189402841577,0
"<anonymized_userid>",25,41609,663,"Thierry Baudet (FvD)",0.550572948368486,0.0708257664779404,0
"<anonymized_userid>",25,41634,664,"Thierry Baudet (FvD)",0.55090374996692,0.0709325926717231,0
"<anonymized_userid>",25,41659,665,"Thierry Baudet (FvD)",0.551234551565353,0.0710394188655058,0
"<anonymized_userid>",25,41684,666,"Thierry Baudet (FvD)",0.551565353163787,0.0711462450592885,0
"<anonymized_userid>",25,41709,667,"Thierry Baudet (FvD)",0.55189615476222,0.0712530712530713,0
"<anonymized_userid>",25,41734,668,"Thierry Baudet (FvD)",0.552226956360653,0.071359897446854,0
"<anonymized_userid>",25,41759,669,"Thierry Baudet (FvD)",0.552557757959086,0.0714667236406367,0
"<anonymized_userid>",25,41784,670,"Thierry Baudet (FvD)",0.55288855955752,0.0715735498344194,0
"<anonymized_userid>",25,41809,671,"Thierry Baudet (FvD)",0.553219361155953,0.0716803760282021,0
"<anonymized_userid>",25,41834,672,"Thierry Baudet (FvD)",0.553550162754386,0.0717872022219848,0
"<anonymized_userid>",25,41859,673,"Thierry Baudet (FvD)",0.55388096435282,0.0718940284157675,0
"<anonymized_userid>",25,41884,674,"Thierry Baudet (FvD)",0.554211765951253,0.0720008546095503,0
"<anonymized_userid>",25,41909,675,"Thierry Baudet (FvD)",0.554542567549686,0.072107680803333,0
"<anonymized_userid>",25,41934,676,"Thierry Baudet (FvD)",0.55487336914812,0.0722145069971157,0
"<anonymized_userid>",25,41959,677,"Thierry Baudet (FvD)",0.555204170746553,0.0723213331908984,0
"<anonymized_userid>",25,41984,678,"Thierry Baudet (FvD)",0.555534972344986,0.0724281593846811,0
"<anonymized_userid>",25,42009,679,"Thierry Baudet (FvD)",0.55586577394342,0.0725349855784638,0
"<anonymized_userid>",25,42034,680,"Thierry Baudet (FvD)",0.556196575541853,0.0726418117722466,0
"<anonymized_userid>",25,42059,681,"Thierry Baudet (FvD)",0.556527377140286,0.0727486379660293,0
"<anonymized_userid>",25,42084,682,"Thierry Baudet (FvD)",0.55685817873872,0.072855464159812,0
"<anonymized_userid>",25,42109,683,"Thierry Baudet (FvD)",0.557188980337153,0.0729622903535947,0
"<anonymized_userid>",25,42134,684,"Thierry Baudet (FvD)",0.557519781935586,0.0730691165473774,0
"<anonymized_userid>",25,42159,685,"Thierry Baudet (FvD)",0.55785058353402,0.0731759427411601,0
"<anonymized_userid>",25,42184,686,"Thierry Baudet (FvD)",0.558181385132453,0.0732827689349428,0
"<anonymized_userid>",25,42209,687,"Thierry Baudet (FvD)",0.558512186730886,0.0733895951287256,0
"<anonymized_userid>",25,42234,688,"Thierry Baudet (FvD)",0.55884298832932,0.0734964213225083,0
"<anonymized_userid>",25,42259,689,"Thierry Baudet (FvD)",0.559173789927753,0.073603247516291,0
"<anonymized_userid>",25,42284,690,"Thierry Baudet (FvD)",0.559504591526186,0.0737100737100737,0
"<anonymized_userid>",25,42309,691,"Thierry Baudet (FvD)",0.55983539312462,0.0738168999038564,0
"<anonymized_userid>",25,42334,692,"Thierry Baudet (FvD)",0.560166194723053,0.0739237260976391,0
"<anonymized_userid>",25,42359,693,"Thierry Baudet (FvD)",0.560496996321486,0.0740305522914219,0
"<anonymized_userid>",25,42384,694,"Thierry Baudet (FvD)",0.56082779791992,0.0741373784852046,0
"<anonymized_userid>",24,42408,695,"Thierry Baudet (FvD)",0.561145367454416,0.0742442046789873,0
"<anonymized_userid>",24,42432,696,"Thierry Baudet (FvD)",0.561462936988911,0.07435103087277,0
"<anonymized_userid>",24,42456,697,"Thierry Baudet (FvD)",0.561780506523407,0.0744578570665527,0
"<anonymized_userid>",24,42480,698,"Thierry Baudet (FvD)",0.562098076057904,0.0745646832603354,0
"<anonymized_userid>",24,42504,699,"Thierry Baudet (FvD)",0.5624156455924,0.0746715094541181,0
"<anonymized_userid>",24,42528,700,"Thierry Baudet (FvD)",0.562733215126895,0.0747783356479009,0
"<anonymized_userid>",24,42552,701,"Thierry Baudet (FvD)",0.563050784661391,0.0748851618416836,0
"<anonymized_userid>",24,42576,702,"Thierry Baudet (FvD)",0.563368354195887,0.0749919880354663,0
"<anonymized_userid>",24,42600,703,"Thierry Baudet (FvD)",0.563685923730384,0.075098814229249,0
"<anonymized_userid>",24,42624,704,"Thierry Baudet (FvD)",0.564003493264879,0.0752056404230317,0
"<anonymized_userid>",24,42648,705,"Thierry Baudet (FvD)",0.564321062799375,0.0753124666168144,0
"<anonymized_userid>",24,42672,706,"Thierry Baudet (FvD)",0.564638632333871,0.0754192928105972,0
"<anonymized_userid>",24,42696,707,"Thierry Baudet (FvD)",0.564956201868367,0.0755261190043799,0
"<anonymized_userid>",24,42720,708,"Thierry Baudet (FvD)",0.565273771402863,0.0756329451981626,0
"<anonymized_userid>",24,42744,709,"Thierry Baudet (FvD)",0.565591340937359,0.0757397713919453,0
"<anonymized_userid>",24,42768,710,"Thierry Baudet (FvD)",0.565908910471855,0.075846597585728,0
"<anonymized_userid>",24,42792,711,"Thierry Baudet (FvD)",0.566226480006351,0.0759534237795107,0
"<anonymized_userid>",24,42816,712,"Thierry Baudet (FvD)",0.566544049540847,0.0760602499732935,0
"<anonymized_userid>",24,42840,713,"Thierry Baudet (FvD)",0.566861619075343,0.0761670761670762,0
"<anonymized_userid>",24,42864,714,"Thierry Baudet (FvD)",0.567179188609839,0.0762739023608589,0
"<anonymized_userid>",24,42888,715,"Thierry Baudet (FvD)",0.567496758144335,0.0763807285546416,0
"<anonymized_userid>",24,42912,716,"Thierry Baudet (FvD)",0.567814327678831,0.0764875547484243,0
"<anonymized_userid>",24,42936,717,"Thierry Baudet (FvD)",0.568131897213327,0.076594380942207,0
"<anonymized_userid>",24,42960,718,"Thierry Baudet (FvD)",0.568449466747823,0.0767012071359897,0
"<anonymized_userid>",24,42984,719,"Thierry Baudet (FvD)",0.568767036282319,0.0768080333297725,0
"<anonymized_userid>",24,43008,720,"Thierry Baudet (FvD)",0.569084605816815,0.0769148595235552,0
"<anonymized_userid>",24,43032,721,"Thierry Baudet (FvD)",0.569402175351311,0.0770216857173379,0
"<anonymized_userid>",24,43056,722,"Thierry Baudet (FvD)",0.569719744885807,0.0771285119111206,0
"<anonymized_userid>",24,43080,723,"Thierry Baudet (FvD)",0.570037314420303,0.0772353381049033,0
"<anonymized_userid>",24,43104,724,"Thierry Baudet (FvD)",0.570354883954799,0.077342164298686,0
"<anonymized_userid>",24,43128,725,"Thierry Baudet (FvD)",0.570672453489295,0.0774489904924688,0
"<anonymized_userid>",24,43152,726,"Thierry Baudet (FvD)",0.570990023023791,0.0775558166862515,0
"<anonymized_userid>",24,43176,727,"Thierry Baudet (FvD)",0.571307592558287,0.0776626428800342,0
"<anonymized_userid>",24,43200,728,"Thierry Baudet (FvD)",0.571625162092783,0.0777694690738169,0
"<anonymized_userid>",24,43224,729,"Thierry Baudet (FvD)",0.571942731627279,0.0778762952675996,0
"<anonymized_userid>",23,43247,730,"Thierry Baudet (FvD)",0.572247069097838,0.0779831214613823,0
"<anonymized_userid>",23,43270,731,"Thierry Baudet (FvD)",0.572551406568397,0.078089947655165,0
"<anonymized_userid>",23,43293,732,"Thierry Baudet (FvD)",0.572855744038955,0.0781967738489478,0
"<anonymized_userid>",23,43316,733,"Thierry Baudet (FvD)",0.573160081509514,0.0783036000427305,0
"<anonymized_userid>",23,43339,734,"Thierry Baudet (FvD)",0.573464418980072,0.0784104262365132,0
"<anonymized_userid>",23,43362,735,"Thierry Baudet (FvD)",0.573768756450631,0.0785172524302959,0
"<anonymized_userid>",23,43385,736,"Thierry Baudet (FvD)",0.57407309392119,0.0786240786240786,0
"<anonymized_userid>",23,43408,737,"Thierry Baudet (FvD)",0.574377431391748,0.0787309048178613,0
"<anonymized_userid>",23,43431,738,"Thierry Baudet (FvD)",0.574681768862307,0.0788377310116441,0
"<anonymized_userid>",23,43454,739,"Thierry Baudet (FvD)",0.574986106332866,0.0789445572054268,0
"<anonymized_userid>",23,43477,740,"Thierry Baudet (FvD)",0.575290443803424,0.0790513833992095,0
"<anonymized_userid>",23,43500,741,"Thierry Baudet (FvD)",0.575594781273983,0.0791582095929922,0
"<anonymized_userid>",23,43523,742,"Thierry Baudet (FvD)",0.575899118744542,0.0792650357867749,0
"<anonymized_userid>",23,43546,743,"Thierry Baudet (FvD)",0.5762034562151,0.0793718619805576,0
"<anonymized_userid>",23,43569,744,"Thierry Baudet (FvD)",0.576507793685659,0.0794786881743404,0
"<anonymized_userid>",23,43592,745,"Thierry Baudet (FvD)",0.576812131156218,0.0795855143681231,0
"<anonymized_userid>",23,43615,746,"Thierry Baudet (FvD)",0.577116468626776,0.0796923405619058,0
"<anonymized_userid>",23,43638,747,"Thierry Baudet (FvD)",0.577420806097335,0.0797991667556885,0
"<anonymized_userid>",23,43661,748,"Thierry Baudet (FvD)",0.577725143567894,0.0799059929494712,0
"<anonymized_userid>",23,43684,749,"Thierry Baudet (FvD)",0.578029481038452,0.0800128191432539,0
"<anonymized_userid>",23,43707,750,"Thierry Baudet (FvD)",0.578333818509011,0.0801196453370366,0
"<anonymized_userid>",23,43730,751,"Thierry Baudet (FvD)",0.57863815597957,0.0802264715308194,0
"<anonymized_userid>",23,43753,752,"Thierry Baudet (FvD)",0.578942493450128,0.0803332977246021,0
"<anonymized_userid>",23,43776,753,"Thierry Baudet (FvD)",0.579246830920687,0.0804401239183848,0
"<anonymized_userid>",23,43799,754,"Thierry Baudet (FvD)",0.579551168391246,0.0805469501121675,0
"<anonymized_userid>",23,43822,755,"Thierry Baudet (FvD)",0.579855505861804,0.0806537763059502,0
"<anonymized_userid>",23,43845,756,"Thierry Baudet (FvD)",0.580159843332363,0.0807606024997329,0
"<anonymized_userid>",23,43868,757,"Thierry Baudet (FvD)",0.580464180802922,0.0808674286935157,0
"<anonymized_userid>",23,43891,758,"Thierry Baudet (FvD)",0.58076851827348,0.0809742548872984,0
"<anonymized_userid>",23,43914,759,"Thierry Baudet (FvD)",0.581072855744039,0.0810810810810811,0
"<anonymized_userid>",23,43937,760,"Thierry Baudet (FvD)",0.581377193214598,0.0811879072748638,0
"<anonymized_userid>",23,43960,761,"Thierry Baudet (FvD)",0.581681530685156,0.0812947334686465,0
"<anonymized_userid>",23,43983,762,"Thierry Baudet (FvD)",0.581985868155715,0.0814015596624292,0
"<anonymized_userid>",23,44006,763,"Thierry Baudet (FvD)",0.582290205626274,0.0815083858562119,0
"<anonymized_userid>",23,44029,764,"Thierry Baudet (FvD)",0.582594543096832,0.0816152120499947,0
"<anonymized_userid>",23,44052,765,"Thierry Baudet (FvD)",0.582898880567391,0.0817220382437774,0
"<anonymized_userid>",23,44075,766,"Thierry Baudet (FvD)",0.58320321803795,0.0818288644375601,0
"<anonymized_userid>",23,44098,767,"Thierry Baudet (FvD)",0.583507555508508,0.0819356906313428,0
"<anonymized_userid>",23,44121,768,"Thierry Baudet (FvD)",0.583811892979067,0.0820425168251255,0
"<anonymized_userid>",23,44144,769,"Thierry Baudet (FvD)",0.584116230449626,0.0821493430189082,0
"<anonymized_userid>",23,44167,770,"Thierry Baudet (FvD)",0.584420567920184,0.082256169212691,0
"<anonymized_userid>",23,44190,771,"Thierry Baudet (FvD)",0.584724905390743,0.0823629954064737,0
"<anonymized_userid>",23,44213,772,"Thierry Baudet (FvD)",0.585029242861302,0.0824698216002564,0
"<anonymized_userid>",23,44236,773,"Thierry Baudet (FvD)",0.58533358033186,0.0825766477940391,0
"<anonymized_userid>",23,44259,774,"Thierry Baudet (FvD)",0.585637917802419,0.0826834739878218,0
"<anonymized_userid>",23,44282,775,"Thierry Baudet (FvD)",0.585942255272977,0.0827903001816045,0
"<anonymized_userid>",22,44304,776,"Thierry Baudet (FvD)",0.586233360679599,0.0828971263753873,0
"<anonymized_userid>",22,44326,777,"Thierry Baudet (FvD)",0.58652446608622,0.08300395256917,0
"<anonymized_userid>",22,44348,778,"Thierry Baudet (FvD)",0.586815571492841,0.0831107787629527,0
"<anonymized_userid>",22,44370,779,"Thierry Baudet (FvD)",0.587106676899463,0.0832176049567354,0
"<anonymized_userid>",22,44392,780,"Thierry Baudet (FvD)",0.587397782306084,0.0833244311505181,0
"<anonymized_userid>",22,44414,781,"Thierry Baudet (FvD)",0.587688887712705,0.0834312573443008,0
"<anonymized_userid>",22,44436,782,"Thierry Baudet (FvD)",0.587979993119327,0.0835380835380835,0
"<anonymized_userid>",22,44458,783,"Thierry Baudet (FvD)",0.588271098525948,0.0836449097318663,0
"<anonymized_userid>",22,44480,784,"Thierry Baudet (FvD)",0.588562203932569,0.083751735925649,0
"<anonymized_userid>",22,44502,785,"Thierry Baudet (FvD)",0.588853309339191,0.0838585621194317,0
"<anonymized_userid>",22,44524,786,"Thierry Baudet (FvD)",0.589144414745812,0.0839653883132144,0
"<anonymized_userid>",22,44546,787,"Thierry Baudet (FvD)",0.589435520152433,0.0840722145069971,0
"<anonymized_userid>",22,44568,788,"Thierry Baudet (FvD)",0.589726625559055,0.0841790407007798,0
"<anonymized_userid>",22,44590,789,"Thierry Baudet (FvD)",0.590017730965676,0.0842858668945625,0
"<anonymized_userid>",22,44612,790,"Thierry Baudet (FvD)",0.590308836372297,0.0843926930883453,0
"<anonymized_userid>",22,44634,791,"Thierry Baudet (FvD)",0.590599941778919,0.084499519282128,0
"<anonymized_userid>",22,44656,792,"Thierry Baudet (FvD)",0.59089104718554,0.0846063454759107,0
"<anonymized_userid>",22,44678,793,"Thierry Baudet (FvD)",0.591182152592161,0.0847131716696934,0
"<anonymized_userid>",22,44700,794,"Thierry Baudet (FvD)",0.591473257998783,0.0848199978634761,0
"<anonymized_userid>",22,44722,795,"Thierry Baudet (FvD)",0.591764363405404,0.0849268240572588,0
"<anonymized_userid>",22,44744,796,"Thierry Baudet (FvD)",0.592055468812025,0.0850336502510416,0
"<anonymized_userid>",22,44766,797,"Thierry Baudet (FvD)",0.592346574218647,0.0851404764448243,0
"<anonymized_userid>",22,44788,798,"Thierry Baudet (FvD)",0.592637679625268,0.085247302638607,0
"<anonymized_userid>",22,44810,799,"Thierry Baudet (FvD)",0.592928785031889,0.0853541288323897,0
"<anonymized_userid>",22,44832,800,"Thierry Baudet (FvD)",0.593219890438511,0.0854609550261724,0
"<anonymized_userid>",22,44854,801,"Thierry Baudet (FvD)",0.593510995845132,0.0855677812199551,0
"<anonymized_userid>",22,44876,802,"Thierry Baudet (FvD)",0.593802101251753,0.0856746074137378,0
"<anonymized_userid>",22,44898,803,"Thierry Baudet (FvD)",0.594093206658375,0.0857814336075206,0
"<anonymized_userid>",22,44920,804,"Thierry Baudet (FvD)",0.594384312064996,0.0858882598013033,0
"<anonymized_userid>",22,44942,805,"Thierry Baudet (FvD)",0.594675417471617,0.085995085995086,0
"<anonymized_userid>",22,44964,806,"Thierry Baudet (FvD)",0.594966522878239,0.0861019121888687,0
"<anonymized_userid>",22,44986,807,"Thierry Baudet (FvD)",0.59525762828486,0.0862087383826514,0
"<anonymized_userid>",22,45008,808,"Thierry Baudet (FvD)",0.595548733691481,0.0863155645764341,0
"<anonymized_userid>",22,45030,809,"Thierry Baudet (FvD)",0.595839839098103,0.0864223907702169,0
"<anonymized_userid>",21,45051,810,"Thierry Baudet (FvD)",0.596117712440786,0.0865292169639996,0
"<anonymized_userid>",21,45072,811,"Thierry Baudet (FvD)",0.596395585783471,0.0866360431577823,0
"<anonymized_userid>",21,45093,812,"Thierry Baudet (FvD)",0.596673459126155,0.086742869351565,0
"<anonymized_userid>",21,45114,813,"Thierry Baudet (FvD)",0.596951332468838,0.0868496955453477,0
"<anonymized_userid>",21,45135,814,"Thierry Baudet (FvD)",0.597229205811523,0.0869565217391304,0
"<anonymized_userid>",21,45156,815,"Thierry Baudet (FvD)",0.597507079154206,0.0870633479329131,0
"<anonymized_userid>",21,45177,816,"Thierry Baudet (FvD)",0.59778495249689,0.0871701741266959,0
"<anonymized_userid>",21,45198,817,"Thierry Baudet (FvD)",0.598062825839574,0.0872770003204786,0
"<anonymized_userid>",21,45219,818,"Thierry Baudet (FvD)",0.598340699182258,0.0873838265142613,0
"<anonymized_userid>",21,45240,819,"Thierry Baudet (FvD)",0.598618572524942,0.087490652708044,0
"<anonymized_userid>",21,45261,820,"Thierry Baudet (FvD)",0.598896445867626,0.0875974789018267,0
"<anonymized_userid>",21,45282,821,"Thierry Baudet (FvD)",0.59917431921031,0.0877043050956094,0
"<anonymized_userid>",21,45303,822,"Thierry Baudet (FvD)",0.599452192552994,0.0878111312893922,0
"<anonymized_userid>",21,45324,823,"Thierry Baudet (FvD)",0.599730065895678,0.0879179574831749,0
"<anonymized_userid>",21,45345,824,"Thierry Baudet (FvD)",0.600007939238362,0.0880247836769576,0
"<anonymized_userid>",21,45366,825,"Thierry Baudet (FvD)",0.600285812581046,0.0881316098707403,0
"<anonymized_userid>",21,45387,826,"Thierry Baudet (FvD)",0.60056368592373,0.088238436064523,0
"<anonymized_userid>",21,45408,827,"Thierry Baudet (FvD)",0.600841559266414,0.0883452622583057,0
"<anonymized_userid>",21,45429,828,"Thierry Baudet (FvD)",0.601119432609098,0.0884520884520884,0
"<anonymized_userid>",21,45450,829,"Thierry Baudet (FvD)",0.601397305951782,0.0885589146458712,0
"<anonymized_userid>",21,45471,830,"Thierry Baudet (FvD)",0.601675179294466,0.0886657408396539,0
"<anonymized_userid>",21,45492,831,"Thierry Baudet (FvD)",0.60195305263715,0.0887725670334366,0
"<anonymized_userid>",21,45513,832,"Thierry Baudet (FvD)",0.602230925979834,0.0888793932272193,0
"<anonymized_userid>",21,45534,833,"Thierry Baudet (FvD)",0.602508799322518,0.088986219421002,0
"<anonymized_userid>",21,45555,834,"Thierry Baudet (FvD)",0.602786672665202,0.0890930456147847,0
"<anonymized_userid>",21,45576,835,"Thierry Baudet (FvD)",0.603064546007886,0.0891998718085675,0
"<anonymized_userid>",21,45597,836,"Thierry Baudet (FvD)",0.60334241935057,0.0893066980023502,0
"<anonymized_userid>",21,45618,837,"Thierry Baudet (FvD)",0.603620292693254,0.0894135241961329,0
"<anonymized_userid>",21,45639,838,"Thierry Baudet (FvD)",0.603898166035938,0.0895203503899156,0
"<anonymized_userid>",21,45660,839,"Thierry Baudet (FvD)",0.604176039378622,0.0896271765836983,0
"<anonymized_userid>",21,45681,840,"Thierry Baudet (FvD)",0.604453912721306,0.089734002777481,0
"<anonymized_userid>",21,45702,841,"Thierry Baudet (FvD)",0.60473178606399,0.0898408289712637,0
"<anonymized_userid>",21,45723,842,"Thierry Baudet (FvD)",0.605009659406674,0.0899476551650465,0
"<anonymized_userid>",21,45744,843,"Thierry Baudet (FvD)",0.605287532749358,0.0900544813588292,0
"<anonymized_userid>",20,45764,844,"Thierry Baudet (FvD)",0.605552174028105,0.0901613075526119,0
"<anonymized_userid>",20,45784,845,"Thierry Baudet (FvD)",0.605816815306852,0.0902681337463946,0
"<anonymized_userid>",20,45804,846,"Thierry Baudet (FvD)",0.606081456585598,0.0903749599401773,0
"<anonymized_userid>",20,45824,847,"Thierry Baudet (FvD)",0.606346097864345,0.09048178613396,0
"<anonymized_userid>",20,45844,848,"Thierry Baudet (FvD)",0.606610739143091,0.0905886123277428,0
"<anonymized_userid>",20,45864,849,"Thierry Baudet (FvD)",0.606875380421838,0.0906954385215255,0
"<anonymized_userid>",20,45884,850,"Thierry Baudet (FvD)",0.607140021700585,0.0908022647153082,0
"<anonymized_userid>",20,45904,851,"Thierry Baudet (FvD)",0.607404662979331,0.0909090909090909,0
"<anonymized_userid>",20,45924,852,"Thierry Baudet (FvD)",0.607669304258078,0.0910159171028736,0
"<anonymized_userid>",20,45944,853,"Thierry Baudet (FvD)",0.607933945536825,0.0911227432966563,0
"<anonymized_userid>",20,45964,854,"Thierry Baudet (FvD)",0.608198586815571,0.0912295694904391,0
"<anonymized_userid>",20,45984,855,"Thierry Baudet (FvD)",0.608463228094318,0.0913363956842218,0
"<anonymized_userid>",20,46004,856,"Thierry Baudet (FvD)",0.608727869373065,0.0914432218780045,0
"<anonymized_userid>",20,46024,857,"Thierry Baudet (FvD)",0.608992510651811,0.0915500480717872,0
"<anonymized_userid>",20,46044,858,"Thierry Baudet (FvD)",0.609257151930558,0.0916568742655699,0
"<anonymized_userid>",20,46064,859,"Thierry Baudet (FvD)",0.609521793209305,0.0917637004593526,0
"<anonymized_userid>",20,46084,860,"Thierry Baudet (FvD)",0.609786434488051,0.0918705266531353,0
"<anonymized_userid>",20,46104,861,"Thierry Baudet (FvD)",0.610051075766798,0.0919773528469181,0
"<anonymized_userid>",20,46124,862,"Thierry Baudet (FvD)",0.610315717045545,0.0920841790407008,0
"<anonymized_userid>",20,46144,863,"Thierry Baudet (FvD)",0.610580358324291,0.0921910052344835,0
"<anonymized_userid>",20,46164,864,"Thierry Baudet (FvD)",0.610844999603038,0.0922978314282662,0
"<anonymized_userid>",20,46184,865,"Thierry Baudet (FvD)",0.611109640881785,0.0924046576220489,0
"<anonymized_userid>",20,46204,866,"Thierry Baudet (FvD)",0.611374282160531,0.0925114838158316,0
"<anonymized_userid>",20,46224,867,"Thierry Baudet (FvD)",0.611638923439278,0.0926183100096144,0
"<anonymized_userid>",20,46244,868,"Thierry Baudet (FvD)",0.611903564718025,0.0927251362033971,0
"<anonymized_userid>",20,46264,869,"Thierry Baudet (FvD)",0.612168205996771,0.0928319623971798,0
"<anonymized_userid>",20,46284,870,"Thierry Baudet (FvD)",0.612432847275518,0.0929387885909625,0
"<anonymized_userid>",20,46304,871,"Thierry Baudet (FvD)",0.612697488554265,0.0930456147847452,0
"<anonymized_userid>",20,46324,872,"Thierry Baudet (FvD)",0.612962129833011,0.0931524409785279,0
"<anonymized_userid>",20,46344,873,"Thierry Baudet (FvD)",0.613226771111758,0.0932592671723106,0
"<anonymized_userid>",20,46364,874,"Thierry Baudet (FvD)",0.613491412390505,0.0933660933660934,0
"<anonymized_userid>",20,46384,875,"Thierry Baudet (FvD)",0.613756053669251,0.0934729195598761,0
"<anonymized_userid>",20,46404,876,"Thierry Baudet (FvD)",0.614020694947998,0.0935797457536588,0
"<anonymized_userid>",20,46424,877,"Thierry Baudet (FvD)",0.614285336226745,0.0936865719474415,0
"<anonymized_userid>",20,46444,878,"Thierry Baudet (FvD)",0.614549977505491,0.0937933981412242,0
"<anonymized_userid>",20,46464,879,"Thierry Baudet (FvD)",0.614814618784238,0.0939002243350069,0
"<anonymized_userid>",20,46484,880,"Thierry Baudet (FvD)",0.615079260062985,0.0940070505287897,0
"<anonymized_userid>",19,46503,881,"Thierry Baudet (FvD)",0.615330669277794,0.0941138767225724,0
"<anonymized_userid>",19,46522,882,"Thierry Baudet (FvD)",0.615582078492603,0.0942207029163551,0
"<anonymized_userid>",19,46541,883,"Thierry Baudet (FvD)",0.615833487707413,0.0943275291101378,0
"<anonymized_userid>",19,46560,884,"Thierry Baudet (FvD)",0.616084896922222,0.0944343553039205,0
"<anonymized_userid>",19,46579,885,"Thierry Baudet (FvD)",0.616336306137031,0.0945411814977032,0
"<anonymized_userid>",19,46598,886,"Thierry Baudet (FvD)",0.616587715351841,0.094648007691486,0
"<anonymized_userid>",19,46617,887,"Thierry Baudet (FvD)",0.61683912456665,0.0947548338852687,0
"<anonymized_userid>",19,46636,888,"Thierry Baudet (FvD)",0.617090533781459,0.0948616600790514,0
"<anonymized_userid>",19,46655,889,"Thierry Baudet (FvD)",0.617341942996269,0.0949684862728341,0
"<anonymized_userid>",19,46674,890,"Thierry Baudet (FvD)",0.617593352211078,0.0950753124666168,0
"<anonymized_userid>",19,46693,891,"Thierry Baudet (FvD)",0.617844761425887,0.0951821386603995,0
"<anonymized_userid>",19,46712,892,"Thierry Baudet (FvD)",0.618096170640697,0.0952889648541822,0
"<anonymized_userid>",19,46731,893,"Thierry Baudet (FvD)",0.618347579855506,0.095395791047965,0
"<anonymized_userid>",19,46750,894,"Thierry Baudet (FvD)",0.618598989070315,0.0955026172417477,0
"<anonymized_userid>",19,46769,895,"Thierry Baudet (FvD)",0.618850398285125,0.0956094434355304,0
"<anonymized_userid>",19,46788,896,"Thierry Baudet (FvD)",0.619101807499934,0.0957162696293131,0
"<anonymized_userid>",19,46807,897,"Thierry Baudet (FvD)",0.619353216714743,0.0958230958230958,0
"<anonymized_userid>",19,46826,898,"Thierry Baudet (FvD)",0.619604625929552,0.0959299220168785,0
"<anonymized_userid>",19,46845,899,"Thierry Baudet (FvD)",0.619856035144362,0.0960367482106613,0
"<anonymized_userid>",19,46864,900,"Thierry Baudet (FvD)",0.620107444359171,0.096143574404444,0
"<anonymized_userid>",19,46883,901,"Thierry Baudet (FvD)",0.62035885357398,0.0962504005982267,0
"<anonymized_userid>",19,46902,902,"Thierry Baudet (FvD)",0.62061026278879,0.0963572267920094,0
"<anonymized_userid>",19,46921,903,"Thierry Baudet (FvD)",0.620861672003599,0.0964640529857921,0
"<anonymized_userid>",19,46940,904,"Thierry Baudet (FvD)",0.621113081218408,0.0965708791795748,0
"<anonymized_userid>",19,46959,905,"Thierry Baudet (FvD)",0.621364490433218,0.0966777053733575,0
"<anonymized_userid>",19,46978,906,"Thierry Baudet (FvD)",0.621615899648027,0.0967845315671403,0
"<anonymized_userid>",19,46997,907,"Thierry Baudet (FvD)",0.621867308862836,0.096891357760923,0
"<anonymized_userid>",19,47016,908,"Thierry Baudet (FvD)",0.622118718077646,0.0969981839547057,0
"<anonymized_userid>",19,47035,909,"Thierry Baudet (FvD)",0.622370127292455,0.0971050101484884,0
"<anonymized_userid>",19,47054,910,"Thierry Baudet (FvD)",0.622621536507264,0.0972118363422711,0
"<anonymized_userid>",19,47073,911,"Thierry Baudet (FvD)",0.622872945722074,0.0973186625360538,0
"<anonymized_userid>",19,47092,912,"Thierry Baudet (FvD)",0.623124354936883,0.0974254887298366,0
"<anonymized_userid>",19,47111,913,"Thierry Baudet (FvD)",0.623375764151692,0.0975323149236193,0
"<anonymized_userid>",19,47130,914,"Thierry Baudet (FvD)",0.623627173366502,0.097639141117402,0
"<anonymized_userid>",19,47149,915,"Thierry Baudet (FvD)",0.623878582581311,0.0977459673111847,0
"<anonymized_userid>",19,47168,916,"Thierry Baudet (FvD)",0.62412999179612,0.0978527935049674,0
"<anonymized_userid>",19,47187,917,"Thierry Baudet (FvD)",0.62438140101093,0.0979596196987501,0
"<anonymized_userid>",19,47206,918,"Thierry Baudet (FvD)",0.624632810225739,0.0980664458925329,0
"<anonymized_userid>",19,47225,919,"Thierry Baudet (FvD)",0.624884219440548,0.0981732720863156,0
"<anonymized_userid>",19,47244,920,"Thierry Baudet (FvD)",0.625135628655358,0.0982800982800983,0
"<anonymized_userid>",19,47263,921,"Thierry Baudet (FvD)",0.625387037870167,0.098386924473881,0
"<anonymized_userid>",19,47282,922,"Thierry Baudet (FvD)",0.625638447084976,0.0984937506676637,0
"<anonymized_userid>",18,47300,923,"Thierry Baudet (FvD)",0.625876624235848,0.0986005768614464,0
"<anonymized_userid>",18,47318,924,"Thierry Baudet (FvD)",0.62611480138672,0.0987074030552291,0
"<anonymized_userid>",18,47336,925,"Thierry Baudet (FvD)",0.626352978537592,0.0988142292490119,0
"<anonymized_userid>",18,47354,926,"Thierry Baudet (FvD)",0.626591155688464,0.0989210554427946,0
"<anonymized_userid>",18,47372,927,"Thierry Baudet (FvD)",0.626829332839336,0.0990278816365773,0
"<anonymized_userid>",18,47390,928,"Thierry Baudet (FvD)",0.627067509990208,0.09913470783036,0
"<anonymized_userid>",18,47408,929,"Thierry Baudet (FvD)",0.62730568714108,0.0992415340241427,0
"<anonymized_userid>",18,47426,930,"Thierry Baudet (FvD)",0.627543864291952,0.0993483602179254,0
"<anonymized_userid>",18,47444,931,"Thierry Baudet (FvD)",0.627782041442824,0.0994551864117082,0
"<anonymized_userid>",18,47462,932,"Thierry Baudet (FvD)",0.628020218593696,0.0995620126054909,0
"<anonymized_userid>",18,47480,933,"Thierry Baudet (FvD)",0.628258395744568,0.0996688387992736,0
"<anonymized_userid>",18,47498,934,"Thierry Baudet (FvD)",0.62849657289544,0.0997756649930563,0
"<anonymized_userid>",18,47516,935,"Thierry Baudet (FvD)",0.628734750046312,0.099882491186839,0
"<anonymized_userid>",18,47534,936,"Thierry Baudet (FvD)",0.628972927197184,0.0999893173806217,0
"<anonymized_userid>",18,47552,937,"Thierry Baudet (FvD)",0.629211104348056,0.100096143574404,0
"<anonymized_userid>",18,47570,938,"Thierry Baudet (FvD)",0.629449281498928,0.100202969768187,0
"<anonymized_userid>",18,47588,939,"Thierry Baudet (FvD)",0.6296874586498,0.10030979596197,0
"<anonymized_userid>",18,47606,940,"Thierry Baudet (FvD)",0.629925635800672,0.100416622155753,0
"<anonymized_userid>",18,47624,941,"Thierry Baudet (FvD)",0.630163812951544,0.100523448349535,0
"<anonymized_userid>",18,47642,942,"Thierry Baudet (FvD)",0.630401990102416,0.100630274543318,0
"<anonymized_userid>",18,47660,943,"Thierry Baudet (FvD)",0.630640167253288,0.100737100737101,0
"<anonymized_userid>",18,47678,944,"Thierry Baudet (FvD)",0.63087834440416,0.100843926930883,0
"<anonymized_userid>",18,47696,945,"Thierry Baudet (FvD)",0.631116521555032,0.100950753124666,0
"<anonymized_userid>",18,47714,946,"Thierry Baudet (FvD)",0.631354698705904,0.101057579318449,0
"<anonymized_userid>",18,47732,947,"Thierry Baudet (FvD)",0.631592875856776,0.101164405512232,0
"<anonymized_userid>",18,47750,948,"Thierry Baudet (FvD)",0.631831053007648,0.101271231706014,0
"<anonymized_userid>",18,47768,949,"Thierry Baudet (FvD)",0.63206923015852,0.101378057899797,0
"<anonymized_userid>",18,47786,950,"Thierry Baudet (FvD)",0.632307407309392,0.10148488409358,0
"<anonymized_userid>",18,47804,951,"Thierry Baudet (FvD)",0.632545584460264,0.101591710287362,0
"<anonymized_userid>",18,47822,952,"Thierry Baudet (FvD)",0.632783761611136,0.101698536481145,0
"<anonymized_userid>",18,47840,953,"Thierry Baudet (FvD)",0.633021938762008,0.101805362674928,0
"<anonymized_userid>",18,47858,954,"Thierry Baudet (FvD)",0.63326011591288,0.101912188868711,0
"<anonymized_userid>",18,47876,955,"Thierry Baudet (FvD)",0.633498293063752,0.102019015062493,0
"<anonymized_userid>",18,47894,956,"Thierry Baudet (FvD)",0.633736470214624,0.102125841256276,0
"<anonymized_userid>",18,47912,957,"Thierry Baudet (FvD)",0.633974647365496,0.102232667450059,0
"<anonymized_userid>",18,47930,958,"Thierry Baudet (FvD)",0.634212824516368,0.102339493643841,0
"<anonymized_userid>",18,47948,959,"Thierry Baudet (FvD)",0.63445100166724,0.102446319837624,0
"<anonymized_userid>",18,47966,960,"Thierry Baudet (FvD)",0.634689178818112,0.102553146031407,0
"<anonymized_userid>",18,47984,961,"Thierry Baudet (FvD)",0.634927355968984,0.10265997222519,0
"<anonymized_userid>",18,48002,962,"Thierry Baudet (FvD)",0.635165533119856,0.102766798418972,0
"<anonymized_userid>",18,48020,963,"Thierry Baudet (FvD)",0.635403710270728,0.102873624612755,0
"<anonymized_userid>",18,48038,964,"Thierry Baudet (FvD)",0.6356418874216,0.102980450806538,0
"<anonymized_userid>",18,48056,965,"Thierry Baudet (FvD)",0.635880064572472,0.10308727700032,0
"<anonymized_userid>",18,48074,966,"Thierry Baudet (FvD)",0.636118241723344,0.103194103194103,0
"<anonymized_userid>",17,48091,967,"Thierry Baudet (FvD)",0.636343186810279,0.103300929387886,0
"<anonymized_userid>",17,48108,968,"Thierry Baudet (FvD)",0.636568131897213,0.103407755581669,0
"<anonymized_userid>",17,48125,969,"Thierry Baudet (FvD)",0.636793076984148,0.103514581775451,0
"<anonymized_userid>",17,48142,970,"Thierry Baudet (FvD)",0.637018022071083,0.103621407969234,0
"<anonymized_userid>",17,48159,971,"Thierry Baudet (FvD)",0.637242967158017,0.103728234163017,0
"<anonymized_userid>",17,48176,972,"Thierry Baudet (FvD)",0.637467912244952,0.103835060356799,0
"<anonymized_userid>",17,48193,973,"Thierry Baudet (FvD)",0.637692857331887,0.103941886550582,0
"<anonymized_userid>",17,48210,974,"Thierry Baudet (FvD)",0.637917802418821,0.104048712744365,0
"<anonymized_userid>",17,48227,975,"Thierry Baudet (FvD)",0.638142747505756,0.104155538938148,0
"<anonymized_userid>",17,48244,976,"Thierry Baudet (FvD)",0.638367692592691,0.10426236513193,0
"<anonymized_userid>",17,48261,977,"Thierry Baudet (FvD)",0.638592637679625,0.104369191325713,0
"<anonymized_userid>",17,48278,978,"Thierry Baudet (FvD)",0.63881758276656,0.104476017519496,0
"<anonymized_userid>",17,48295,979,"Thierry Baudet (FvD)",0.639042527853495,0.104582843713279,0
"<anonymized_userid>",17,48312,980,"Thierry Baudet (FvD)",0.639267472940429,0.104689669907061,0
"<anonymized_userid>",17,48329,981,"Thierry Baudet (FvD)",0.639492418027364,0.104796496100844,0
"<anonymized_userid>",17,48346,982,"Thierry Baudet (FvD)",0.639717363114299,0.104903322294627,0
"<anonymized_userid>",17,48363,983,"Thierry Baudet (FvD)",0.639942308201233,0.105010148488409,0
"<anonymized_userid>",17,48380,984,"Thierry Baudet (FvD)",0.640167253288168,0.105116974682192,0
"<anonymized_userid>",17,48397,985,"Thierry Baudet (FvD)",0.640392198375103,0.105223800875975,0
"<anonymized_userid>",17,48414,986,"Thierry Baudet (FvD)",0.640617143462037,0.105330627069758,0
"<anonymized_userid>",17,48431,987,"Thierry Baudet (FvD)",0.640842088548972,0.10543745326354,0
"<anonymized_userid>",17,48448,988,"Thierry Baudet (FvD)",0.641067033635907,0.105544279457323,0
"<anonymized_userid>",17,48465,989,"Thierry Baudet (FvD)",0.641291978722841,0.105651105651106,0
"<anonymized_userid>",17,48482,990,"Thierry Baudet (FvD)",0.641516923809776,0.105757931844888,0
"<anonymized_userid>",17,48499,991,"Thierry Baudet (FvD)",0.64174186889671,0.105864758038671,0
"<anonymized_userid>",17,48516,992,"Thierry Baudet (FvD)",0.641966813983645,0.105971584232454,0
"<anonymized_userid>",17,48533,993,"Thierry Baudet (FvD)",0.64219175907058,0.106078410426237,0
"<anonymized_userid>",17,48550,994,"Thierry Baudet (FvD)",0.642416704157515,0.106185236620019,0
"<anonymized_userid>",17,48567,995,"Thierry Baudet (FvD)",0.642641649244449,0.106292062813802,0
"<anonymized_userid>",17,48584,996,"Thierry Baudet (FvD)",0.642866594331384,0.106398889007585,0
"<anonymized_userid>",17,48601,997,"Thierry Baudet (FvD)",0.643091539418318,0.106505715201367,0
"<anonymized_userid>",17,48618,998,"Thierry Baudet (FvD)",0.643316484505253,0.10661254139515,0
"<anonymized_userid>",17,48635,999,"Thierry Baudet (FvD)",0.643541429592188,0.106719367588933,0
"<anonymized_userid>",17,48652,1000,"Thierry Baudet (FvD)",0.643766374679122,0.106826193782716,0
"<anonymized_userid>",17,48669,1001,"Thierry Baudet (FvD)",0.643991319766057,0.106933019976498,0
"<anonymized_userid>",17,48686,1002,"Thierry Baudet (FvD)",0.644216264852992,0.107039846170281,0
"<anonymized_userid>",17,48703,1003,"Thierry Baudet (FvD)",0.644441209939926,0.107146672364064,0
"<anonymized_userid>",17,48720,1004,"Thierry Baudet (FvD)",0.644666155026861,0.107253498557846,0
"<anonymized_userid>",17,48737,1005,"Thierry Baudet (FvD)",0.644891100113796,0.107360324751629,0
"<anonymized_userid>",17,48754,1006,"Thierry Baudet (FvD)",0.64511604520073,0.107467150945412,0
"<anonymized_userid>",17,48771,1007,"Thierry Baudet (FvD)",0.645340990287665,0.107573977139195,0
"<anonymized_userid>",17,48788,1008,"Thierry Baudet (FvD)",0.6455659353746,0.107680803332977,0
"<anonymized_userid>",17,48805,1009,"Thierry Baudet (FvD)",0.645790880461534,0.10778762952676,0
"<anonymized_userid>",17,48822,1010,"Thierry Baudet (FvD)",0.646015825548469,0.107894455720543,0
"<anonymized_userid>",17,48839,1011,"Thierry Baudet (FvD)",0.646240770635404,0.108001281914325,0
"<anonymized_userid>",17,48856,1012,"Thierry Baudet (FvD)",0.646465715722338,0.108108108108108,0
"<anonymized_userid>",17,48873,1013,"Thierry Baudet (FvD)",0.646690660809273,0.108214934301891,0
"<anonymized_userid>",17,48890,1014,"Thierry Baudet (FvD)",0.646915605896208,0.108321760495674,0
"<anonymized_userid>",17,48907,1015,"Thierry Baudet (FvD)",0.647140550983142,0.108428586689456,0
"<anonymized_userid>",17,48924,1016,"Thierry Baudet (FvD)",0.647365496070077,0.108535412883239,0
"<anonymized_userid>",17,48941,1017,"Thierry Baudet (FvD)",0.647590441157012,0.108642239077022,0
"<anonymized_userid>",17,48958,1018,"Thierry Baudet (FvD)",0.647815386243946,0.108749065270804,0
"<anonymized_userid>",17,48975,1019,"Thierry Baudet (FvD)",0.648040331330881,0.108855891464587,0
"<anonymized_userid>",17,48992,1020,"Thierry Baudet (FvD)",0.648265276417816,0.10896271765837,0
"<anonymized_userid>",17,49009,1021,"Thierry Baudet (FvD)",0.64849022150475,0.109069543852153,0
"<anonymized_userid>",17,49026,1022,"Thierry Baudet (FvD)",0.648715166591685,0.109176370045935,0
"<anonymized_userid>",17,49043,1023,"Thierry Baudet (FvD)",0.64894011167862,0.109283196239718,0
"<anonymized_userid>",17,49060,1024,"Thierry Baudet (FvD)",0.649165056765554,0.109390022433501,0
"<anonymized_userid>",17,49077,1025,"Thierry Baudet (FvD)",0.649390001852489,0.109496848627283,0
"<anonymized_userid>",17,49094,1026,"Thierry Baudet (FvD)",0.649614946939424,0.109603674821066,0
"<anonymized_userid>",17,49111,1027,"Thierry Baudet (FvD)",0.649839892026358,0.109710501014849,0
"<anonymized_userid>",17,49128,1028,"Thierry Baudet (FvD)",0.650064837113293,0.109817327208632,0
"<anonymized_userid>",17,49145,1029,"Thierry Baudet (FvD)",0.650289782200228,0.109924153402414,0
"<anonymized_userid>",16,49161,1030,"Thierry Baudet (FvD)",0.650501495223225,0.110030979596197,0
"<anonymized_userid>",16,49177,1031,"Thierry Baudet (FvD)",0.650713208246222,0.11013780578998,0
"<anonymized_userid>",16,49193,1032,"Thierry Baudet (FvD)",0.65092492126922,0.110244631983762,0
"<anonymized_userid>",16,49209,1033,"Thierry Baudet (FvD)",0.651136634292217,0.110351458177545,0
"<anonymized_userid>",16,49225,1034,"Thierry Baudet (FvD)",0.651348347315214,0.110458284371328,0
"<anonymized_userid>",16,49241,1035,"Thierry Baudet (FvD)",0.651560060338212,0.110565110565111,0
"<anonymized_userid>",16,49257,1036,"Thierry Baudet (FvD)",0.651771773361209,0.110671936758893,0
"<anonymized_userid>",16,49273,1037,"Thierry Baudet (FvD)",0.651983486384206,0.110778762952676,0
"<anonymized_userid>",16,49289,1038,"Thierry Baudet (FvD)",0.652195199407203,0.110885589146459,0
"<anonymized_userid>",16,49305,1039,"Thierry Baudet (FvD)",0.652406912430201,0.110992415340241,0
"<anonymized_userid>",16,49321,1040,"Thierry Baudet (FvD)",0.652618625453198,0.111099241534024,0
"<anonymized_userid>",16,49337,1041,"Thierry Baudet (FvD)",0.652830338476196,0.111206067727807,0
"<anonymized_userid>",16,49353,1042,"Thierry Baudet (FvD)",0.653042051499193,0.11131289392159,0
"<anonymized_userid>",16,49369,1043,"Thierry Baudet (FvD)",0.65325376452219,0.111419720115372,0
"<anonymized_userid>",16,49385,1044,"Thierry Baudet (FvD)",0.653465477545187,0.111526546309155,0
"<anonymized_userid>",16,49401,1045,"Thierry Baudet (FvD)",0.653677190568185,0.111633372502938,0
"<anonymized_userid>",16,49417,1046,"Thierry Baudet (FvD)",0.653888903591182,0.11174019869672,0
"<anonymized_userid>",16,49433,1047,"Thierry Baudet (FvD)",0.65410061661418,0.111847024890503,0
"<anonymized_userid>",16,49449,1048,"Thierry Baudet (FvD)",0.654312329637177,0.111953851084286,0
"<anonymized_userid>",16,49465,1049,"Thierry Baudet (FvD)",0.654524042660174,0.112060677278069,0
"<anonymized_userid>",16,49481,1050,"Thierry Baudet (FvD)",0.654735755683171,0.112167503471851,0
"<anonymized_userid>",16,49497,1051,"Thierry Baudet (FvD)",0.654947468706169,0.112274329665634,0
"<anonymized_userid>",16,49513,1052,"Thierry Baudet (FvD)",0.655159181729166,0.112381155859417,0
"<anonymized_userid>",16,49529,1053,"Thierry Baudet (FvD)",0.655370894752163,0.112487982053199,0
"<anonymized_userid>",16,49545,1054,"Thierry Baudet (FvD)",0.655582607775161,0.112594808246982,0
"<anonymized_userid>",16,49561,1055,"Thierry Baudet (FvD)",0.655794320798158,0.112701634440765,0
"<anonymized_userid>",16,49577,1056,"Thierry Baudet (FvD)",0.656006033821155,0.112808460634548,0
"<anonymized_userid>",16,49593,1057,"Thierry Baudet (FvD)",0.656217746844153,0.11291528682833,0
"<anonymized_userid>",16,49609,1058,"Thierry Baudet (FvD)",0.65642945986715,0.113022113022113,0
"<anonymized_userid>",16,49625,1059,"Thierry Baudet (FvD)",0.656641172890147,0.113128939215896,0
"<anonymized_userid>",16,49641,1060,"Thierry Baudet (FvD)",0.656852885913145,0.113235765409678,0
"<anonymized_userid>",16,49657,1061,"Thierry Baudet (FvD)",0.657064598936142,0.113342591603461,0
"<anonymized_userid>",16,49673,1062,"Thierry Baudet (FvD)",0.657276311959139,0.113449417797244,0
"<anonymized_userid>",16,49689,1063,"Thierry Baudet (FvD)",0.657488024982137,0.113556243991027,0
"<anonymized_userid>",16,49705,1064,"Thierry Baudet (FvD)",0.657699738005134,0.113663070184809,0
"<anonymized_userid>",16,49721,1065,"Thierry Baudet (FvD)",0.657911451028131,0.113769896378592,0
"<anonymized_userid>",16,49737,1066,"Thierry Baudet (FvD)",0.658123164051129,0.113876722572375,0
"<anonymized_userid>",16,49753,1067,"Thierry Baudet (FvD)",0.658334877074126,0.113983548766157,0
"<anonymized_userid>",16,49769,1068,"Thierry Baudet (FvD)",0.658546590097123,0.11409037495994,0
"<anonymized_userid>",16,49785,1069,"Thierry Baudet (FvD)",0.658758303120121,0.114197201153723,0
"<anonymized_userid>",16,49801,1070,"Thierry Baudet (FvD)",0.658970016143118,0.114304027347506,0
"<anonymized_userid>",16,49817,1071,"Thierry Baudet (FvD)",0.659181729166115,0.114410853541288,0
"<anonymized_userid>",16,49833,1072,"Thierry Baudet (FvD)",0.659393442189113,0.114517679735071,0
"<anonymized_userid>",16,49849,1073,"Thierry Baudet (FvD)",0.65960515521211,0.114624505928854,0
"<anonymized_userid>",16,49865,1074,"Thierry Baudet (FvD)",0.659816868235107,0.114731332122636,0
"<anonymized_userid>",16,49881,1075,"Thierry Baudet (FvD)",0.660028581258105,0.114838158316419,0
"<anonymized_userid>",16,49897,1076,"Thierry Baudet (FvD)",0.660240294281102,0.114944984510202,0
"<anonymized_userid>",16,49913,1077,"Thierry Baudet (FvD)",0.660452007304099,0.115051810703985,0
"<anonymized_userid>",16,49929,1078,"Thierry Baudet (FvD)",0.660663720327097,0.115158636897767,0
"<anonymized_userid>",16,49945,1079,"Thierry Baudet (FvD)",0.660875433350094,0.11526546309155,0
"<anonymized_userid>",16,49961,1080,"Thierry Baudet (FvD)",0.661087146373091,0.115372289285333,0
"<anonymized_userid>",16,49977,1081,"Thierry Baudet (FvD)",0.661298859396089,0.115479115479115,0
"<anonymized_userid>",16,49993,1082,"Thierry Baudet (FvD)",0.661510572419086,0.115585941672898,0
"<anonymized_userid>",16,50009,1083,"Thierry Baudet (FvD)",0.661722285442083,0.115692767866681,0
"<anonymized_userid>",16,50025,1084,"Thierry Baudet (FvD)",0.661933998465081,0.115799594060464,0
"<anonymized_userid>",16,50041,1085,"Thierry Baudet (FvD)",0.662145711488078,0.115906420254246,0
"<anonymized_userid>",16,50057,1086,"Thierry Baudet (FvD)",0.662357424511075,0.116013246448029,0
"<anonymized_userid>",16,50073,1087,"Thierry Baudet (FvD)",0.662569137534073,0.116120072641812,0
"<anonymized_userid>",15,50088,1088,"Thierry Baudet (FvD)",0.662767618493133,0.116226898835594,0
"<anonymized_userid>",15,50103,1089,"Thierry Baudet (FvD)",0.662966099452193,0.116333725029377,0
"<anonymized_userid>",15,50118,1090,"Thierry Baudet (FvD)",0.663164580411253,0.11644055122316,0
"<anonymized_userid>",15,50133,1091,"Thierry Baudet (FvD)",0.663363061370313,0.116547377416943,0
"<anonymized_userid>",15,50148,1092,"Thierry Baudet (FvD)",0.663561542329373,0.116654203610725,0
"<anonymized_userid>",15,50163,1093,"Thierry Baudet (FvD)",0.663760023288433,0.116761029804508,0
"<anonymized_userid>",15,50178,1094,"Thierry Baudet (FvD)",0.663958504247492,0.116867855998291,0
"<anonymized_userid>",15,50193,1095,"Thierry Baudet (FvD)",0.664156985206553,0.116974682192073,0
"<anonymized_userid>",15,50208,1096,"Thierry Baudet (FvD)",0.664355466165612,0.117081508385856,0
"<anonymized_userid>",15,50223,1097,"Thierry Baudet (FvD)",0.664553947124673,0.117188334579639,0
"<anonymized_userid>",15,50238,1098,"Thierry Baudet (FvD)",0.664752428083732,0.117295160773422,0
"<anonymized_userid>",15,50253,1099,"Thierry Baudet (FvD)",0.664950909042793,0.117401986967204,0
"<anonymized_userid>",15,50268,1100,"Thierry Baudet (FvD)",0.665149390001852,0.117508813160987,0
"<anonymized_userid>",15,50283,1101,"Thierry Baudet (FvD)",0.665347870960913,0.11761563935477,0
"<anonymized_userid>",15,50298,1102,"Thierry Baudet (FvD)",0.665546351919972,0.117722465548553,0
"<anonymized_userid>",15,50313,1103,"Thierry Baudet (FvD)",0.665744832879033,0.117829291742335,0
"<anonymized_userid>",15,50328,1104,"Thierry Baudet (FvD)",0.665943313838092,0.117936117936118,0
"<anonymized_userid>",15,50343,1105,"Thierry Baudet (FvD)",0.666141794797152,0.118042944129901,0
"<anonymized_userid>",15,50358,1106,"Thierry Baudet (FvD)",0.666340275756212,0.118149770323683,0
"<anonymized_userid>",15,50373,1107,"Thierry Baudet (FvD)",0.666538756715272,0.118256596517466,0
"<anonymized_userid>",15,50388,1108,"Thierry Baudet (FvD)",0.666737237674332,0.118363422711249,0
"<anonymized_userid>",15,50403,1109,"Thierry Baudet (FvD)",0.666935718633392,0.118470248905032,0
"<anonymized_userid>",15,50418,1110,"Thierry Baudet (FvD)",0.667134199592452,0.118577075098814,0
"<anonymized_userid>",15,50433,1111,"Thierry Baudet (FvD)",0.667332680551512,0.118683901292597,0
"<anonymized_userid>",15,50448,1112,"Thierry Baudet (FvD)",0.667531161510572,0.11879072748638,0
"<anonymized_userid>",15,50463,1113,"Thierry Baudet (FvD)",0.667729642469632,0.118897553680162,0
"<anonymized_userid>",15,50478,1114,"Thierry Baudet (FvD)",0.667928123428692,0.119004379873945,0
"<anonymized_userid>",15,50493,1115,"Thierry Baudet (FvD)",0.668126604387752,0.119111206067728,0
"<anonymized_userid>",15,50508,1116,"Thierry Baudet (FvD)",0.668325085346812,0.119218032261511,0
"<anonymized_userid>",15,50523,1117,"Thierry Baudet (FvD)",0.668523566305872,0.119324858455293,0
"<anonymized_userid>",15,50538,1118,"Thierry Baudet (FvD)",0.668722047264932,0.119431684649076,0
"<anonymized_userid>",15,50553,1119,"Thierry Baudet (FvD)",0.668920528223992,0.119538510842859,0
"<anonymized_userid>",15,50568,1120,"Thierry Baudet (FvD)",0.669119009183052,0.119645337036641,0
"<anonymized_userid>",15,50583,1121,"Thierry Baudet (FvD)",0.669317490142112,0.119752163230424,0
"<anonymized_userid>",15,50598,1122,"Thierry Baudet (FvD)",0.669515971101172,0.119858989424207,0
"<anonymized_userid>",15,50613,1123,"Thierry Baudet (FvD)",0.669714452060232,0.11996581561799,0
"<anonymized_userid>",15,50628,1124,"Thierry Baudet (FvD)",0.669912933019292,0.120072641811772,0
"<anonymized_userid>",15,50643,1125,"Thierry Baudet (FvD)",0.670111413978352,0.120179468005555,0
"<anonymized_userid>",15,50658,1126,"Thierry Baudet (FvD)",0.670309894937412,0.120286294199338,0
"<anonymized_userid>",15,50673,1127,"Thierry Baudet (FvD)",0.670508375896472,0.12039312039312,0
"<anonymized_userid>",15,50688,1128,"Thierry Baudet (FvD)",0.670706856855532,0.120499946586903,0
"<anonymized_userid>",15,50703,1129,"Thierry Baudet (FvD)",0.670905337814592,0.120606772780686,0
"<anonymized_userid>",15,50718,1130,"Thierry Baudet (FvD)",0.671103818773652,0.120713598974469,0
"<anonymized_userid>",15,50733,1131,"Thierry Baudet (FvD)",0.671302299732712,0.120820425168251,0
"<anonymized_userid>",15,50748,1132,"Thierry Baudet (FvD)",0.671500780691772,0.120927251362034,0
"<anonymized_userid>",15,50763,1133,"Thierry Baudet (FvD)",0.671699261650832,0.121034077555817,0
"<anonymized_userid>",15,50778,1134,"Thierry Baudet (FvD)",0.671897742609892,0.121140903749599,0
"<anonymized_userid>",15,50793,1135,"Thierry Baudet (FvD)",0.672096223568952,0.121247729943382,0
"<anonymized_userid>",15,50808,1136,"Thierry Baudet (FvD)",0.672294704528012,0.121354556137165,0
"<anonymized_userid>",15,50823,1137,"Thierry Baudet (FvD)",0.672493185487072,0.121461382330948,0
"<anonymized_userid>",15,50838,1138,"Thierry Baudet (FvD)",0.672691666446132,0.12156820852473,0
"<anonymized_userid>",15,50853,1139,"Thierry Baudet (FvD)",0.672890147405192,0.121675034718513,0
"<anonymized_userid>",15,50868,1140,"Thierry Baudet (FvD)",0.673088628364252,0.121781860912296,0
"<anonymized_userid>",15,50883,1141,"Thierry Baudet (FvD)",0.673287109323312,0.121888687106078,0
"<anonymized_userid>",15,50898,1142,"Thierry Baudet (FvD)",0.673485590282372,0.121995513299861,0
"<anonymized_userid>",15,50913,1143,"Thierry Baudet (FvD)",0.673684071241432,0.122102339493644,0
"<anonymized_userid>",15,50928,1144,"Thierry Baudet (FvD)",0.673882552200492,0.122209165687427,0
"<anonymized_userid>",15,50943,1145,"Thierry Baudet (FvD)",0.674081033159552,0.122315991881209,0
"<anonymized_userid>",15,50958,1146,"Thierry Baudet (FvD)",0.674279514118612,0.122422818074992,0
"<anonymized_userid>",15,50973,1147,"Thierry Baudet (FvD)",0.674477995077672,0.122529644268775,0
"<anonymized_userid>",15,50988,1148,"Thierry Baudet (FvD)",0.674676476036732,0.122636470462557,0
"<anonymized_userid>",15,51003,1149,"Thierry Baudet (FvD)",0.674874956995792,0.12274329665634,0
"<anonymized_userid>",15,51018,1150,"Thierry Baudet (FvD)",0.675073437954852,0.122850122850123,0
"<anonymized_userid>",15,51033,1151,"Thierry Baudet (FvD)",0.675271918913912,0.122956949043906,0
"<anonymized_userid>",15,51048,1152,"Thierry Baudet (FvD)",0.675470399872972,0.123063775237688,0
"<anonymized_userid>",15,51063,1153,"Thierry Baudet (FvD)",0.675668880832032,0.123170601431471,0
"<anonymized_userid>",15,51078,1154,"Thierry Baudet (FvD)",0.675867361791092,0.123277427625254,0
"<anonymized_userid>",15,51093,1155,"Thierry Baudet (FvD)",0.676065842750152,0.123384253819036,0
"<anonymized_userid>",15,51108,1156,"Thierry Baudet (FvD)",0.676264323709212,0.123491080012819,0
"<anonymized_userid>",15,51123,1157,"Thierry Baudet (FvD)",0.676462804668272,0.123597906206602,0
"<anonymized_userid>",15,51138,1158,"Thierry Baudet (FvD)",0.676661285627332,0.123704732400385,0
"<anonymized_userid>",15,51153,1159,"Thierry Baudet (FvD)",0.676859766586392,0.123811558594167,0
"<anonymized_userid>",15,51168,1160,"Thierry Baudet (FvD)",0.677058247545452,0.12391838478795,0
"<anonymized_userid>",15,51183,1161,"Thierry Baudet (FvD)",0.677256728504512,0.124025210981733,0
"<anonymized_userid>",15,51198,1162,"Thierry Baudet (FvD)",0.677455209463572,0.124132037175515,0
"<anonymized_userid>",14,51212,1163,"Thierry Baudet (FvD)",0.677640458358695,0.124238863369298,0
"<anonymized_userid>",14,51226,1164,"Thierry Baudet (FvD)",0.677825707253817,0.124345689563081,0
"<anonymized_userid>",14,51240,1165,"Thierry Baudet (FvD)",0.67801095614894,0.124452515756864,0
"<anonymized_userid>",14,51254,1166,"Thierry Baudet (FvD)",0.678196205044063,0.124559341950646,0
"<anonymized_userid>",14,51268,1167,"Thierry Baudet (FvD)",0.678381453939185,0.124666168144429,0
"<anonymized_userid>",14,51282,1168,"Thierry Baudet (FvD)",0.678566702834308,0.124772994338212,0
"<anonymized_userid>",14,51296,1169,"Thierry Baudet (FvD)",0.678751951729431,0.124879820531994,0
"<anonymized_userid>",14,51310,1170,"Thierry Baudet (FvD)",0.678937200624553,0.124986646725777,0
"<anonymized_userid>",14,51324,1171,"Thierry Baudet (FvD)",0.679122449519676,0.12509347291956,0
"<anonymized_userid>",14,51338,1172,"Thierry Baudet (FvD)",0.679307698414799,0.125200299113343,0
"<anonymized_userid>",14,51352,1173,"Thierry Baudet (FvD)",0.679492947309921,0.125307125307125,0
"<anonymized_userid>",14,51366,1174,"Thierry Baudet (FvD)",0.679678196205044,0.125413951500908,0
"<anonymized_userid>",14,51380,1175,"Thierry Baudet (FvD)",0.679863445100167,0.125520777694691,0
"<anonymized_userid>",14,51394,1176,"Thierry Baudet (FvD)",0.680048693995289,0.125627603888473,0
"<anonymized_userid>",14,51408,1177,"Thierry Baudet (FvD)",0.680233942890412,0.125734430082256,0
"<anonymized_userid>",14,51422,1178,"Thierry Baudet (FvD)",0.680419191785535,0.125841256276039,0
"<anonymized_userid>",14,51436,1179,"Thierry Baudet (FvD)",0.680604440680657,0.125948082469822,0
"<anonymized_userid>",14,51450,1180,"Thierry Baudet (FvD)",0.68078968957578,0.126054908663604,0
"<anonymized_userid>",14,51464,1181,"Thierry Baudet (FvD)",0.680974938470903,0.126161734857387,0
"<anonymized_userid>",14,51478,1182,"Thierry Baudet (FvD)",0.681160187366025,0.12626856105117,0
"<anonymized_userid>",14,51492,1183,"Thierry Baudet (FvD)",0.681345436261148,0.126375387244952,0
"<anonymized_userid>",14,51506,1184,"Thierry Baudet (FvD)",0.681530685156271,0.126482213438735,0
"<anonymized_userid>",14,51520,1185,"Thierry Baudet (FvD)",0.681715934051393,0.126589039632518,0
"<anonymized_userid>",14,51534,1186,"Thierry Baudet (FvD)",0.681901182946516,0.126695865826301,0
"<anonymized_userid>",14,51548,1187,"Thierry Baudet (FvD)",0.682086431841639,0.126802692020083,0
"<anonymized_userid>",14,51562,1188,"Thierry Baudet (FvD)",0.682271680736761,0.126909518213866,0
"<anonymized_userid>",14,51576,1189,"Thierry Baudet (FvD)",0.682456929631884,0.127016344407649,0
"<anonymized_userid>",14,51590,1190,"Thierry Baudet (FvD)",0.682642178527007,0.127123170601431,0
"<anonymized_userid>",14,51604,1191,"Thierry Baudet (FvD)",0.682827427422129,0.127229996795214,0
"<anonymized_userid>",14,51618,1192,"Thierry Baudet (FvD)",0.683012676317252,0.127336822988997,0
"<anonymized_userid>",14,51632,1193,"Thierry Baudet (FvD)",0.683197925212375,0.12744364918278,0
"<anonymized_userid>",14,51646,1194,"Thierry Baudet (FvD)",0.683383174107497,0.127550475376562,0
"<anonymized_userid>",14,51660,1195,"Thierry Baudet (FvD)",0.68356842300262,0.127657301570345,0
"<anonymized_userid>",14,51674,1196,"Thierry Baudet (FvD)",0.683753671897743,0.127764127764128,0
"<anonymized_userid>",14,51688,1197,"Thierry Baudet (FvD)",0.683938920792865,0.12787095395791,0
"<anonymized_userid>",14,51702,1198,"Thierry Baudet (FvD)",0.684124169687988,0.127977780151693,0
"<anonymized_userid>",14,51716,1199,"Thierry Baudet (FvD)",0.684309418583111,0.128084606345476,0
"<anonymized_userid>",14,51730,1200,"Thierry Baudet (FvD)",0.684494667478233,0.128191432539259,0
"<anonymized_userid>",14,51744,1201,"Thierry Baudet (FvD)",0.684679916373356,0.128298258733041,0
"<anonymized_userid>",14,51758,1202,"Thierry Baudet (FvD)",0.684865165268479,0.128405084926824,0
"<anonymized_userid>",14,51772,1203,"Thierry Baudet (FvD)",0.685050414163601,0.128511911120607,0
"<anonymized_userid>",14,51786,1204,"Thierry Baudet (FvD)",0.685235663058724,0.128618737314389,0
"<anonymized_userid>",14,51800,1205,"Thierry Baudet (FvD)",0.685420911953847,0.128725563508172,0
"<anonymized_userid>",14,51814,1206,"Thierry Baudet (FvD)",0.685606160848969,0.128832389701955,0
"<anonymized_userid>",14,51828,1207,"Thierry Baudet (FvD)",0.685791409744092,0.128939215895738,0
"<anonymized_userid>",14,51842,1208,"Thierry Baudet (FvD)",0.685976658639215,0.12904604208952,0
"<anonymized_userid>",14,51856,1209,"Thierry Baudet (FvD)",0.686161907534337,0.129152868283303,0
"<anonymized_userid>",14,51870,1210,"Thierry Baudet (FvD)",0.68634715642946,0.129259694477086,0
"<anonymized_userid>",14,51884,1211,"Thierry Baudet (FvD)",0.686532405324582,0.129366520670868,0
"<anonymized_userid>",14,51898,1212,"Thierry Baudet (FvD)",0.686717654219705,0.129473346864651,0
"<anonymized_userid>",14,51912,1213,"Thierry Baudet (FvD)",0.686902903114828,0.129580173058434,0
"<anonymized_userid>",14,51926,1214,"Thierry Baudet (FvD)",0.687088152009951,0.129686999252217,0
"<anonymized_userid>",14,51940,1215,"Thierry Baudet (FvD)",0.687273400905073,0.129793825445999,0
"<anonymized_userid>",14,51954,1216,"Thierry Baudet (FvD)",0.687458649800196,0.129900651639782,0
"<anonymized_userid>",14,51968,1217,"Thierry Baudet (FvD)",0.687643898695319,0.130007477833565,0
"<anonymized_userid>",14,51982,1218,"Thierry Baudet (FvD)",0.687829147590441,0.130114304027347,0
"<anonymized_userid>",14,51996,1219,"Thierry Baudet (FvD)",0.688014396485564,0.13022113022113,0
"<anonymized_userid>",14,52010,1220,"Thierry Baudet (FvD)",0.688199645380686,0.130327956414913,0
"<anonymized_userid>",14,52024,1221,"Thierry Baudet (FvD)",0.688384894275809,0.130434782608696,0
"<anonymized_userid>",14,52038,1222,"Thierry Baudet (FvD)",0.688570143170932,0.130541608802478,0
"<anonymized_userid>",14,52052,1223,"Thierry Baudet (FvD)",0.688755392066055,0.130648434996261,0
"<anonymized_userid>",14,52066,1224,"Thierry Baudet (FvD)",0.688940640961177,0.130755261190044,0
"<anonymized_userid>",14,52080,1225,"Thierry Baudet (FvD)",0.6891258898563,0.130862087383827,0
"<anonymized_userid>",14,52094,1226,"Thierry Baudet (FvD)",0.689311138751422,0.130968913577609,0
"<anonymized_userid>",14,52108,1227,"Thierry Baudet (FvD)",0.689496387646545,0.131075739771392,0
"<anonymized_userid>",14,52122,1228,"Thierry Baudet (FvD)",0.689681636541668,0.131182565965175,0
"<anonymized_userid>",14,52136,1229,"Thierry Baudet (FvD)",0.68986688543679,0.131289392158957,0
"<anonymized_userid>",14,52150,1230,"Thierry Baudet (FvD)",0.690052134331913,0.13139621835274,0
"<anonymized_userid>",14,52164,1231,"Thierry Baudet (FvD)",0.690237383227036,0.131503044546523,0
"<anonymized_userid>",14,52178,1232,"Thierry Baudet (FvD)",0.690422632122158,0.131609870740306,0
"<anonymized_userid>",14,52192,1233,"Thierry Baudet (FvD)",0.690607881017281,0.131716696934088,0
"<anonymized_userid>",14,52206,1234,"Thierry Baudet (FvD)",0.690793129912404,0.131823523127871,0
"<anonymized_userid>",14,52220,1235,"Thierry Baudet (FvD)",0.690978378807526,0.131930349321654,0
"<anonymized_userid>",14,52234,1236,"Thierry Baudet (FvD)",0.691163627702649,0.132037175515436,0
"<anonymized_userid>",14,52248,1237,"Thierry Baudet (FvD)",0.691348876597772,0.132144001709219,0
"<anonymized_userid>",14,52262,1238,"Thierry Baudet (FvD)",0.691534125492894,0.132250827903002,0
"<anonymized_userid>",14,52276,1239,"Thierry Baudet (FvD)",0.691719374388017,0.132357654096785,0
"<anonymized_userid>",14,52290,1240,"Thierry Baudet (FvD)",0.69190462328314,0.132464480290567,0
"<anonymized_userid>",14,52304,1241,"Thierry Baudet (FvD)",0.692089872178262,0.13257130648435,0
"<anonymized_userid>",14,52318,1242,"Thierry Baudet (FvD)",0.692275121073385,0.132678132678133,0
"<anonymized_userid>",14,52332,1243,"Thierry Baudet (FvD)",0.692460369968508,0.132784958871915,0
"<anonymized_userid>",14,52346,1244,"Thierry Baudet (FvD)",0.69264561886363,0.132891785065698,0
"<anonymized_userid>",14,52360,1245,"Thierry Baudet (FvD)",0.692830867758753,0.132998611259481,0
"<anonymized_userid>",14,52374,1246,"Thierry Baudet (FvD)",0.693016116653876,0.133105437453264,0
"<anonymized_userid>",13,52387,1247,"Thierry Baudet (FvD)",0.693188133485061,0.133212263647046,0
"<anonymized_userid>",13,52400,1248,"Thierry Baudet (FvD)",0.693360150316246,0.133319089840829,0
"<anonymized_userid>",13,52413,1249,"Thierry Baudet (FvD)",0.693532167147432,0.133425916034612,0
"<anonymized_userid>",13,52426,1250,"Thierry Baudet (FvD)",0.693704183978617,0.133532742228394,0
"<anonymized_userid>",13,52439,1251,"Thierry Baudet (FvD)",0.693876200809802,0.133639568422177,0
"<anonymized_userid>",13,52452,1252,"Thierry Baudet (FvD)",0.694048217640988,0.13374639461596,0
"<anonymized_userid>",13,52465,1253,"Thierry Baudet (FvD)",0.694220234472173,0.133853220809743,0
"<anonymized_userid>",13,52478,1254,"Thierry Baudet (FvD)",0.694392251303358,0.133960047003525,0
"<anonymized_userid>",13,52491,1255,"Thierry Baudet (FvD)",0.694564268134544,0.134066873197308,0
"<anonymized_userid>",13,52504,1256,"Thierry Baudet (FvD)",0.694736284965729,0.134173699391091,0
"<anonymized_userid>",13,52517,1257,"Thierry Baudet (FvD)",0.694908301796914,0.134280525584873,0
"<anonymized_userid>",13,52530,1258,"Thierry Baudet (FvD)",0.6950803186281,0.134387351778656,0
"<anonymized_userid>",13,52543,1259,"Thierry Baudet (FvD)",0.695252335459285,0.134494177972439,0
"<anonymized_userid>",13,52556,1260,"Thierry Baudet (FvD)",0.69542435229047,0.134601004166222,0
"<anonymized_userid>",13,52569,1261,"Thierry Baudet (FvD)",0.695596369121656,0.134707830360004,0
"<anonymized_userid>",13,52582,1262,"Thierry Baudet (FvD)",0.695768385952841,0.134814656553787,0
"<anonymized_userid>",13,52595,1263,"Thierry Baudet (FvD)",0.695940402784026,0.13492148274757,0
"<anonymized_userid>",13,52608,1264,"Thierry Baudet (FvD)",0.696112419615212,0.135028308941352,0
"<anonymized_userid>",13,52621,1265,"Thierry Baudet (FvD)",0.696284436446397,0.135135135135135,0
"<anonymized_userid>",13,52634,1266,"Thierry Baudet (FvD)",0.696456453277582,0.135241961328918,0
"<anonymized_userid>",13,52647,1267,"Thierry Baudet (FvD)",0.696628470108768,0.135348787522701,0
"<anonymized_userid>",13,52660,1268,"Thierry Baudet (FvD)",0.696800486939953,0.135455613716483,0
"<anonymized_userid>",13,52673,1269,"Thierry Baudet (FvD)",0.696972503771138,0.135562439910266,0
"<anonymized_userid>",13,52686,1270,"Thierry Baudet (FvD)",0.697144520602324,0.135669266104049,0
"<anonymized_userid>",13,52699,1271,"Thierry Baudet (FvD)",0.697316537433509,0.135776092297831,0
"<anonymized_userid>",13,52712,1272,"Thierry Baudet (FvD)",0.697488554264694,0.135882918491614,0
"<anonymized_userid>",13,52725,1273,"Thierry Baudet (FvD)",0.69766057109588,0.135989744685397,0
"<anonymized_userid>",13,52738,1274,"Thierry Baudet (FvD)",0.697832587927065,0.13609657087918,0
"<anonymized_userid>",13,52751,1275,"Thierry Baudet (FvD)",0.69800460475825,0.136203397072962,0
"<anonymized_userid>",13,52764,1276,"Thierry Baudet (FvD)",0.698176621589435,0.136310223266745,0
"<anonymized_userid>",13,52777,1277,"Thierry Baudet (FvD)",0.698348638420621,0.136417049460528,0
"<anonymized_userid>",13,52790,1278,"Thierry Baudet (FvD)",0.698520655251806,0.13652387565431,0
"<anonymized_userid>",13,52803,1279,"Thierry Baudet (FvD)",0.698692672082991,0.136630701848093,0
"<anonymized_userid>",13,52816,1280,"Thierry Baudet (FvD)",0.698864688914177,0.136737528041876,0
"<anonymized_userid>",13,52829,1281,"Thierry Baudet (FvD)",0.699036705745362,0.136844354235659,0
"<anonymized_userid>",13,52842,1282,"Thierry Baudet (FvD)",0.699208722576548,0.136951180429441,0
"<anonymized_userid>",13,52855,1283,"Thierry Baudet (FvD)",0.699380739407733,0.137058006623224,0
"<anonymized_userid>",13,52868,1284,"Thierry Baudet (FvD)",0.699552756238918,0.137164832817007,0
"<anonymized_userid>",13,52881,1285,"Thierry Baudet (FvD)",0.699724773070104,0.137271659010789,0
"<anonymized_userid>",13,52894,1286,"Thierry Baudet (FvD)",0.699896789901289,0.137378485204572,0
"<anonymized_userid>",13,52907,1287,"Thierry Baudet (FvD)",0.700068806732474,0.137485311398355,0
"<anonymized_userid>",13,52920,1288,"Thierry Baudet (FvD)",0.700240823563659,0.137592137592138,0
"<anonymized_userid>",13,52933,1289,"Thierry Baudet (FvD)",0.700412840394845,0.13769896378592,0
"<anonymized_userid>",13,52946,1290,"Thierry Baudet (FvD)",0.70058485722603,0.137805789979703,0
"<anonymized_userid>",13,52959,1291,"Thierry Baudet (FvD)",0.700756874057215,0.137912616173486,0
"<anonymized_userid>",13,52972,1292,"Thierry Baudet (FvD)",0.700928890888401,0.138019442367268,0
"<anonymized_userid>",13,52985,1293,"Thierry Baudet (FvD)",0.701100907719586,0.138126268561051,0
"<anonymized_userid>",13,52998,1294,"Thierry Baudet (FvD)",0.701272924550771,0.138233094754834,0
"<anonymized_userid>",13,53011,1295,"Thierry Baudet (FvD)",0.701444941381957,0.138339920948617,0
"<anonymized_userid>",13,53024,1296,"Thierry Baudet (FvD)",0.701616958213142,0.138446747142399,0
"<anonymized_userid>",13,53037,1297,"Thierry Baudet (FvD)",0.701788975044327,0.138553573336182,0
"<anonymized_userid>",13,53050,1298,"Thierry Baudet (FvD)",0.701960991875513,0.138660399529965,0
"<anonymized_userid>",13,53063,1299,"Thierry Baudet (FvD)",0.702133008706698,0.138767225723747,0
"<anonymized_userid>",13,53076,1300,"Thierry Baudet (FvD)",0.702305025537883,0.13887405191753,0
"<anonymized_userid>",13,53089,1301,"Thierry Baudet (FvD)",0.702477042369069,0.138980878111313,0
"<anonymized_userid>",13,53102,1302,"Thierry Baudet (FvD)",0.702649059200254,0.139087704305096,0
"<anonymized_userid>",13,53115,1303,"Thierry Baudet (FvD)",0.702821076031439,0.139194530498878,0
"<anonymized_userid>",13,53128,1304,"Thierry Baudet (FvD)",0.702993092862625,0.139301356692661,0
"<anonymized_userid>",13,53141,1305,"Thierry Baudet (FvD)",0.70316510969381,0.139408182886444,0
"<anonymized_userid>",13,53154,1306,"Thierry Baudet (FvD)",0.703337126524995,0.139515009080226,0
"<anonymized_userid>",13,53167,1307,"Thierry Baudet (FvD)",0.703509143356181,0.139621835274009,0
"<anonymized_userid>",13,53180,1308,"Thierry Baudet (FvD)",0.703681160187366,0.139728661467792,0
"<anonymized_userid>",13,53193,1309,"Thierry Baudet (FvD)",0.703853177018551,0.139835487661575,0
"<anonymized_userid>",13,53206,1310,"Thierry Baudet (FvD)",0.704025193849737,0.139942313855357,0
"<anonymized_userid>",13,53219,1311,"Thierry Baudet (FvD)",0.704197210680922,0.14004914004914,0
"<anonymized_userid>",13,53232,1312,"Thierry Baudet (FvD)",0.704369227512107,0.140155966242923,0
"<anonymized_userid>",13,53245,1313,"Thierry Baudet (FvD)",0.704541244343293,0.140262792436705,0
"<anonymized_userid>",13,53258,1314,"Thierry Baudet (FvD)",0.704713261174478,0.140369618630488,0
"<anonymized_userid>",13,53271,1315,"Thierry Baudet (FvD)",0.704885278005663,0.140476444824271,0
"<anonymized_userid>",13,53284,1316,"Thierry Baudet (FvD)",0.705057294836849,0.140583271018054,0
"<anonymized_userid>",13,53297,1317,"Thierry Baudet (FvD)",0.705229311668034,0.140690097211836,0
"<anonymized_userid>",13,53310,1318,"Thierry Baudet (FvD)",0.705401328499219,0.140796923405619,0
"<anonymized_userid>",13,53323,1319,"Thierry Baudet (FvD)",0.705573345330405,0.140903749599402,0
"<anonymized_userid>",13,53336,1320,"Thierry Baudet (FvD)",0.70574536216159,0.141010575793184,0
"<anonymized_userid>",13,53349,1321,"Thierry Baudet (FvD)",0.705917378992775,0.141117401986967,0
"<anonymized_userid>",13,53362,1322,"Thierry Baudet (FvD)",0.706089395823961,0.14122422818075,0
"<anonymized_userid>",13,53375,1323,"Thierry Baudet (FvD)",0.706261412655146,0.141331054374533,0
"<anonymized_userid>",12,53387,1324,"Thierry Baudet (FvD)",0.706420197422394,0.141437880568315,0
"<anonymized_userid>",12,53399,1325,"Thierry Baudet (FvD)",0.706578982189642,0.141544706762098,0
"<anonymized_userid>",12,53411,1326,"Thierry Baudet (FvD)",0.70673776695689,0.141651532955881,0
"<anonymized_userid>",12,53423,1327,"Thierry Baudet (FvD)",0.706896551724138,0.141758359149664,0
"<anonymized_userid>",12,53435,1328,"Thierry Baudet (FvD)",0.707055336491386,0.141865185343446,0
"<anonymized_userid>",12,53447,1329,"Thierry Baudet (FvD)",0.707214121258634,0.141972011537229,0
"<anonymized_userid>",12,53459,1330,"Thierry Baudet (FvD)",0.707372906025882,0.142078837731012,0
"<anonymized_userid>",12,53471,1331,"Thierry Baudet (FvD)",0.70753169079313,0.142185663924794,0
"<anonymized_userid>",12,53483,1332,"Thierry Baudet (FvD)",0.707690475560378,0.142292490118577,0
"<anonymized_userid>",12,53495,1333,"Thierry Baudet (FvD)",0.707849260327626,0.14239931631236,0
"<anonymized_userid>",12,53507,1334,"Thierry Baudet (FvD)",0.708008045094874,0.142506142506143,0
"<anonymized_userid>",12,53519,1335,"Thierry Baudet (FvD)",0.708166829862122,0.142612968699925,0
"<anonymized_userid>",12,53531,1336,"Thierry Baudet (FvD)",0.70832561462937,0.142719794893708,0
"<anonymized_userid>",12,53543,1337,"Thierry Baudet (FvD)",0.708484399396618,0.142826621087491,0
"<anonymized_userid>",12,53555,1338,"Thierry Baudet (FvD)",0.708643184163866,0.142933447281273,0
"<anonymized_userid>",12,53567,1339,"Thierry Baudet (FvD)",0.708801968931114,0.143040273475056,0
"<anonymized_userid>",12,53579,1340,"Thierry Baudet (FvD)",0.708960753698362,0.143147099668839,0
"<anonymized_userid>",12,53591,1341,"Thierry Baudet (FvD)",0.70911953846561,0.143253925862622,0
"<anonymized_userid>",12,53603,1342,"Thierry Baudet (FvD)",0.709278323232858,0.143360752056404,0
"<anonymized_userid>",12,53615,1343,"Thierry Baudet (FvD)",0.709437108000106,0.143467578250187,0
"<anonymized_userid>",12,53627,1344,"Thierry Baudet (FvD)",0.709595892767354,0.14357440444397,0
"<anonymized_userid>",12,53639,1345,"Thierry Baudet (FvD)",0.709754677534602,0.143681230637752,0
"<anonymized_userid>",12,53651,1346,"Thierry Baudet (FvD)",0.70991346230185,0.143788056831535,0
"<anonymized_userid>",12,53663,1347,"Thierry Baudet (FvD)",0.710072247069098,0.143894883025318,0
"<anonymized_userid>",12,53675,1348,"Thierry Baudet (FvD)",0.710231031836346,0.144001709219101,0
"<anonymized_userid>",12,53687,1349,"Thierry Baudet (FvD)",0.710389816603594,0.144108535412883,0
"<anonymized_userid>",12,53699,1350,"Thierry Baudet (FvD)",0.710548601370842,0.144215361606666,0
"<anonymized_userid>",12,53711,1351,"Thierry Baudet (FvD)",0.71070738613809,0.144322187800449,0
"<anonymized_userid>",12,53723,1352,"Thierry Baudet (FvD)",0.710866170905338,0.144429013994231,0
"<anonymized_userid>",12,53735,1353,"Thierry Baudet (FvD)",0.711024955672586,0.144535840188014,0
"<anonymized_userid>",12,53747,1354,"Thierry Baudet (FvD)",0.711183740439834,0.144642666381797,0
"<anonymized_userid>",12,53759,1355,"Thierry Baudet (FvD)",0.711342525207082,0.14474949257558,0
"<anonymized_userid>",12,53771,1356,"Thierry Baudet (FvD)",0.71150130997433,0.144856318769362,0
"<anonymized_userid>",12,53783,1357,"Thierry Baudet (FvD)",0.711660094741578,0.144963144963145,0
"<anonymized_userid>",12,53795,1358,"Thierry Baudet (FvD)",0.711818879508826,0.145069971156928,0
"<anonymized_userid>",12,53807,1359,"Thierry Baudet (FvD)",0.711977664276074,0.14517679735071,0
"<anonymized_userid>",12,53819,1360,"Thierry Baudet (FvD)",0.712136449043322,0.145283623544493,0
"<anonymized_userid>",12,53831,1361,"Thierry Baudet (FvD)",0.71229523381057,0.145390449738276,0
"<anonymized_userid>",12,53843,1362,"Thierry Baudet (FvD)",0.712454018577818,0.145497275932059,0
"<anonymized_userid>",12,53855,1363,"Thierry Baudet (FvD)",0.712612803345066,0.145604102125841,0
"<anonymized_userid>",12,53867,1364,"Thierry Baudet (FvD)",0.712771588112314,0.145710928319624,0
"<anonymized_userid>",12,53879,1365,"Thierry Baudet (FvD)",0.712930372879562,0.145817754513407,0
"<anonymized_userid>",12,53891,1366,"Thierry Baudet (FvD)",0.71308915764681,0.145924580707189,0
"<anonymized_userid>",12,53903,1367,"Thierry Baudet (FvD)",0.713247942414058,0.146031406900972,0
"<anonymized_userid>",12,53915,1368,"Thierry Baudet (FvD)",0.713406727181306,0.146138233094755,0
"<anonymized_userid>",12,53927,1369,"Thierry Baudet (FvD)",0.713565511948554,0.146245059288538,0
"<anonymized_userid>",12,53939,1370,"Thierry Baudet (FvD)",0.713724296715802,0.14635188548232,0
"<anonymized_userid>",12,53951,1371,"Thierry Baudet (FvD)",0.71388308148305,0.146458711676103,0
"<anonymized_userid>",12,53963,1372,"Thierry Baudet (FvD)",0.714041866250298,0.146565537869886,0
"<anonymized_userid>",12,53975,1373,"Thierry Baudet (FvD)",0.714200651017546,0.146672364063668,0
"<anonymized_userid>",12,53987,1374,"Thierry Baudet (FvD)",0.714359435784794,0.146779190257451,0
"<anonymized_userid>",12,53999,1375,"Thierry Baudet (FvD)",0.714518220552042,0.146886016451234,0
"<anonymized_userid>",12,54011,1376,"Thierry Baudet (FvD)",0.71467700531929,0.146992842645017,0
"<anonymized_userid>",12,54023,1377,"Thierry Baudet (FvD)",0.714835790086538,0.147099668838799,0
"<anonymized_userid>",12,54035,1378,"Thierry Baudet (FvD)",0.714994574853786,0.147206495032582,0
"<anonymized_userid>",12,54047,1379,"Thierry Baudet (FvD)",0.715153359621034,0.147313321226365,0
"<anonymized_userid>",12,54059,1380,"Thierry Baudet (FvD)",0.715312144388282,0.147420147420147,0
"<anonymized_userid>",12,54071,1381,"Thierry Baudet (FvD)",0.71547092915553,0.14752697361393,0
"<anonymized_userid>",12,54083,1382,"Thierry Baudet (FvD)",0.715629713922778,0.147633799807713,0
"<anonymized_userid>",12,54095,1383,"Thierry Baudet (FvD)",0.715788498690026,0.147740626001496,0
"<anonymized_userid>",12,54107,1384,"Thierry Baudet (FvD)",0.715947283457274,0.147847452195278,0
"<anonymized_userid>",12,54119,1385,"Thierry Baudet (FvD)",0.716106068224522,0.147954278389061,0
"<anonymized_userid>",12,54131,1386,"Thierry Baudet (FvD)",0.71626485299177,0.148061104582844,0
"<anonymized_userid>",12,54143,1387,"Thierry Baudet (FvD)",0.716423637759018,0.148167930776626,0
"<anonymized_userid>",12,54155,1388,"Thierry Baudet (FvD)",0.716582422526266,0.148274756970409,0
"<anonymized_userid>",12,54167,1389,"Thierry Baudet (FvD)",0.716741207293514,0.148381583164192,0
"<anonymized_userid>",12,54179,1390,"Thierry Baudet (FvD)",0.716899992060762,0.148488409357975,0
"<anonymized_userid>",12,54191,1391,"Thierry Baudet (FvD)",0.71705877682801,0.148595235551757,0
"<anonymized_userid>",12,54203,1392,"Thierry Baudet (FvD)",0.717217561595258,0.14870206174554,0
"<anonymized_userid>",12,54215,1393,"Thierry Baudet (FvD)",0.717376346362506,0.148808887939323,0
"<anonymized_userid>",12,54227,1394,"Thierry Baudet (FvD)",0.717535131129754,0.148915714133105,0
"<anonymized_userid>",12,54239,1395,"Thierry Baudet (FvD)",0.717693915897002,0.149022540326888,0
"<anonymized_userid>",12,54251,1396,"Thierry Baudet (FvD)",0.71785270066425,0.149129366520671,0
"<anonymized_userid>",12,54263,1397,"Thierry Baudet (FvD)",0.718011485431498,0.149236192714454,0
"<anonymized_userid>",12,54275,1398,"Thierry Baudet (FvD)",0.718170270198746,0.149343018908236,0
"<anonymized_userid>",12,54287,1399,"Thierry Baudet (FvD)",0.718329054965994,0.149449845102019,0
"<anonymized_userid>",12,54299,1400,"Thierry Baudet (FvD)",0.718487839733242,0.149556671295802,0
"<anonymized_userid>",12,54311,1401,"Thierry Baudet (FvD)",0.71864662450049,0.149663497489584,0
"<anonymized_userid>",12,54323,1402,"Thierry Baudet (FvD)",0.718805409267738,0.149770323683367,0
"<anonymized_userid>",12,54335,1403,"Thierry Baudet (FvD)",0.718964194034986,0.14987714987715,0
"<anonymized_userid>",12,54347,1404,"Thierry Baudet (FvD)",0.719122978802234,0.149983976070933,0
"<anonymized_userid>",12,54359,1405,"Thierry Baudet (FvD)",0.719281763569482,0.150090802264715,0
"<anonymized_userid>",12,54371,1406,"Thierry Baudet (FvD)",0.71944054833673,0.150197628458498,0
"<anonymized_userid>",12,54383,1407,"Thierry Baudet (FvD)",0.719599333103978,0.150304454652281,0
"<anonymized_userid>",12,54395,1408,"Thierry Baudet (FvD)",0.719758117871226,0.150411280846063,0
"<anonymized_userid>",12,54407,1409,"Thierry Baudet (FvD)",0.719916902638474,0.150518107039846,0
"<anonymized_userid>",12,54419,1410,"Thierry Baudet (FvD)",0.720075687405722,0.150624933233629,0
"<anonymized_userid>",12,54431,1411,"Thierry Baudet (FvD)",0.72023447217297,0.150731759427412,0
"<anonymized_userid>",12,54443,1412,"Thierry Baudet (FvD)",0.720393256940217,0.150838585621194,0
"<anonymized_userid>",12,54455,1413,"Thierry Baudet (FvD)",0.720552041707466,0.150945411814977,0
"<anonymized_userid>",12,54467,1414,"Thierry Baudet (FvD)",0.720710826474714,0.15105223800876,0
"<anonymized_userid>",12,54479,1415,"Thierry Baudet (FvD)",0.720869611241961,0.151159064202542,0
"<anonymized_userid>",12,54491,1416,"Thierry Baudet (FvD)",0.72102839600921,0.151265890396325,0
"<anonymized_userid>",12,54503,1417,"Thierry Baudet (FvD)",0.721187180776457,0.151372716590108,0
"<anonymized_userid>",12,54515,1418,"Thierry Baudet (FvD)",0.721345965543706,0.151479542783891,0
"<anonymized_userid>",12,54527,1419,"Thierry Baudet (FvD)",0.721504750310954,0.151586368977673,0
"<anonymized_userid>",12,54539,1420,"Thierry Baudet (FvD)",0.721663535078201,0.151693195171456,0
"<anonymized_userid>",12,54551,1421,"Thierry Baudet (FvD)",0.72182231984545,0.151800021365239,0
"<anonymized_userid>",12,54563,1422,"Thierry Baudet (FvD)",0.721981104612697,0.151906847559021,0
"<anonymized_userid>",12,54575,1423,"Thierry Baudet (FvD)",0.722139889379945,0.152013673752804,0
"<anonymized_userid>",12,54587,1424,"Thierry Baudet (FvD)",0.722298674147194,0.152120499946587,0
"<anonymized_userid>",12,54599,1425,"Thierry Baudet (FvD)",0.722457458914441,0.15222732614037,0
"<anonymized_userid>",11,54610,1426,"Thierry Baudet (FvD)",0.722603011617752,0.152334152334152,0
"<anonymized_userid>",11,54621,1427,"Thierry Baudet (FvD)",0.722748564321063,0.152440978527935,0
"<anonymized_userid>",11,54632,1428,"Thierry Baudet (FvD)",0.722894117024373,0.152547804721718,0
"<anonymized_userid>",11,54643,1429,"Thierry Baudet (FvD)",0.723039669727684,0.1526546309155,0
"<anonymized_userid>",11,54654,1430,"Thierry Baudet (FvD)",0.723185222430995,0.152761457109283,0
"<anonymized_userid>",11,54665,1431,"Thierry Baudet (FvD)",0.723330775134305,0.152868283303066,0
"<anonymized_userid>",11,54676,1432,"Thierry Baudet (FvD)",0.723476327837616,0.152975109496849,0
"<anonymized_userid>",11,54687,1433,"Thierry Baudet (FvD)",0.723621880540927,0.153081935690631,0
"<anonymized_userid>",11,54698,1434,"Thierry Baudet (FvD)",0.723767433244237,0.153188761884414,0
"<anonymized_userid>",11,54709,1435,"Thierry Baudet (FvD)",0.723912985947548,0.153295588078197,0
"<anonymized_userid>",11,54720,1436,"Thierry Baudet (FvD)",0.724058538650859,0.153402414271979,0
"<anonymized_userid>",11,54731,1437,"Thierry Baudet (FvD)",0.724204091354169,0.153509240465762,0
"<anonymized_userid>",11,54742,1438,"Thierry Baudet (FvD)",0.72434964405748,0.153616066659545,0
"<anonymized_userid>",11,54753,1439,"Thierry Baudet (FvD)",0.724495196760791,0.153722892853328,0
"<anonymized_userid>",11,54764,1440,"Thierry Baudet (FvD)",0.724640749464101,0.15382971904711,0
"<anonymized_userid>",11,54775,1441,"Thierry Baudet (FvD)",0.724786302167412,0.153936545240893,0
"<anonymized_userid>",11,54786,1442,"Thierry Baudet (FvD)",0.724931854870723,0.154043371434676,0
"<anonymized_userid>",11,54797,1443,"Thierry Baudet (FvD)",0.725077407574033,0.154150197628458,0
"<anonymized_userid>",11,54808,1444,"Thierry Baudet (FvD)",0.725222960277344,0.154257023822241,0
"<anonymized_userid>",11,54819,1445,"Thierry Baudet (FvD)",0.725368512980655,0.154363850016024,0
"<anonymized_userid>",11,54830,1446,"Thierry Baudet (FvD)",0.725514065683965,0.154470676209807,0
"<anonymized_userid>",11,54841,1447,"Thierry Baudet (FvD)",0.725659618387276,0.154577502403589,0
"<anonymized_userid>",11,54852,1448,"Thierry Baudet (FvD)",0.725805171090587,0.154684328597372,0
"<anonymized_userid>",11,54863,1449,"Thierry Baudet (FvD)",0.725950723793897,0.154791154791155,0
"<anonymized_userid>",11,54874,1450,"Thierry Baudet (FvD)",0.726096276497208,0.154897980984938,0
"<anonymized_userid>",11,54885,1451,"Thierry Baudet (FvD)",0.726241829200519,0.15500480717872,0
"<anonymized_userid>",11,54896,1452,"Thierry Baudet (FvD)",0.726387381903829,0.155111633372503,0
"<anonymized_userid>",11,54907,1453,"Thierry Baudet (FvD)",0.72653293460714,0.155218459566286,0
"<anonymized_userid>",11,54918,1454,"Thierry Baudet (FvD)",0.726678487310451,0.155325285760068,0
"<anonymized_userid>",11,54929,1455,"Thierry Baudet (FvD)",0.726824040013761,0.155432111953851,0
"<anonymized_userid>",11,54940,1456,"Thierry Baudet (FvD)",0.726969592717072,0.155538938147634,0
"<anonymized_userid>",11,54951,1457,"Thierry Baudet (FvD)",0.727115145420383,0.155645764341417,0
"<anonymized_userid>",11,54962,1458,"Thierry Baudet (FvD)",0.727260698123693,0.155752590535199,0
"<anonymized_userid>",11,54973,1459,"Thierry Baudet (FvD)",0.727406250827004,0.155859416728982,0
"<anonymized_userid>",11,54984,1460,"Thierry Baudet (FvD)",0.727551803530315,0.155966242922765,0
"<anonymized_userid>",11,54995,1461,"Thierry Baudet (FvD)",0.727697356233625,0.156073069116547,0
"<anonymized_userid>",11,55006,1462,"Thierry Baudet (FvD)",0.727842908936936,0.15617989531033,0
"<anonymized_userid>",11,55017,1463,"Thierry Baudet (FvD)",0.727988461640247,0.156286721504113,0
"<anonymized_userid>",11,55028,1464,"Thierry Baudet (FvD)",0.728134014343557,0.156393547697896,0
"<anonymized_userid>",11,55039,1465,"Thierry Baudet (FvD)",0.728279567046868,0.156500373891678,0
"<anonymized_userid>",11,55050,1466,"Thierry Baudet (FvD)",0.728425119750179,0.156607200085461,0
"<anonymized_userid>",11,55061,1467,"Thierry Baudet (FvD)",0.728570672453489,0.156714026279244,0
"<anonymized_userid>",11,55072,1468,"Thierry Baudet (FvD)",0.7287162251568,0.156820852473026,0
"<anonymized_userid>",11,55083,1469,"Thierry Baudet (FvD)",0.728861777860111,0.156927678666809,0
"<anonymized_userid>",11,55094,1470,"Thierry Baudet (FvD)",0.729007330563421,0.157034504860592,0
"<anonymized_userid>",11,55105,1471,"Thierry Baudet (FvD)",0.729152883266732,0.157141331054375,0
"<anonymized_userid>",11,55116,1472,"Thierry Baudet (FvD)",0.729298435970043,0.157248157248157,0
"<anonymized_userid>",11,55127,1473,"Thierry Baudet (FvD)",0.729443988673353,0.15735498344194,0
"<anonymized_userid>",11,55138,1474,"Thierry Baudet (FvD)",0.729589541376664,0.157461809635723,0
"<anonymized_userid>",11,55149,1475,"Thierry Baudet (FvD)",0.729735094079975,0.157568635829505,0
"<anonymized_userid>",11,55160,1476,"Thierry Baudet (FvD)",0.729880646783285,0.157675462023288,0
"<anonymized_userid>",11,55171,1477,"Thierry Baudet (FvD)",0.730026199486596,0.157782288217071,0
"<anonymized_userid>",11,55182,1478,"Thierry Baudet (FvD)",0.730171752189907,0.157889114410854,0
"<anonymized_userid>",11,55193,1479,"Thierry Baudet (FvD)",0.730317304893217,0.157995940604636,0
"<anonymized_userid>",11,55204,1480,"Thierry Baudet (FvD)",0.730462857596528,0.158102766798419,0
"<anonymized_userid>",11,55215,1481,"Thierry Baudet (FvD)",0.730608410299839,0.158209592992202,0
"<anonymized_userid>",11,55226,1482,"Thierry Baudet (FvD)",0.730753963003149,0.158316419185984,0
"<anonymized_userid>",11,55237,1483,"Thierry Baudet (FvD)",0.73089951570646,0.158423245379767,0
"<anonymized_userid>",11,55248,1484,"Thierry Baudet (FvD)",0.731045068409771,0.15853007157355,0
"<anonymized_userid>",11,55259,1485,"Thierry Baudet (FvD)",0.731190621113081,0.158636897767333,0
"<anonymized_userid>",11,55270,1486,"Thierry Baudet (FvD)",0.731336173816392,0.158743723961115,0
"<anonymized_userid>",11,55281,1487,"Thierry Baudet (FvD)",0.731481726519703,0.158850550154898,0
"<anonymized_userid>",11,55292,1488,"Thierry Baudet (FvD)",0.731627279223013,0.158957376348681,0
"<anonymized_userid>",11,55303,1489,"Thierry Baudet (FvD)",0.731772831926324,0.159064202542463,0
"<anonymized_userid>",11,55314,1490,"Thierry Baudet (FvD)",0.731918384629635,0.159171028736246,0
"<anonymized_userid>",11,55325,1491,"Thierry Baudet (FvD)",0.732063937332945,0.159277854930029,0
"<anonymized_userid>",11,55336,1492,"Thierry Baudet (FvD)",0.732209490036256,0.159384681123812,0
"<anonymized_userid>",11,55347,1493,"Thierry Baudet (FvD)",0.732355042739567,0.159491507317594,0
"<anonymized_userid>",11,55358,1494,"Thierry Baudet (FvD)",0.732500595442877,0.159598333511377,0
"<anonymized_userid>",11,55369,1495,"Thierry Baudet (FvD)",0.732646148146188,0.15970515970516,0
"<anonymized_userid>",11,55380,1496,"Thierry Baudet (FvD)",0.732791700849499,0.159811985898942,0
"<anonymized_userid>",11,55391,1497,"Thierry Baudet (FvD)",0.732937253552809,0.159918812092725,0
"<anonymized_userid>",11,55402,1498,"Thierry Baudet (FvD)",0.73308280625612,0.160025638286508,0
"<anonymized_userid>",11,55413,1499,"Thierry Baudet (FvD)",0.733228358959431,0.160132464480291,0
"<anonymized_userid>",11,55424,1500,"Thierry Baudet (FvD)",0.733373911662741,0.160239290674073,0
"<anonymized_userid>",11,55435,1501,"Thierry Baudet (FvD)",0.733519464366052,0.160346116867856,0
"<anonymized_userid>",11,55446,1502,"Thierry Baudet (FvD)",0.733665017069362,0.160452943061639,0
"<anonymized_userid>",11,55457,1503,"Thierry Baudet (FvD)",0.733810569772673,0.160559769255421,0
"<anonymized_userid>",11,55468,1504,"Thierry Baudet (FvD)",0.733956122475984,0.160666595449204,0
"<anonymized_userid>",11,55479,1505,"Thierry Baudet (FvD)",0.734101675179294,0.160773421642987,0
"<anonymized_userid>",11,55490,1506,"Thierry Baudet (FvD)",0.734247227882605,0.16088024783677,0
"<anonymized_userid>",11,55501,1507,"Thierry Baudet (FvD)",0.734392780585916,0.160987074030552,0
"<anonymized_userid>",11,55512,1508,"Thierry Baudet (FvD)",0.734538333289226,0.161093900224335,0
"<anonymized_userid>",11,55523,1509,"Thierry Baudet (FvD)",0.734683885992537,0.161200726418118,0
"<anonymized_userid>",11,55534,1510,"Thierry Baudet (FvD)",0.734829438695848,0.1613075526119,0
"<anonymized_userid>",11,55545,1511,"Thierry Baudet (FvD)",0.734974991399158,0.161414378805683,0
"<anonymized_userid>",11,55556,1512,"Thierry Baudet (FvD)",0.735120544102469,0.161521204999466,0
"<anonymized_userid>",11,55567,1513,"Thierry Baudet (FvD)",0.73526609680578,0.161628031193249,0
"<anonymized_userid>",11,55578,1514,"Thierry Baudet (FvD)",0.73541164950909,0.161734857387031,0
"<anonymized_userid>",11,55589,1515,"Thierry Baudet (FvD)",0.735557202212401,0.161841683580814,0
"<anonymized_userid>",11,55600,1516,"Thierry Baudet (FvD)",0.735702754915712,0.161948509774597,0
"<anonymized_userid>",11,55611,1517,"Thierry Baudet (FvD)",0.735848307619022,0.162055335968379,0
"<anonymized_userid>",11,55622,1518,"Thierry Baudet (FvD)",0.735993860322333,0.162162162162162,0
"<anonymized_userid>",11,55633,1519,"Thierry Baudet (FvD)",0.736139413025644,0.162268988355945,0
"<anonymized_userid>",11,55644,1520,"Thierry Baudet (FvD)",0.736284965728954,0.162375814549728,0
"<anonymized_userid>",11,55655,1521,"Thierry Baudet (FvD)",0.736430518432265,0.16248264074351,0
"<anonymized_userid>",11,55666,1522,"Thierry Baudet (FvD)",0.736576071135576,0.162589466937293,0
"<anonymized_userid>",11,55677,1523,"Thierry Baudet (FvD)",0.736721623838886,0.162696293131076,0
"<anonymized_userid>",11,55688,1524,"Thierry Baudet (FvD)",0.736867176542197,0.162803119324858,0
"<anonymized_userid>",11,55699,1525,"Thierry Baudet (FvD)",0.737012729245508,0.162909945518641,0
"<anonymized_userid>",11,55710,1526,"Thierry Baudet (FvD)",0.737158281948818,0.163016771712424,0
"<anonymized_userid>",11,55721,1527,"Thierry Baudet (FvD)",0.737303834652129,0.163123597906207,0
"<anonymized_userid>",11,55732,1528,"Thierry Baudet (FvD)",0.73744938735544,0.163230424099989,0
"<anonymized_userid>",11,55743,1529,"Thierry Baudet (FvD)",0.73759494005875,0.163337250293772,0
"<anonymized_userid>",11,55754,1530,"Thierry Baudet (FvD)",0.737740492762061,0.163444076487555,0
"<anonymized_userid>",11,55765,1531,"Thierry Baudet (FvD)",0.737886045465372,0.163550902681337,0
"<anonymized_userid>",11,55776,1532,"Thierry Baudet (FvD)",0.738031598168682,0.16365772887512,0
"<anonymized_userid>",11,55787,1533,"Thierry Baudet (FvD)",0.738177150871993,0.163764555068903,0
"<anonymized_userid>",11,55798,1534,"Thierry Baudet (FvD)",0.738322703575304,0.163871381262686,0
"<anonymized_userid>",11,55809,1535,"Thierry Baudet (FvD)",0.738468256278614,0.163978207456468,0
"<anonymized_userid>",11,55820,1536,"Thierry Baudet (FvD)",0.738613808981925,0.164085033650251,0
"<anonymized_userid>",11,55831,1537,"Thierry Baudet (FvD)",0.738759361685236,0.164191859844034,0
"<anonymized_userid>",11,55842,1538,"Thierry Baudet (FvD)",0.738904914388546,0.164298686037816,0
"<anonymized_userid>",11,55853,1539,"Thierry Baudet (FvD)",0.739050467091857,0.164405512231599,0
"<anonymized_userid>",11,55864,1540,"Thierry Baudet (FvD)",0.739196019795168,0.164512338425382,0
"<anonymized_userid>",11,55875,1541,"Thierry Baudet (FvD)",0.739341572498478,0.164619164619165,0
"<anonymized_userid>",10,55885,1542,"Thierry Baudet (FvD)",0.739473893137852,0.164725990812947,0
"<anonymized_userid>",10,55895,1543,"Thierry Baudet (FvD)",0.739606213777225,0.16483281700673,0
"<anonymized_userid>",10,55905,1544,"Thierry Baudet (FvD)",0.739738534416598,0.164939643200513,0
"<anonymized_userid>",10,55915,1545,"Thierry Baudet (FvD)",0.739870855055972,0.165046469394295,0
"<anonymized_userid>",10,55925,1546,"Thierry Baudet (FvD)",0.740003175695345,0.165153295588078,0
"<anonymized_userid>",10,55935,1547,"Thierry Baudet (FvD)",0.740135496334718,0.165260121781861,0
"<anonymized_userid>",10,55945,1548,"Thierry Baudet (FvD)",0.740267816974092,0.165366947975644,0
"<anonymized_userid>",10,55955,1549,"Thierry Baudet (FvD)",0.740400137613465,0.165473774169426,0
"<anonymized_userid>",10,55965,1550,"Thierry Baudet (FvD)",0.740532458252838,0.165580600363209,0
"<anonymized_userid>",10,55975,1551,"Thierry Baudet (FvD)",0.740664778892212,0.165687426556992,0
"<anonymized_userid>",10,55985,1552,"Thierry Baudet (FvD)",0.740797099531585,0.165794252750775,0
"<anonymized_userid>",10,55995,1553,"Thierry Baudet (FvD)",0.740929420170958,0.165901078944557,0
"<anonymized_userid>",10,56005,1554,"Thierry Baudet (FvD)",0.741061740810332,0.16600790513834,0
"<anonymized_userid>",10,56015,1555,"Thierry Baudet (FvD)",0.741194061449705,0.166114731332123,0
"<anonymized_userid>",10,56025,1556,"Thierry Baudet (FvD)",0.741326382089078,0.166221557525905,0
"<anonymized_userid>",10,56035,1557,"Thierry Baudet (FvD)",0.741458702728452,0.166328383719688,0
"<anonymized_userid>",10,56045,1558,"Thierry Baudet (FvD)",0.741591023367825,0.166435209913471,0
"<anonymized_userid>",10,56055,1559,"Thierry Baudet (FvD)",0.741723344007198,0.166542036107253,0
"<anonymized_userid>",10,56065,1560,"Thierry Baudet (FvD)",0.741855664646572,0.166648862301036,0
"<anonymized_userid>",10,56075,1561,"Thierry Baudet (FvD)",0.741987985285945,0.166755688494819,0
"<anonymized_userid>",10,56085,1562,"Thierry Baudet (FvD)",0.742120305925318,0.166862514688602,0
"<anonymized_userid>",10,56095,1563,"Thierry Baudet (FvD)",0.742252626564692,0.166969340882384,0
"<anonymized_userid>",10,56105,1564,"Thierry Baudet (FvD)",0.742384947204065,0.167076167076167,0
"<anonymized_userid>",10,56115,1565,"Thierry Baudet (FvD)",0.742517267843438,0.16718299326995,0
"<anonymized_userid>",10,56125,1566,"Thierry Baudet (FvD)",0.742649588482812,0.167289819463733,0
"<anonymized_userid>",10,56135,1567,"Thierry Baudet (FvD)",0.742781909122185,0.167396645657515,0
"<anonymized_userid>",10,56145,1568,"Thierry Baudet (FvD)",0.742914229761558,0.167503471851298,0
"<anonymized_userid>",10,56155,1569,"Thierry Baudet (FvD)",0.743046550400931,0.167610298045081,0
"<anonymized_userid>",10,56165,1570,"Thierry Baudet (FvD)",0.743178871040305,0.167717124238863,0
"<anonymized_userid>",10,56175,1571,"Thierry Baudet (FvD)",0.743311191679678,0.167823950432646,0
"<anonymized_userid>",10,56185,1572,"Thierry Baudet (FvD)",0.743443512319051,0.167930776626429,0
"<anonymized_userid>",10,56195,1573,"Thierry Baudet (FvD)",0.743575832958425,0.168037602820212,0
"<anonymized_userid>",10,56205,1574,"Thierry Baudet (FvD)",0.743708153597798,0.168144429013994,0
"<anonymized_userid>",10,56215,1575,"Thierry Baudet (FvD)",0.743840474237171,0.168251255207777,0
"<anonymized_userid>",10,56225,1576,"Thierry Baudet (FvD)",0.743972794876545,0.16835808140156,0
"<anonymized_userid>",10,56235,1577,"Thierry Baudet (FvD)",0.744105115515918,0.168464907595342,0
"<anonymized_userid>",10,56245,1578,"Thierry Baudet (FvD)",0.744237436155291,0.168571733789125,0
"<anonymized_userid>",10,56255,1579,"Thierry Baudet (FvD)",0.744369756794665,0.168678559982908,0
"<anonymized_userid>",10,56265,1580,"Thierry Baudet (FvD)",0.744502077434038,0.168785386176691,0
"<anonymized_userid>",10,56275,1581,"Thierry Baudet (FvD)",0.744634398073411,0.168892212370473,0
"<anonymized_userid>",10,56285,1582,"Thierry Baudet (FvD)",0.744766718712785,0.168999038564256,0
"<anonymized_userid>",10,56295,1583,"Thierry Baudet (FvD)",0.744899039352158,0.169105864758039,0
"<anonymized_userid>",10,56305,1584,"Thierry Baudet (FvD)",0.745031359991531,0.169212690951821,0
"<anonymized_userid>",10,56315,1585,"Thierry Baudet (FvD)",0.745163680630905,0.169319517145604,0
"<anonymized_userid>",10,56325,1586,"Thierry Baudet (FvD)",0.745296001270278,0.169426343339387,0
"<anonymized_userid>",10,56335,1587,"Thierry Baudet (FvD)",0.745428321909651,0.16953316953317,0
"<anonymized_userid>",10,56345,1588,"Thierry Baudet (FvD)",0.745560642549025,0.169639995726952,0
"<anonymized_userid>",10,56355,1589,"Thierry Baudet (FvD)",0.745692963188398,0.169746821920735,0
"<anonymized_userid>",10,56365,1590,"Thierry Baudet (FvD)",0.745825283827771,0.169853648114518,0
"<anonymized_userid>",10,56375,1591,"Thierry Baudet (FvD)",0.745957604467145,0.1699604743083,0
"<anonymized_userid>",10,56385,1592,"Thierry Baudet (FvD)",0.746089925106518,0.170067300502083,0
"<anonymized_userid>",10,56395,1593,"Thierry Baudet (FvD)",0.746222245745891,0.170174126695866,0
"<anonymized_userid>",10,56405,1594,"Thierry Baudet (FvD)",0.746354566385265,0.170280952889649,0
"<anonymized_userid>",10,56415,1595,"Thierry Baudet (FvD)",0.746486887024638,0.170387779083431,0
"<anonymized_userid>",10,56425,1596,"Thierry Baudet (FvD)",0.746619207664011,0.170494605277214,0
"<anonymized_userid>",10,56435,1597,"Thierry Baudet (FvD)",0.746751528303385,0.170601431470997,0
"<anonymized_userid>",10,56445,1598,"Thierry Baudet (FvD)",0.746883848942758,0.170708257664779,0
"<anonymized_userid>",10,56455,1599,"Thierry Baudet (FvD)",0.747016169582131,0.170815083858562,0
"<anonymized_userid>",10,56465,1600,"Thierry Baudet (FvD)",0.747148490221505,0.170921910052345,0
"<anonymized_userid>",10,56475,1601,"Thierry Baudet (FvD)",0.747280810860878,0.171028736246128,0
"<anonymized_userid>",10,56485,1602,"Thierry Baudet (FvD)",0.747413131500251,0.17113556243991,0
"<anonymized_userid>",10,56495,1603,"Thierry Baudet (FvD)",0.747545452139625,0.171242388633693,0
"<anonymized_userid>",10,56505,1604,"Thierry Baudet (FvD)",0.747677772778998,0.171349214827476,0
"<anonymized_userid>",10,56515,1605,"Thierry Baudet (FvD)",0.747810093418371,0.171456041021258,0
"<anonymized_userid>",10,56525,1606,"Thierry Baudet (FvD)",0.747942414057745,0.171562867215041,0
"<anonymized_userid>",10,56535,1607,"Thierry Baudet (FvD)",0.748074734697118,0.171669693408824,0
"<anonymized_userid>",10,56545,1608,"Thierry Baudet (FvD)",0.748207055336491,0.171776519602607,0
"<anonymized_userid>",10,56555,1609,"Thierry Baudet (FvD)",0.748339375975865,0.171883345796389,0
"<anonymized_userid>",10,56565,1610,"Thierry Baudet (FvD)",0.748471696615238,0.171990171990172,0
"<anonymized_userid>",10,56575,1611,"Thierry Baudet (FvD)",0.748604017254611,0.172096998183955,0
"<anonymized_userid>",10,56585,1612,"Thierry Baudet (FvD)",0.748736337893985,0.172203824377737,0
"<anonymized_userid>",10,56595,1613,"Thierry Baudet (FvD)",0.748868658533358,0.17231065057152,0
"<anonymized_userid>",10,56605,1614,"Thierry Baudet (FvD)",0.749000979172731,0.172417476765303,0
"<anonymized_userid>",10,56615,1615,"Thierry Baudet (FvD)",0.749133299812105,0.172524302959086,0
"<anonymized_userid>",10,56625,1616,"Thierry Baudet (FvD)",0.749265620451478,0.172631129152868,0
"<anonymized_userid>",10,56635,1617,"Thierry Baudet (FvD)",0.749397941090851,0.172737955346651,0
"<anonymized_userid>",10,56645,1618,"Thierry Baudet (FvD)",0.749530261730225,0.172844781540434,0
"<anonymized_userid>",10,56655,1619,"Thierry Baudet (FvD)",0.749662582369598,0.172951607734216,0
"<anonymized_userid>",10,56665,1620,"Thierry Baudet (FvD)",0.749794903008971,0.173058433927999,0
"<anonymized_userid>",10,56675,1621,"Thierry Baudet (FvD)",0.749927223648345,0.173165260121782,0
"<anonymized_userid>",10,56685,1622,"Thierry Baudet (FvD)",0.750059544287718,0.173272086315565,0
"<anonymized_userid>",10,56695,1623,"Thierry Baudet (FvD)",0.750191864927091,0.173378912509347,0
"<anonymized_userid>",10,56705,1624,"Thierry Baudet (FvD)",0.750324185566465,0.17348573870313,0
"<anonymized_userid>",10,56715,1625,"Thierry Baudet (FvD)",0.750456506205838,0.173592564896913,0
"<anonymized_userid>",10,56725,1626,"Thierry Baudet (FvD)",0.750588826845211,0.173699391090695,0
"<anonymized_userid>",10,56735,1627,"Thierry Baudet (FvD)",0.750721147484585,0.173806217284478,0
"<anonymized_userid>",10,56745,1628,"Thierry Baudet (FvD)",0.750853468123958,0.173913043478261,0
"<anonymized_userid>",10,56755,1629,"Thierry Baudet (FvD)",0.750985788763331,0.174019869672044,0
"<anonymized_userid>",10,56765,1630,"Thierry Baudet (FvD)",0.751118109402705,0.174126695865826,0
"<anonymized_userid>",10,56775,1631,"Thierry Baudet (FvD)",0.751250430042078,0.174233522059609,0
"<anonymized_userid>",10,56785,1632,"Thierry Baudet (FvD)",0.751382750681451,0.174340348253392,0
"<anonymized_userid>",10,56795,1633,"Thierry Baudet (FvD)",0.751515071320825,0.174447174447174,0
"<anonymized_userid>",10,56805,1634,"Thierry Baudet (FvD)",0.751647391960198,0.174554000640957,0
"<anonymized_userid>",10,56815,1635,"Thierry Baudet (FvD)",0.751779712599571,0.17466082683474,0
"<anonymized_userid>",10,56825,1636,"Thierry Baudet (FvD)",0.751912033238945,0.174767653028523,0
"<anonymized_userid>",10,56835,1637,"Thierry Baudet (FvD)",0.752044353878318,0.174874479222305,0
"<anonymized_userid>",10,56845,1638,"Thierry Baudet (FvD)",0.752176674517691,0.174981305416088,0
"<anonymized_userid>",10,56855,1639,"Thierry Baudet (FvD)",0.752308995157065,0.175088131609871,0
"<anonymized_userid>",10,56865,1640,"Thierry Baudet (FvD)",0.752441315796438,0.175194957803653,0
"<anonymized_userid>",10,56875,1641,"Thierry Baudet (FvD)",0.752573636435811,0.175301783997436,0
"<anonymized_userid>",10,56885,1642,"Thierry Baudet (FvD)",0.752705957075185,0.175408610191219,0
"<anonymized_userid>",10,56895,1643,"Thierry Baudet (FvD)",0.752838277714558,0.175515436385002,0
"<anonymized_userid>",10,56905,1644,"Thierry Baudet (FvD)",0.752970598353931,0.175622262578784,0
"<anonymized_userid>",10,56915,1645,"Thierry Baudet (FvD)",0.753102918993305,0.175729088772567,0
"<anonymized_userid>",10,56925,1646,"Thierry Baudet (FvD)",0.753235239632678,0.17583591496635,0
"<anonymized_userid>",10,56935,1647,"Thierry Baudet (FvD)",0.753367560272051,0.175942741160132,0
"<anonymized_userid>",10,56945,1648,"Thierry Baudet (FvD)",0.753499880911425,0.176049567353915,0
"<anonymized_userid>",10,56955,1649,"Thierry Baudet (FvD)",0.753632201550798,0.176156393547698,0
"<anonymized_userid>",10,56965,1650,"Thierry Baudet (FvD)",0.753764522190171,0.176263219741481,0
"<anonymized_userid>",10,56975,1651,"Thierry Baudet (FvD)",0.753896842829545,0.176370045935263,0
"<anonymized_userid>",10,56985,1652,"Thierry Baudet (FvD)",0.754029163468918,0.176476872129046,0
"<anonymized_userid>",10,56995,1653,"Thierry Baudet (FvD)",0.754161484108291,0.176583698322829,0
"<anonymized_userid>",10,57005,1654,"Thierry Baudet (FvD)",0.754293804747664,0.176690524516611,0
"<anonymized_userid>",10,57015,1655,"Thierry Baudet (FvD)",0.754426125387038,0.176797350710394,0
"<anonymized_userid>",10,57025,1656,"Thierry Baudet (FvD)",0.754558446026411,0.176904176904177,0
"<anonymized_userid>",10,57035,1657,"Thierry Baudet (FvD)",0.754690766665784,0.17701100309796,0
"<anonymized_userid>",10,57045,1658,"Thierry Baudet (FvD)",0.754823087305158,0.177117829291742,0
"<anonymized_userid>",9,57054,1659,"Thierry Baudet (FvD)",0.754942175880594,0.177224655485525,0
"<anonymized_userid>",9,57063,1660,"Thierry Baudet (FvD)",0.75506126445603,0.177331481679308,0
"<anonymized_userid>",9,57072,1661,"Thierry Baudet (FvD)",0.755180353031466,0.17743830787309,0
"<anonymized_userid>",9,57081,1662,"Thierry Baudet (FvD)",0.755299441606902,0.177545134066873,0
"<anonymized_userid>",9,57090,1663,"Thierry Baudet (FvD)",0.755418530182338,0.177651960260656,0
"<anonymized_userid>",9,57099,1664,"Thierry Baudet (FvD)",0.755537618757774,0.177758786454439,0
"<anonymized_userid>",9,57108,1665,"Thierry Baudet (FvD)",0.75565670733321,0.177865612648221,0
"<anonymized_userid>",9,57117,1666,"Thierry Baudet (FvD)",0.755775795908646,0.177972438842004,0
"<anonymized_userid>",9,57126,1667,"Thierry Baudet (FvD)",0.755894884484082,0.178079265035787,0
"<anonymized_userid>",9,57135,1668,"Thierry Baudet (FvD)",0.756013973059518,0.178186091229569,0
"<anonymized_userid>",9,57144,1669,"Thierry Baudet (FvD)",0.756133061634954,0.178292917423352,0
"<anonymized_userid>",9,57153,1670,"Thierry Baudet (FvD)",0.75625215021039,0.178399743617135,0
"<anonymized_userid>",9,57162,1671,"Thierry Baudet (FvD)",0.756371238785826,0.178506569810918,0
"<anonymized_userid>",9,57171,1672,"Thierry Baudet (FvD)",0.756490327361262,0.1786133960047,0
"<anonymized_userid>",9,57180,1673,"Thierry Baudet (FvD)",0.756609415936698,0.178720222198483,0
"<anonymized_userid>",9,57189,1674,"Thierry Baudet (FvD)",0.756728504512134,0.178827048392266,0
"<anonymized_userid>",9,57198,1675,"Thierry Baudet (FvD)",0.75684759308757,0.178933874586049,0
"<anonymized_userid>",9,57207,1676,"Thierry Baudet (FvD)",0.756966681663006,0.179040700779831,0
"<anonymized_userid>",9,57216,1677,"Thierry Baudet (FvD)",0.757085770238442,0.179147526973614,0
"<anonymized_userid>",9,57225,1678,"Thierry Baudet (FvD)",0.757204858813878,0.179254353167397,0
"<anonymized_userid>",9,57234,1679,"Thierry Baudet (FvD)",0.757323947389314,0.179361179361179,0
"<anonymized_userid>",9,57243,1680,"Thierry Baudet (FvD)",0.75744303596475,0.179468005554962,0
"<anonymized_userid>",9,57252,1681,"Thierry Baudet (FvD)",0.757562124540186,0.179574831748745,0
"<anonymized_userid>",9,57261,1682,"Thierry Baudet (FvD)",0.757681213115622,0.179681657942527,0
"<anonymized_userid>",9,57270,1683,"Thierry Baudet (FvD)",0.757800301691058,0.17978848413631,0
"<anonymized_userid>",9,57279,1684,"Thierry Baudet (FvD)",0.757919390266494,0.179895310330093,0
"<anonymized_userid>",9,57288,1685,"Thierry Baudet (FvD)",0.75803847884193,0.180002136523876,0
"<anonymized_userid>",9,57297,1686,"Thierry Baudet (FvD)",0.758157567417366,0.180108962717658,0
"<anonymized_userid>",9,57306,1687,"Thierry Baudet (FvD)",0.758276655992802,0.180215788911441,0
"<anonymized_userid>",9,57315,1688,"Thierry Baudet (FvD)",0.758395744568238,0.180322615105224,0
"<anonymized_userid>",9,57324,1689,"Thierry Baudet (FvD)",0.758514833143674,0.180429441299007,0
"<anonymized_userid>",9,57333,1690,"Thierry Baudet (FvD)",0.75863392171911,0.180536267492789,0
"<anonymized_userid>",9,57342,1691,"Thierry Baudet (FvD)",0.758753010294546,0.180643093686572,0
"<anonymized_userid>",9,57351,1692,"Thierry Baudet (FvD)",0.758872098869982,0.180749919880355,0
"<anonymized_userid>",9,57360,1693,"Thierry Baudet (FvD)",0.758991187445418,0.180856746074137,0
"<anonymized_userid>",9,57369,1694,"Thierry Baudet (FvD)",0.759110276020854,0.18096357226792,0
"<anonymized_userid>",9,57378,1695,"Thierry Baudet (FvD)",0.75922936459629,0.181070398461703,0
"<anonymized_userid>",9,57387,1696,"Thierry Baudet (FvD)",0.759348453171726,0.181177224655486,0
"<anonymized_userid>",9,57396,1697,"Thierry Baudet (FvD)",0.759467541747162,0.181284050849268,0
"<anonymized_userid>",9,57405,1698,"Thierry Baudet (FvD)",0.759586630322598,0.181390877043051,0
"<anonymized_userid>",9,57414,1699,"Thierry Baudet (FvD)",0.759705718898034,0.181497703236834,0
"<anonymized_userid>",9,57423,1700,"Thierry Baudet (FvD)",0.75982480747347,0.181604529430616,0
"<anonymized_userid>",9,57432,1701,"Thierry Baudet (FvD)",0.759943896048906,0.181711355624399,0
"<anonymized_userid>",9,57441,1702,"Thierry Baudet (FvD)",0.760062984624342,0.181818181818182,0
"<anonymized_userid>",9,57450,1703,"Thierry Baudet (FvD)",0.760182073199778,0.181925008011965,0
"<anonymized_userid>",9,57459,1704,"Thierry Baudet (FvD)",0.760301161775214,0.182031834205747,0
"<anonymized_userid>",9,57468,1705,"Thierry Baudet (FvD)",0.76042025035065,0.18213866039953,0
"<anonymized_userid>",9,57477,1706,"Thierry Baudet (FvD)",0.760539338926086,0.182245486593313,0
"<anonymized_userid>",9,57486,1707,"Thierry Baudet (FvD)",0.760658427501522,0.182352312787095,0
"<anonymized_userid>",9,57495,1708,"Thierry Baudet (FvD)",0.760777516076958,0.182459138980878,0
"<anonymized_userid>",9,57504,1709,"Thierry Baudet (FvD)",0.760896604652394,0.182565965174661,0
"<anonymized_userid>",9,57513,1710,"Thierry Baudet (FvD)",0.76101569322783,0.182672791368444,0
"<anonymized_userid>",9,57522,1711,"Thierry Baudet (FvD)",0.761134781803266,0.182779617562226,0
"<anonymized_userid>",9,57531,1712,"Thierry Baudet (FvD)",0.761253870378702,0.182886443756009,0
"<anonymized_userid>",9,57540,1713,"Thierry Baudet (FvD)",0.761372958954138,0.182993269949792,0
"<anonymized_userid>",9,57549,1714,"Thierry Baudet (FvD)",0.761492047529574,0.183100096143574,0
"<anonymized_userid>",9,57558,1715,"Thierry Baudet (FvD)",0.76161113610501,0.183206922337357,0
"<anonymized_userid>",9,57567,1716,"Thierry Baudet (FvD)",0.761730224680446,0.18331374853114,0
"<anonymized_userid>",9,57576,1717,"Thierry Baudet (FvD)",0.761849313255882,0.183420574724923,0
"<anonymized_userid>",9,57585,1718,"Thierry Baudet (FvD)",0.761968401831318,0.183527400918705,0
"<anonymized_userid>",9,57594,1719,"Thierry Baudet (FvD)",0.762087490406754,0.183634227112488,0
"<anonymized_userid>",9,57603,1720,"Thierry Baudet (FvD)",0.76220657898219,0.183741053306271,0
"<anonymized_userid>",9,57612,1721,"Thierry Baudet (FvD)",0.762325667557626,0.183847879500053,0
"<anonymized_userid>",9,57621,1722,"Thierry Baudet (FvD)",0.762444756133062,0.183954705693836,0
"<anonymized_userid>",9,57630,1723,"Thierry Baudet (FvD)",0.762563844708498,0.184061531887619,0
"<anonymized_userid>",9,57639,1724,"Thierry Baudet (FvD)",0.762682933283934,0.184168358081402,0
"<anonymized_userid>",9,57648,1725,"Thierry Baudet (FvD)",0.76280202185937,0.184275184275184,0
"<anonymized_userid>",9,57657,1726,"Thierry Baudet (FvD)",0.762921110434806,0.184382010468967,0
"<anonymized_userid>",9,57666,1727,"Thierry Baudet (FvD)",0.763040199010242,0.18448883666275,0
"<anonymized_userid>",9,57675,1728,"Thierry Baudet (FvD)",0.763159287585678,0.184595662856532,0
"<anonymized_userid>",9,57684,1729,"Thierry Baudet (FvD)",0.763278376161114,0.184702489050315,0
"<anonymized_userid>",9,57693,1730,"Thierry Baudet (FvD)",0.76339746473655,0.184809315244098,0
"<anonymized_userid>",9,57702,1731,"Thierry Baudet (FvD)",0.763516553311986,0.184916141437881,0
"<anonymized_userid>",9,57711,1732,"Thierry Baudet (FvD)",0.763635641887422,0.185022967631663,0
"<anonymized_userid>",9,57720,1733,"Thierry Baudet (FvD)",0.763754730462858,0.185129793825446,0
"<anonymized_userid>",9,57729,1734,"Thierry Baudet (FvD)",0.763873819038294,0.185236620019229,0
"<anonymized_userid>",9,57738,1735,"Thierry Baudet (FvD)",0.76399290761373,0.185343446213011,0
"<anonymized_userid>",9,57747,1736,"Thierry Baudet (FvD)",0.764111996189166,0.185450272406794,0
"<anonymized_userid>",9,57756,1737,"Thierry Baudet (FvD)",0.764231084764602,0.185557098600577,0
"<anonymized_userid>",9,57765,1738,"Thierry Baudet (FvD)",0.764350173340038,0.18566392479436,0
"<anonymized_userid>",9,57774,1739,"Thierry Baudet (FvD)",0.764469261915474,0.185770750988142,0
"<anonymized_userid>",9,57783,1740,"Thierry Baudet (FvD)",0.76458835049091,0.185877577181925,0
"<anonymized_userid>",9,57792,1741,"Thierry Baudet (FvD)",0.764707439066346,0.185984403375708,0
"<anonymized_userid>",9,57801,1742,"Thierry Baudet (FvD)",0.764826527641782,0.18609122956949,0
"<anonymized_userid>",9,57810,1743,"Thierry Baudet (FvD)",0.764945616217218,0.186198055763273,0
"<anonymized_userid>",9,57819,1744,"Thierry Baudet (FvD)",0.765064704792654,0.186304881957056,0
"<anonymized_userid>",9,57828,1745,"Thierry Baudet (FvD)",0.76518379336809,0.186411708150839,0
"<anonymized_userid>",9,57837,1746,"Thierry Baudet (FvD)",0.765302881943526,0.186518534344621,0
"<anonymized_userid>",9,57846,1747,"Thierry Baudet (FvD)",0.765421970518962,0.186625360538404,0
"<anonymized_userid>",9,57855,1748,"Thierry Baudet (FvD)",0.765541059094398,0.186732186732187,0
"<anonymized_userid>",9,57864,1749,"Thierry Baudet (FvD)",0.765660147669834,0.186839012925969,0
"<anonymized_userid>",9,57873,1750,"Thierry Baudet (FvD)",0.76577923624527,0.186945839119752,0
"<anonymized_userid>",9,57882,1751,"Thierry Baudet (FvD)",0.765898324820706,0.187052665313535,0
"<anonymized_userid>",9,57891,1752,"Thierry Baudet (FvD)",0.766017413396141,0.187159491507318,0
"<anonymized_userid>",9,57900,1753,"Thierry Baudet (FvD)",0.766136501971578,0.1872663177011,0
"<anonymized_userid>",9,57909,1754,"Thierry Baudet (FvD)",0.766255590547014,0.187373143894883,0
"<anonymized_userid>",9,57918,1755,"Thierry Baudet (FvD)",0.766374679122449,0.187479970088666,0
"<anonymized_userid>",9,57927,1756,"Thierry Baudet (FvD)",0.766493767697885,0.187586796282448,0
"<anonymized_userid>",9,57936,1757,"Thierry Baudet (FvD)",0.766612856273322,0.187693622476231,0
"<anonymized_userid>",9,57945,1758,"Thierry Baudet (FvD)",0.766731944848758,0.187800448670014,0
"<anonymized_userid>",9,57954,1759,"Thierry Baudet (FvD)",0.766851033424193,0.187907274863797,0
"<anonymized_userid>",9,57963,1760,"Thierry Baudet (FvD)",0.76697012199963,0.188014101057579,0
"<anonymized_userid>",9,57972,1761,"Thierry Baudet (FvD)",0.767089210575066,0.188120927251362,0
"<anonymized_userid>",9,57981,1762,"Thierry Baudet (FvD)",0.767208299150501,0.188227753445145,0
"<anonymized_userid>",9,57990,1763,"Thierry Baudet (FvD)",0.767327387725937,0.188334579638927,0
"<anonymized_userid>",9,57999,1764,"Thierry Baudet (FvD)",0.767446476301374,0.18844140583271,0
"<anonymized_userid>",9,58008,1765,"Thierry Baudet (FvD)",0.767565564876809,0.188548232026493,0
"<anonymized_userid>",9,58017,1766,"Thierry Baudet (FvD)",0.767684653452245,0.188655058220276,0
"<anonymized_userid>",9,58026,1767,"Thierry Baudet (FvD)",0.767803742027681,0.188761884414058,0
"<anonymized_userid>",9,58035,1768,"Thierry Baudet (FvD)",0.767922830603118,0.188868710607841,0
"<anonymized_userid>",9,58044,1769,"Thierry Baudet (FvD)",0.768041919178553,0.188975536801624,0
"<anonymized_userid>",9,58053,1770,"Thierry Baudet (FvD)",0.768161007753989,0.189082362995406,0
"<anonymized_userid>",9,58062,1771,"Thierry Baudet (FvD)",0.768280096329426,0.189189189189189,0
"<anonymized_userid>",9,58071,1772,"Thierry Baudet (FvD)",0.768399184904861,0.189296015382972,0
"<anonymized_userid>",9,58080,1773,"Thierry Baudet (FvD)",0.768518273480297,0.189402841576755,0
"<anonymized_userid>",9,58089,1774,"Thierry Baudet (FvD)",0.768637362055733,0.189509667770537,0
"<anonymized_userid>",9,58098,1775,"Thierry Baudet (FvD)",0.768756450631169,0.18961649396432,0
"<anonymized_userid>",9,58107,1776,"Thierry Baudet (FvD)",0.768875539206605,0.189723320158103,0
"<anonymized_userid>",9,58116,1777,"Thierry Baudet (FvD)",0.768994627782041,0.189830146351885,0
"<anonymized_userid>",9,58125,1778,"Thierry Baudet (FvD)",0.769113716357477,0.189936972545668,0
"<anonymized_userid>",9,58134,1779,"Thierry Baudet (FvD)",0.769232804932913,0.190043798739451,0
"<anonymized_userid>",9,58143,1780,"Thierry Baudet (FvD)",0.769351893508349,0.190150624933234,0
"<anonymized_userid>",9,58152,1781,"Thierry Baudet (FvD)",0.769470982083785,0.190257451127016,0
"<anonymized_userid>",9,58161,1782,"Thierry Baudet (FvD)",0.769590070659221,0.190364277320799,0
"<anonymized_userid>",9,58170,1783,"Thierry Baudet (FvD)",0.769709159234657,0.190471103514582,0
"<anonymized_userid>",9,58179,1784,"Thierry Baudet (FvD)",0.769828247810093,0.190577929708364,0
"<anonymized_userid>",9,58188,1785,"Thierry Baudet (FvD)",0.769947336385529,0.190684755902147,0
"<anonymized_userid>",9,58197,1786,"Thierry Baudet (FvD)",0.770066424960965,0.19079158209593,0
"<anonymized_userid>",9,58206,1787,"Thierry Baudet (FvD)",0.770185513536401,0.190898408289713,0
"<anonymized_userid>",9,58215,1788,"Thierry Baudet (FvD)",0.770304602111837,0.191005234483495,0
"<anonymized_userid>",9,58224,1789,"Thierry Baudet (FvD)",0.770423690687273,0.191112060677278,0
"<anonymized_userid>",9,58233,1790,"Thierry Baudet (FvD)",0.770542779262709,0.191218886871061,0
"<anonymized_userid>",9,58242,1791,"Thierry Baudet (FvD)",0.770661867838145,0.191325713064844,0
"<anonymized_userid>",9,58251,1792,"Thierry Baudet (FvD)",0.770780956413581,0.191432539258626,0
"<anonymized_userid>",9,58260,1793,"Thierry Baudet (FvD)",0.770900044989017,0.191539365452409,0
"<anonymized_userid>",9,58269,1794,"Thierry Baudet (FvD)",0.771019133564453,0.191646191646192,0
"<anonymized_userid>",9,58278,1795,"Thierry Baudet (FvD)",0.771138222139889,0.191753017839974,0
"<anonymized_userid>",9,58287,1796,"Thierry Baudet (FvD)",0.771257310715325,0.191859844033757,0
"<anonymized_userid>",9,58296,1797,"Thierry Baudet (FvD)",0.771376399290761,0.19196667022754,0
"<anonymized_userid>",9,58305,1798,"Thierry Baudet (FvD)",0.771495487866197,0.192073496421323,0
"<anonymized_userid>",9,58314,1799,"Thierry Baudet (FvD)",0.771614576441633,0.192180322615105,0
"<anonymized_userid>",9,58323,1800,"Thierry Baudet (FvD)",0.771733665017069,0.192287148808888,0
"<anonymized_userid>",9,58332,1801,"Thierry Baudet (FvD)",0.771852753592505,0.192393975002671,0
"<anonymized_userid>",9,58341,1802,"Thierry Baudet (FvD)",0.771971842167941,0.192500801196453,0
"<anonymized_userid>",9,58350,1803,"Thierry Baudet (FvD)",0.772090930743377,0.192607627390236,0
"<anonymized_userid>",9,58359,1804,"Thierry Baudet (FvD)",0.772210019318813,0.192714453584019,0
"<anonymized_userid>",9,58368,1805,"Thierry Baudet (FvD)",0.772329107894249,0.192821279777802,0
"<anonymized_userid>",9,58377,1806,"Thierry Baudet (FvD)",0.772448196469685,0.192928105971584,0
"<anonymized_userid>",9,58386,1807,"Thierry Baudet (FvD)",0.772567285045121,0.193034932165367,0
"<anonymized_userid>",9,58395,1808,"Thierry Baudet (FvD)",0.772686373620557,0.19314175835915,0
"<anonymized_userid>",9,58404,1809,"Thierry Baudet (FvD)",0.772805462195993,0.193248584552932,0
"<anonymized_userid>",9,58413,1810,"Thierry Baudet (FvD)",0.772924550771429,0.193355410746715,0
"<anonymized_userid>",9,58422,1811,"Thierry Baudet (FvD)",0.773043639346865,0.193462236940498,0
"<anonymized_userid>",9,58431,1812,"Thierry Baudet (FvD)",0.773162727922301,0.193569063134281,0
"<anonymized_userid>",9,58440,1813,"Thierry Baudet (FvD)",0.773281816497737,0.193675889328063,0
"<anonymized_userid>",9,58449,1814,"Thierry Baudet (FvD)",0.773400905073173,0.193782715521846,0
"<anonymized_userid>",9,58458,1815,"Thierry Baudet (FvD)",0.773519993648609,0.193889541715629,0
"<anonymized_userid>",9,58467,1816,"Thierry Baudet (FvD)",0.773639082224045,0.193996367909411,0
"<anonymized_userid>",9,58476,1817,"Thierry Baudet (FvD)",0.773758170799481,0.194103194103194,0
"<anonymized_userid>",9,58485,1818,"Thierry Baudet (FvD)",0.773877259374917,0.194210020296977,0
"<anonymized_userid>",9,58494,1819,"Thierry Baudet (FvD)",0.773996347950353,0.19431684649076,0
"<anonymized_userid>",9,58503,1820,"Thierry Baudet (FvD)",0.774115436525789,0.194423672684542,0
"<anonymized_userid>",9,58512,1821,"Thierry Baudet (FvD)",0.774234525101225,0.194530498878325,0
"<anonymized_userid>",9,58521,1822,"Thierry Baudet (FvD)",0.774353613676661,0.194637325072108,0
"<anonymized_userid>",9,58530,1823,"Thierry Baudet (FvD)",0.774472702252097,0.19474415126589,0
"<anonymized_userid>",9,58539,1824,"Thierry Baudet (FvD)",0.774591790827533,0.194850977459673,0
"<anonymized_userid>",9,58548,1825,"Thierry Baudet (FvD)",0.774710879402969,0.194957803653456,0
"<anonymized_userid>",9,58557,1826,"Thierry Baudet (FvD)",0.774829967978405,0.195064629847239,0
"<anonymized_userid>",8,58565,1827,"Thierry Baudet (FvD)",0.774935824489904,0.195171456041021,0
"<anonymized_userid>",8,58573,1828,"Thierry Baudet (FvD)",0.775041681001403,0.195278282234804,0
"<anonymized_userid>",8,58581,1829,"Thierry Baudet (FvD)",0.775147537512901,0.195385108428587,0
"<anonymized_userid>",8,58589,1830,"Thierry Baudet (FvD)",0.7752533940244,0.195491934622369,0
"<anonymized_userid>",8,58597,1831,"Thierry Baudet (FvD)",0.775359250535899,0.195598760816152,0
"<anonymized_userid>",8,58605,1832,"Thierry Baudet (FvD)",0.775465107047397,0.195705587009935,0
"<anonymized_userid>",8,58613,1833,"Thierry Baudet (FvD)",0.775570963558896,0.195812413203718,0
"<anonymized_userid>",8,58621,1834,"Thierry Baudet (FvD)",0.775676820070395,0.1959192393975,0
"<anonymized_userid>",8,58629,1835,"Thierry Baudet (FvD)",0.775782676581893,0.196026065591283,0
"<anonymized_userid>",8,58637,1836,"Thierry Baudet (FvD)",0.775888533093392,0.196132891785066,0
"<anonymized_userid>",8,58645,1837,"Thierry Baudet (FvD)",0.775994389604891,0.196239717978848,0
"<anonymized_userid>",8,58653,1838,"Thierry Baudet (FvD)",0.776100246116389,0.196346544172631,0
"<anonymized_userid>",8,58661,1839,"Thierry Baudet (FvD)",0.776206102627888,0.196453370366414,0
"<anonymized_userid>",8,58669,1840,"Thierry Baudet (FvD)",0.776311959139387,0.196560196560197,0
"<anonymized_userid>",8,58677,1841,"Thierry Baudet (FvD)",0.776417815650885,0.196667022753979,0
"<anonymized_userid>",8,58685,1842,"Thierry Baudet (FvD)",0.776523672162384,0.196773848947762,0
"<anonymized_userid>",8,58693,1843,"Thierry Baudet (FvD)",0.776629528673883,0.196880675141545,0
"<anonymized_userid>",8,58701,1844,"Thierry Baudet (FvD)",0.776735385185381,0.196987501335327,0
"<anonymized_userid>",8,58709,1845,"Thierry Baudet (FvD)",0.77684124169688,0.19709432752911,0
"<anonymized_userid>",8,58717,1846,"Thierry Baudet (FvD)",0.776947098208379,0.197201153722893,0
"<anonymized_userid>",8,58725,1847,"Thierry Baudet (FvD)",0.777052954719877,0.197307979916676,0
"<anonymized_userid>",8,58733,1848,"Thierry Baudet (FvD)",0.777158811231376,0.197414806110458,0
"<anonymized_userid>",8,58741,1849,"Thierry Baudet (FvD)",0.777264667742875,0.197521632304241,0
"<anonymized_userid>",8,58749,1850,"Thierry Baudet (FvD)",0.777370524254373,0.197628458498024,0
"<anonymized_userid>",8,58757,1851,"Thierry Baudet (FvD)",0.777476380765872,0.197735284691806,0
"<anonymized_userid>",8,58765,1852,"Thierry Baudet (FvD)",0.777582237277371,0.197842110885589,0
"<anonymized_userid>",8,58773,1853,"Thierry Baudet (FvD)",0.777688093788869,0.197948937079372,0
"<anonymized_userid>",8,58781,1854,"Thierry Baudet (FvD)",0.777793950300368,0.198055763273155,0
"<anonymized_userid>",8,58789,1855,"Thierry Baudet (FvD)",0.777899806811867,0.198162589466937,0
"<anonymized_userid>",8,58797,1856,"Thierry Baudet (FvD)",0.778005663323365,0.19826941566072,0
"<anonymized_userid>",8,58805,1857,"Thierry Baudet (FvD)",0.778111519834864,0.198376241854503,0
"<anonymized_userid>",8,58813,1858,"Thierry Baudet (FvD)",0.778217376346362,0.198483068048285,0
"<anonymized_userid>",8,58821,1859,"Thierry Baudet (FvD)",0.778323232857861,0.198589894242068,0
"<anonymized_userid>",8,58829,1860,"Thierry Baudet (FvD)",0.77842908936936,0.198696720435851,0
"<anonymized_userid>",8,58837,1861,"Thierry Baudet (FvD)",0.778534945880858,0.198803546629634,0
"<anonymized_userid>",8,58845,1862,"Thierry Baudet (FvD)",0.778640802392357,0.198910372823416,0
"<anonymized_userid>",8,58853,1863,"Thierry Baudet (FvD)",0.778746658903856,0.199017199017199,0
"<anonymized_userid>",8,58861,1864,"Thierry Baudet (FvD)",0.778852515415354,0.199124025210982,0
"<anonymized_userid>",8,58869,1865,"Thierry Baudet (FvD)",0.778958371926853,0.199230851404764,0
"<anonymized_userid>",8,58877,1866,"Thierry Baudet (FvD)",0.779064228438352,0.199337677598547,0
"<anonymized_userid>",8,58885,1867,"Thierry Baudet (FvD)",0.779170084949851,0.19944450379233,0
"<anonymized_userid>",8,58893,1868,"Thierry Baudet (FvD)",0.779275941461349,0.199551329986113,0
"<anonymized_userid>",8,58901,1869,"Thierry Baudet (FvD)",0.779381797972848,0.199658156179895,0
"<anonymized_userid>",8,58909,1870,"Thierry Baudet (FvD)",0.779487654484346,0.199764982373678,0
"<anonymized_userid>",8,58917,1871,"Thierry Baudet (FvD)",0.779593510995845,0.199871808567461,0
"<anonymized_userid>",8,58925,1872,"Thierry Baudet (FvD)",0.779699367507344,0.199978634761243,0
"<anonymized_userid>",8,58933,1873,"Thierry Baudet (FvD)",0.779805224018842,0.200085460955026,0
"<anonymized_userid>",8,58941,1874,"Thierry Baudet (FvD)",0.779911080530341,0.200192287148809,0
"<anonymized_userid>",8,58949,1875,"Thierry Baudet (FvD)",0.78001693704184,0.200299113342592,0
"<anonymized_userid>",8,58957,1876,"Thierry Baudet (FvD)",0.780122793553338,0.200405939536374,0
"<anonymized_userid>",8,58965,1877,"Thierry Baudet (FvD)",0.780228650064837,0.200512765730157,0
"<anonymized_userid>",8,58973,1878,"Thierry Baudet (FvD)",0.780334506576336,0.20061959192394,0
"<anonymized_userid>",8,58981,1879,"Thierry Baudet (FvD)",0.780440363087834,0.200726418117722,0
"<anonymized_userid>",8,58989,1880,"Thierry Baudet (FvD)",0.780546219599333,0.200833244311505,0
"<anonymized_userid>",8,58997,1881,"Thierry Baudet (FvD)",0.780652076110832,0.200940070505288,0
"<anonymized_userid>",8,59005,1882,"Thierry Baudet (FvD)",0.78075793262233,0.201046896699071,0
"<anonymized_userid>",8,59013,1883,"Thierry Baudet (FvD)",0.780863789133829,0.201153722892853,0
"<anonymized_userid>",8,59021,1884,"Thierry Baudet (FvD)",0.780969645645328,0.201260549086636,0
"<anonymized_userid>",8,59029,1885,"Thierry Baudet (FvD)",0.781075502156826,0.201367375280419,0
"<anonymized_userid>",8,59037,1886,"Thierry Baudet (FvD)",0.781181358668325,0.201474201474201,0
"<anonymized_userid>",8,59045,1887,"Thierry Baudet (FvD)",0.781287215179824,0.201581027667984,0
"<anonymized_userid>",8,59053,1888,"Thierry Baudet (FvD)",0.781393071691322,0.201687853861767,0
"<anonymized_userid>",8,59061,1889,"Thierry Baudet (FvD)",0.781498928202821,0.20179468005555,0
"<anonymized_userid>",8,59069,1890,"Thierry Baudet (FvD)",0.78160478471432,0.201901506249332,0
"<anonymized_userid>",8,59077,1891,"Thierry Baudet (FvD)",0.781710641225818,0.202008332443115,0
"<anonymized_userid>",8,59085,1892,"Thierry Baudet (FvD)",0.781816497737317,0.202115158636898,0
"<anonymized_userid>",8,59093,1893,"Thierry Baudet (FvD)",0.781922354248816,0.20222198483068,0
"<anonymized_userid>",8,59101,1894,"Thierry Baudet (FvD)",0.782028210760314,0.202328811024463,0
"<anonymized_userid>",8,59109,1895,"Thierry Baudet (FvD)",0.782134067271813,0.202435637218246,0
"<anonymized_userid>",8,59117,1896,"Thierry Baudet (FvD)",0.782239923783312,0.202542463412029,0
"<anonymized_userid>",8,59125,1897,"Thierry Baudet (FvD)",0.78234578029481,0.202649289605811,0
"<anonymized_userid>",8,59133,1898,"Thierry Baudet (FvD)",0.782451636806309,0.202756115799594,0
"<anonymized_userid>",8,59141,1899,"Thierry Baudet (FvD)",0.782557493317808,0.202862941993377,0
"<anonymized_userid>",8,59149,1900,"Thierry Baudet (FvD)",0.782663349829306,0.20296976818716,0
"<anonymized_userid>",8,59157,1901,"Thierry Baudet (FvD)",0.782769206340805,0.203076594380942,0
"<anonymized_userid>",8,59165,1902,"Thierry Baudet (FvD)",0.782875062852304,0.203183420574725,0
"<anonymized_userid>",8,59173,1903,"Thierry Baudet (FvD)",0.782980919363802,0.203290246768508,0
"<anonymized_userid>",8,59181,1904,"Thierry Baudet (FvD)",0.783086775875301,0.20339707296229,0
"<anonymized_userid>",8,59189,1905,"Thierry Baudet (FvD)",0.7831926323868,0.203503899156073,0
"<anonymized_userid>",8,59197,1906,"Thierry Baudet (FvD)",0.783298488898298,0.203610725349856,0
"<anonymized_userid>",8,59205,1907,"Thierry Baudet (FvD)",0.783404345409797,0.203717551543638,0
"<anonymized_userid>",8,59213,1908,"Thierry Baudet (FvD)",0.783510201921296,0.203824377737421,0
"<anonymized_userid>",8,59221,1909,"Thierry Baudet (FvD)",0.783616058432794,0.203931203931204,0
"<anonymized_userid>",8,59229,1910,"Thierry Baudet (FvD)",0.783721914944293,0.204038030124987,0
"<anonymized_userid>",8,59237,1911,"Thierry Baudet (FvD)",0.783827771455792,0.204144856318769,0
"<anonymized_userid>",8,59245,1912,"Thierry Baudet (FvD)",0.78393362796729,0.204251682512552,0
"<anonymized_userid>",8,59253,1913,"Thierry Baudet (FvD)",0.784039484478789,0.204358508706335,0
"<anonymized_userid>",8,59261,1914,"Thierry Baudet (FvD)",0.784145340990288,0.204465334900118,0
"<anonymized_userid>",8,59269,1915,"Thierry Baudet (FvD)",0.784251197501786,0.2045721610939,0
"<anonymized_userid>",8,59277,1916,"Thierry Baudet (FvD)",0.784357054013285,0.204678987287683,0
"<anonymized_userid>",8,59285,1917,"Thierry Baudet (FvD)",0.784462910524784,0.204785813481466,0
"<anonymized_userid>",8,59293,1918,"Thierry Baudet (FvD)",0.784568767036282,0.204892639675248,0
"<anonymized_userid>",8,59301,1919,"Thierry Baudet (FvD)",0.784674623547781,0.204999465869031,0
"<anonymized_userid>",8,59309,1920,"Thierry Baudet (FvD)",0.78478048005928,0.205106292062814,0
"<anonymized_userid>",8,59317,1921,"Thierry Baudet (FvD)",0.784886336570778,0.205213118256597,0
"<anonymized_userid>",8,59325,1922,"Thierry Baudet (FvD)",0.784992193082277,0.205319944450379,0
"<anonymized_userid>",8,59333,1923,"Thierry Baudet (FvD)",0.785098049593776,0.205426770644162,0
"<anonymized_userid>",8,59341,1924,"Thierry Baudet (FvD)",0.785203906105274,0.205533596837945,0
"<anonymized_userid>",8,59349,1925,"Thierry Baudet (FvD)",0.785309762616773,0.205640423031727,0
"<anonymized_userid>",8,59357,1926,"Thierry Baudet (FvD)",0.785415619128272,0.20574724922551,0
"<anonymized_userid>",8,59365,1927,"Thierry Baudet (FvD)",0.78552147563977,0.205854075419293,0
"<anonymized_userid>",8,59373,1928,"Thierry Baudet (FvD)",0.785627332151269,0.205960901613076,0
"<anonymized_userid>",8,59381,1929,"Thierry Baudet (FvD)",0.785733188662768,0.206067727806858,0
"<anonymized_userid>",8,59389,1930,"Thierry Baudet (FvD)",0.785839045174266,0.206174554000641,0
"<anonymized_userid>",8,59397,1931,"Thierry Baudet (FvD)",0.785944901685765,0.206281380194424,0
"<anonymized_userid>",8,59405,1932,"Thierry Baudet (FvD)",0.786050758197264,0.206388206388206,0
"<anonymized_userid>",8,59413,1933,"Thierry Baudet (FvD)",0.786156614708762,0.206495032581989,0
"<anonymized_userid>",8,59421,1934,"Thierry Baudet (FvD)",0.786262471220261,0.206601858775772,0
"<anonymized_userid>",8,59429,1935,"Thierry Baudet (FvD)",0.78636832773176,0.206708684969555,0
"<anonymized_userid>",8,59437,1936,"Thierry Baudet (FvD)",0.786474184243258,0.206815511163337,0
"<anonymized_userid>",8,59445,1937,"Thierry Baudet (FvD)",0.786580040754757,0.20692233735712,0
"<anonymized_userid>",8,59453,1938,"Thierry Baudet (FvD)",0.786685897266256,0.207029163550903,0
"<anonymized_userid>",8,59461,1939,"Thierry Baudet (FvD)",0.786791753777754,0.207135989744685,0
"<anonymized_userid>",8,59469,1940,"Thierry Baudet (FvD)",0.786897610289253,0.207242815938468,0
"<anonymized_userid>",8,59477,1941,"Thierry Baudet (FvD)",0.787003466800752,0.207349642132251,0
"<anonymized_userid>",8,59485,1942,"Thierry Baudet (FvD)",0.78710932331225,0.207456468326034,0
"<anonymized_userid>",8,59493,1943,"Thierry Baudet (FvD)",0.787215179823749,0.207563294519816,0
"<anonymized_userid>",8,59501,1944,"Thierry Baudet (FvD)",0.787321036335248,0.207670120713599,0
"<anonymized_userid>",8,59509,1945,"Thierry Baudet (FvD)",0.787426892846746,0.207776946907382,0
"<anonymized_userid>",8,59517,1946,"Thierry Baudet (FvD)",0.787532749358245,0.207883773101164,0
"<anonymized_userid>",8,59525,1947,"Thierry Baudet (FvD)",0.787638605869744,0.207990599294947,0
"<anonymized_userid>",8,59533,1948,"Thierry Baudet (FvD)",0.787744462381242,0.20809742548873,0
"<anonymized_userid>",8,59541,1949,"Thierry Baudet (FvD)",0.787850318892741,0.208204251682513,0
"<anonymized_userid>",8,59549,1950,"Thierry Baudet (FvD)",0.78795617540424,0.208311077876295,0
"<anonymized_userid>",8,59557,1951,"Thierry Baudet (FvD)",0.788062031915738,0.208417904070078,0
"<anonymized_userid>",8,59565,1952,"Thierry Baudet (FvD)",0.788167888427237,0.208524730263861,0
"<anonymized_userid>",8,59573,1953,"Thierry Baudet (FvD)",0.788273744938736,0.208631556457643,0
"<anonymized_userid>",8,59581,1954,"Thierry Baudet (FvD)",0.788379601450234,0.208738382651426,0
"<anonymized_userid>",8,59589,1955,"Thierry Baudet (FvD)",0.788485457961733,0.208845208845209,0
"<anonymized_userid>",8,59597,1956,"Thierry Baudet (FvD)",0.788591314473231,0.208952035038992,0
"<anonymized_userid>",8,59605,1957,"Thierry Baudet (FvD)",0.78869717098473,0.209058861232774,0
"<anonymized_userid>",8,59613,1958,"Thierry Baudet (FvD)",0.788803027496229,0.209165687426557,0
"<anonymized_userid>",8,59621,1959,"Thierry Baudet (FvD)",0.788908884007728,0.20927251362034,0
"<anonymized_userid>",8,59629,1960,"Thierry Baudet (FvD)",0.789014740519226,0.209379339814122,0
"<anonymized_userid>",8,59637,1961,"Thierry Baudet (FvD)",0.789120597030725,0.209486166007905,0
"<anonymized_userid>",8,59645,1962,"Thierry Baudet (FvD)",0.789226453542224,0.209592992201688,0
"<anonymized_userid>",8,59653,1963,"Thierry Baudet (FvD)",0.789332310053722,0.209699818395471,0
"<anonymized_userid>",8,59661,1964,"Thierry Baudet (FvD)",0.789438166565221,0.209806644589253,0
"<anonymized_userid>",8,59669,1965,"Thierry Baudet (FvD)",0.78954402307672,0.209913470783036,0
"<anonymized_userid>",8,59677,1966,"Thierry Baudet (FvD)",0.789649879588218,0.210020296976819,0
"<anonymized_userid>",8,59685,1967,"Thierry Baudet (FvD)",0.789755736099717,0.210127123170601,0
"<anonymized_userid>",8,59693,1968,"Thierry Baudet (FvD)",0.789861592611215,0.210233949364384,0
"<anonymized_userid>",8,59701,1969,"Thierry Baudet (FvD)",0.789967449122714,0.210340775558167,0
"<anonymized_userid>",8,59709,1970,"Thierry Baudet (FvD)",0.790073305634213,0.21044760175195,0
"<anonymized_userid>",8,59717,1971,"Thierry Baudet (FvD)",0.790179162145711,0.210554427945732,0
"<anonymized_userid>",8,59725,1972,"Thierry Baudet (FvD)",0.79028501865721,0.210661254139515,0
"<anonymized_userid>",8,59733,1973,"Thierry Baudet (FvD)",0.790390875168709,0.210768080333298,0
"<anonymized_userid>",8,59741,1974,"Thierry Baudet (FvD)",0.790496731680208,0.21087490652708,0
"<anonymized_userid>",8,59749,1975,"Thierry Baudet (FvD)",0.790602588191706,0.210981732720863,0
"<anonymized_userid>",8,59757,1976,"Thierry Baudet (FvD)",0.790708444703205,0.211088558914646,0
"<anonymized_userid>",8,59765,1977,"Thierry Baudet (FvD)",0.790814301214703,0.211195385108429,0
"<anonymized_userid>",8,59773,1978,"Thierry Baudet (FvD)",0.790920157726202,0.211302211302211,0
"<anonymized_userid>",8,59781,1979,"Thierry Baudet (FvD)",0.791026014237701,0.211409037495994,0
"<anonymized_userid>",8,59789,1980,"Thierry Baudet (FvD)",0.791131870749199,0.211515863689777,0
"<anonymized_userid>",8,59797,1981,"Thierry Baudet (FvD)",0.791237727260698,0.211622689883559,0
"<anonymized_userid>",8,59805,1982,"Thierry Baudet (FvD)",0.791343583772197,0.211729516077342,0
"<anonymized_userid>",8,59813,1983,"Thierry Baudet (FvD)",0.791449440283695,0.211836342271125,0
"<anonymized_userid>",8,59821,1984,"Thierry Baudet (FvD)",0.791555296795194,0.211943168464908,0
"<anonymized_userid>",8,59829,1985,"Thierry Baudet (FvD)",0.791661153306693,0.21204999465869,0
"<anonymized_userid>",8,59837,1986,"Thierry Baudet (FvD)",0.791767009818191,0.212156820852473,0
"<anonymized_userid>",8,59845,1987,"Thierry Baudet (FvD)",0.79187286632969,0.212263647046256,0
"<anonymized_userid>",8,59853,1988,"Thierry Baudet (FvD)",0.791978722841189,0.212370473240038,0
"<anonymized_userid>",8,59861,1989,"Thierry Baudet (FvD)",0.792084579352687,0.212477299433821,0
"<anonymized_userid>",8,59869,1990,"Thierry Baudet (FvD)",0.792190435864186,0.212584125627604,0
"<anonymized_userid>",8,59877,1991,"Thierry Baudet (FvD)",0.792296292375685,0.212690951821387,0
"<anonymized_userid>",8,59885,1992,"Thierry Baudet (FvD)",0.792402148887183,0.212797778015169,0
"<anonymized_userid>",8,59893,1993,"Thierry Baudet (FvD)",0.792508005398682,0.212904604208952,0
"<anonymized_userid>",8,59901,1994,"Thierry Baudet (FvD)",0.792613861910181,0.213011430402735,0
"<anonymized_userid>",8,59909,1995,"Thierry Baudet (FvD)",0.792719718421679,0.213118256596517,0
"<anonymized_userid>",8,59917,1996,"Thierry Baudet (FvD)",0.792825574933178,0.2132250827903,0
"<anonymized_userid>",8,59925,1997,"Thierry Baudet (FvD)",0.792931431444677,0.213331908984083,0
"<anonymized_userid>",8,59933,1998,"Thierry Baudet (FvD)",0.793037287956175,0.213438735177866,0
"<anonymized_userid>",8,59941,1999,"Thierry Baudet (FvD)",0.793143144467674,0.213545561371648,0
"<anonymized_userid>",8,59949,2000,"Thierry Baudet (FvD)",0.793249000979173,0.213652387565431,0
"<anonymized_userid>",8,59957,2001,"Thierry Baudet (FvD)",0.793354857490671,0.213759213759214,0
"<anonymized_userid>",8,59965,2002,"Thierry Baudet (FvD)",0.79346071400217,0.213866039952996,0
"<anonymized_userid>",8,59973,2003,"Thierry Baudet (FvD)",0.793566570513669,0.213972866146779,0
"<anonymized_userid>",8,59981,2004,"Thierry Baudet (FvD)",0.793672427025167,0.214079692340562,0
"<anonymized_userid>",8,59989,2005,"Thierry Baudet (FvD)",0.793778283536666,0.214186518534345,0
"<anonymized_userid>",7,59996,2006,"Thierry Baudet (FvD)",0.793870907984227,0.214293344728127,0
"<anonymized_userid>",7,60003,2007,"Thierry Baudet (FvD)",0.793963532431789,0.21440017092191,0
"<anonymized_userid>",7,60010,2008,"Thierry Baudet (FvD)",0.79405615687935,0.214506997115693,0
"<anonymized_userid>",7,60017,2009,"Thierry Baudet (FvD)",0.794148781326911,0.214613823309475,0
"<anonymized_userid>",7,60024,2010,"Thierry Baudet (FvD)",0.794241405774473,0.214720649503258,0
"<anonymized_userid>",7,60031,2011,"Thierry Baudet (FvD)",0.794334030222034,0.214827475697041,0
"<anonymized_userid>",7,60038,2012,"Thierry Baudet (FvD)",0.794426654669595,0.214934301890824,0
"<anonymized_userid>",7,60045,2013,"Thierry Baudet (FvD)",0.794519279117157,0.215041128084606,0
"<anonymized_userid>",7,60052,2014,"Thierry Baudet (FvD)",0.794611903564718,0.215147954278389,0
"<anonymized_userid>",7,60059,2015,"Thierry Baudet (FvD)",0.794704528012279,0.215254780472172,0
"<anonymized_userid>",7,60066,2016,"Thierry Baudet (FvD)",0.794797152459841,0.215361606665954,0
"<anonymized_userid>",7,60073,2017,"Thierry Baudet (FvD)",0.794889776907402,0.215468432859737,0
"<anonymized_userid>",7,60080,2018,"Thierry Baudet (FvD)",0.794982401354963,0.21557525905352,0
"<anonymized_userid>",7,60087,2019,"Thierry Baudet (FvD)",0.795075025802525,0.215682085247303,0
"<anonymized_userid>",7,60094,2020,"Thierry Baudet (FvD)",0.795167650250086,0.215788911441085,0
"<anonymized_userid>",7,60101,2021,"Thierry Baudet (FvD)",0.795260274697647,0.215895737634868,0
"<anonymized_userid>",7,60108,2022,"Thierry Baudet (FvD)",0.795352899145209,0.216002563828651,0
"<anonymized_userid>",7,60115,2023,"Thierry Baudet (FvD)",0.79544552359277,0.216109390022434,0
"<anonymized_userid>",7,60122,2024,"Thierry Baudet (FvD)",0.795538148040331,0.216216216216216,0
"<anonymized_userid>",7,60129,2025,"Thierry Baudet (FvD)",0.795630772487893,0.216323042409999,0
"<anonymized_userid>",7,60136,2026,"Thierry Baudet (FvD)",0.795723396935454,0.216429868603782,0
"<anonymized_userid>",7,60143,2027,"Thierry Baudet (FvD)",0.795816021383015,0.216536694797564,0
"<anonymized_userid>",7,60150,2028,"Thierry Baudet (FvD)",0.795908645830577,0.216643520991347,0
"<anonymized_userid>",7,60157,2029,"Thierry Baudet (FvD)",0.796001270278138,0.21675034718513,0
"<anonymized_userid>",7,60164,2030,"Thierry Baudet (FvD)",0.796093894725699,0.216857173378912,0
"<anonymized_userid>",7,60171,2031,"Thierry Baudet (FvD)",0.796186519173261,0.216963999572695,0
"<anonymized_userid>",7,60178,2032,"Thierry Baudet (FvD)",0.796279143620822,0.217070825766478,0
"<anonymized_userid>",7,60185,2033,"Thierry Baudet (FvD)",0.796371768068383,0.217177651960261,0
"<anonymized_userid>",7,60192,2034,"Thierry Baudet (FvD)",0.796464392515945,0.217284478154043,0
"<anonymized_userid>",7,60199,2035,"Thierry Baudet (FvD)",0.796557016963506,0.217391304347826,0
"<anonymized_userid>",7,60206,2036,"Thierry Baudet (FvD)",0.796649641411067,0.217498130541609,0
"<anonymized_userid>",7,60213,2037,"Thierry Baudet (FvD)",0.796742265858629,0.217604956735392,0
"<anonymized_userid>",7,60220,2038,"Thierry Baudet (FvD)",0.79683489030619,0.217711782929174,0
"<anonymized_userid>",7,60227,2039,"Thierry Baudet (FvD)",0.796927514753751,0.217818609122957,0
"<anonymized_userid>",7,60234,2040,"Thierry Baudet (FvD)",0.797020139201313,0.21792543531674,0
"<anonymized_userid>",7,60241,2041,"Thierry Baudet (FvD)",0.797112763648874,0.218032261510522,0
"<anonymized_userid>",7,60248,2042,"Thierry Baudet (FvD)",0.797205388096435,0.218139087704305,0
"<anonymized_userid>",7,60255,2043,"Thierry Baudet (FvD)",0.797298012543997,0.218245913898088,0
"<anonymized_userid>",7,60262,2044,"Thierry Baudet (FvD)",0.797390636991558,0.218352740091871,0
"<anonymized_userid>",7,60269,2045,"Thierry Baudet (FvD)",0.797483261439119,0.218459566285653,0
"<anonymized_userid>",7,60276,2046,"Thierry Baudet (FvD)",0.797575885886681,0.218566392479436,0
"<anonymized_userid>",7,60283,2047,"Thierry Baudet (FvD)",0.797668510334242,0.218673218673219,0
"<anonymized_userid>",7,60290,2048,"Thierry Baudet (FvD)",0.797761134781803,0.218780044867001,0
"<anonymized_userid>",7,60297,2049,"Thierry Baudet (FvD)",0.797853759229365,0.218886871060784,0
"<anonymized_userid>",7,60304,2050,"Thierry Baudet (FvD)",0.797946383676926,0.218993697254567,0
"<anonymized_userid>",7,60311,2051,"Thierry Baudet (FvD)",0.798039008124487,0.21910052344835,0
"<anonymized_userid>",7,60318,2052,"Thierry Baudet (FvD)",0.798131632572049,0.219207349642132,0
"<anonymized_userid>",7,60325,2053,"Thierry Baudet (FvD)",0.79822425701961,0.219314175835915,0
"<anonymized_userid>",7,60332,2054,"Thierry Baudet (FvD)",0.798316881467171,0.219421002029698,0
"<anonymized_userid>",7,60339,2055,"Thierry Baudet (FvD)",0.798409505914733,0.21952782822348,0
"<anonymized_userid>",7,60346,2056,"Thierry Baudet (FvD)",0.798502130362294,0.219634654417263,0
"<anonymized_userid>",7,60353,2057,"Thierry Baudet (FvD)",0.798594754809855,0.219741480611046,0
"<anonymized_userid>",7,60360,2058,"Thierry Baudet (FvD)",0.798687379257417,0.219848306804829,0
"<anonymized_userid>",7,60367,2059,"Thierry Baudet (FvD)",0.798780003704978,0.219955132998611,0
"<anonymized_userid>",7,60374,2060,"Thierry Baudet (FvD)",0.798872628152539,0.220061959192394,0
"<anonymized_userid>",7,60381,2061,"Thierry Baudet (FvD)",0.798965252600101,0.220168785386177,0
"<anonymized_userid>",7,60388,2062,"Thierry Baudet (FvD)",0.799057877047662,0.220275611579959,0
"<anonymized_userid>",7,60395,2063,"Thierry Baudet (FvD)",0.799150501495223,0.220382437773742,0
"<anonymized_userid>",7,60402,2064,"Thierry Baudet (FvD)",0.799243125942785,0.220489263967525,0
"<anonymized_userid>",7,60409,2065,"Thierry Baudet (FvD)",0.799335750390346,0.220596090161308,0
"<anonymized_userid>",7,60416,2066,"Thierry Baudet (FvD)",0.799428374837907,0.22070291635509,0
"<anonymized_userid>",7,60423,2067,"Thierry Baudet (FvD)",0.799520999285468,0.220809742548873,0
"<anonymized_userid>",7,60430,2068,"Thierry Baudet (FvD)",0.79961362373303,0.220916568742656,0
"<anonymized_userid>",7,60437,2069,"Thierry Baudet (FvD)",0.799706248180591,0.221023394936438,0
"<anonymized_userid>",7,60444,2070,"Thierry Baudet (FvD)",0.799798872628153,0.221130221130221,0
"<anonymized_userid>",7,60451,2071,"Thierry Baudet (FvD)",0.799891497075714,0.221237047324004,0
"<anonymized_userid>",7,60458,2072,"Thierry Baudet (FvD)",0.799984121523275,0.221343873517787,0
"<anonymized_userid>",7,60465,2073,"Thierry Baudet (FvD)",0.800076745970837,0.221450699711569,0
"<anonymized_userid>",7,60472,2074,"Thierry Baudet (FvD)",0.800169370418398,0.221557525905352,0
"<anonymized_userid>",7,60479,2075,"Thierry Baudet (FvD)",0.800261994865959,0.221664352099135,0
"<anonymized_userid>",7,60486,2076,"Thierry Baudet (FvD)",0.80035461931352,0.221771178292917,0
"<anonymized_userid>",7,60493,2077,"Thierry Baudet (FvD)",0.800447243761082,0.2218780044867,0
"<anonymized_userid>",7,60500,2078,"Thierry Baudet (FvD)",0.800539868208643,0.221984830680483,0
"<anonymized_userid>",7,60507,2079,"Thierry Baudet (FvD)",0.800632492656205,0.222091656874266,0
"<anonymized_userid>",7,60514,2080,"Thierry Baudet (FvD)",0.800725117103766,0.222198483068048,0
"<anonymized_userid>",7,60521,2081,"Thierry Baudet (FvD)",0.800817741551327,0.222305309261831,0
"<anonymized_userid>",7,60528,2082,"Thierry Baudet (FvD)",0.800910365998889,0.222412135455614,0
"<anonymized_userid>",7,60535,2083,"Thierry Baudet (FvD)",0.80100299044645,0.222518961649396,0
"<anonymized_userid>",7,60542,2084,"Thierry Baudet (FvD)",0.801095614894011,0.222625787843179,0
"<anonymized_userid>",7,60549,2085,"Thierry Baudet (FvD)",0.801188239341572,0.222732614036962,0
"<anonymized_userid>",7,60556,2086,"Thierry Baudet (FvD)",0.801280863789134,0.222839440230745,0
"<anonymized_userid>",7,60563,2087,"Thierry Baudet (FvD)",0.801373488236695,0.222946266424527,0
"<anonymized_userid>",7,60570,2088,"Thierry Baudet (FvD)",0.801466112684256,0.22305309261831,0
"<anonymized_userid>",7,60577,2089,"Thierry Baudet (FvD)",0.801558737131818,0.223159918812093,0
"<anonymized_userid>",7,60584,2090,"Thierry Baudet (FvD)",0.801651361579379,0.223266745005875,0
"<anonymized_userid>",7,60591,2091,"Thierry Baudet (FvD)",0.801743986026941,0.223373571199658,0
"<anonymized_userid>",7,60598,2092,"Thierry Baudet (FvD)",0.801836610474502,0.223480397393441,0
"<anonymized_userid>",7,60605,2093,"Thierry Baudet (FvD)",0.801929234922063,0.223587223587224,0
"<anonymized_userid>",7,60612,2094,"Thierry Baudet (FvD)",0.802021859369624,0.223694049781006,0
"<anonymized_userid>",7,60619,2095,"Thierry Baudet (FvD)",0.802114483817186,0.223800875974789,0
"<anonymized_userid>",7,60626,2096,"Thierry Baudet (FvD)",0.802207108264747,0.223907702168572,0
"<anonymized_userid>",7,60633,2097,"Thierry Baudet (FvD)",0.802299732712308,0.224014528362354,0
"<anonymized_userid>",7,60640,2098,"Thierry Baudet (FvD)",0.80239235715987,0.224121354556137,0
"<anonymized_userid>",7,60647,2099,"Thierry Baudet (FvD)",0.802484981607431,0.22422818074992,0
"<anonymized_userid>",7,60654,2100,"Thierry Baudet (FvD)",0.802577606054993,0.224335006943703,0
"<anonymized_userid>",7,60661,2101,"Thierry Baudet (FvD)",0.802670230502554,0.224441833137485,0
"<anonymized_userid>",7,60668,2102,"Thierry Baudet (FvD)",0.802762854950115,0.224548659331268,0
"<anonymized_userid>",7,60675,2103,"Thierry Baudet (FvD)",0.802855479397676,0.224655485525051,0
"<anonymized_userid>",7,60682,2104,"Thierry Baudet (FvD)",0.802948103845238,0.224762311718833,0
"<anonymized_userid>",7,60689,2105,"Thierry Baudet (FvD)",0.803040728292799,0.224869137912616,0
"<anonymized_userid>",7,60696,2106,"Thierry Baudet (FvD)",0.80313335274036,0.224975964106399,0
"<anonymized_userid>",7,60703,2107,"Thierry Baudet (FvD)",0.803225977187922,0.225082790300182,0
"<anonymized_userid>",7,60710,2108,"Thierry Baudet (FvD)",0.803318601635483,0.225189616493964,0
"<anonymized_userid>",7,60717,2109,"Thierry Baudet (FvD)",0.803411226083044,0.225296442687747,0
"<anonymized_userid>",7,60724,2110,"Thierry Baudet (FvD)",0.803503850530606,0.22540326888153,0
"<anonymized_userid>",7,60731,2111,"Thierry Baudet (FvD)",0.803596474978167,0.225510095075312,0
"<anonymized_userid>",7,60738,2112,"Thierry Baudet (FvD)",0.803689099425728,0.225616921269095,0
"<anonymized_userid>",7,60745,2113,"Thierry Baudet (FvD)",0.80378172387329,0.225723747462878,0
"<anonymized_userid>",7,60752,2114,"Thierry Baudet (FvD)",0.803874348320851,0.225830573656661,0
"<anonymized_userid>",7,60759,2115,"Thierry Baudet (FvD)",0.803966972768412,0.225937399850443,0
"<anonymized_userid>",7,60766,2116,"Thierry Baudet (FvD)",0.804059597215974,0.226044226044226,0
"<anonymized_userid>",7,60773,2117,"Thierry Baudet (FvD)",0.804152221663535,0.226151052238009,0
"<anonymized_userid>",7,60780,2118,"Thierry Baudet (FvD)",0.804244846111096,0.226257878431791,0
"<anonymized_userid>",7,60787,2119,"Thierry Baudet (FvD)",0.804337470558658,0.226364704625574,0
"<anonymized_userid>",7,60794,2120,"Thierry Baudet (FvD)",0.804430095006219,0.226471530819357,0
"<anonymized_userid>",7,60801,2121,"Thierry Baudet (FvD)",0.80452271945378,0.22657835701314,0
"<anonymized_userid>",7,60808,2122,"Thierry Baudet (FvD)",0.804615343901342,0.226685183206922,0
"<anonymized_userid>",7,60815,2123,"Thierry Baudet (FvD)",0.804707968348903,0.226792009400705,0
"<anonymized_userid>",7,60822,2124,"Thierry Baudet (FvD)",0.804800592796464,0.226898835594488,0
"<anonymized_userid>",7,60829,2125,"Thierry Baudet (FvD)",0.804893217244026,0.22700566178827,0
"<anonymized_userid>",7,60836,2126,"Thierry Baudet (FvD)",0.804985841691587,0.227112487982053,0
"<anonymized_userid>",7,60843,2127,"Thierry Baudet (FvD)",0.805078466139148,0.227219314175836,0
"<anonymized_userid>",7,60850,2128,"Thierry Baudet (FvD)",0.80517109058671,0.227326140369619,0
"<anonymized_userid>",7,60857,2129,"Thierry Baudet (FvD)",0.805263715034271,0.227432966563401,0
"<anonymized_userid>",7,60864,2130,"Thierry Baudet (FvD)",0.805356339481832,0.227539792757184,0
"<anonymized_userid>",7,60871,2131,"Thierry Baudet (FvD)",0.805448963929394,0.227646618950967,0
"<anonymized_userid>",7,60878,2132,"Thierry Baudet (FvD)",0.805541588376955,0.227753445144749,0
"<anonymized_userid>",7,60885,2133,"Thierry Baudet (FvD)",0.805634212824516,0.227860271338532,0
"<anonymized_userid>",7,60892,2134,"Thierry Baudet (FvD)",0.805726837272078,0.227967097532315,0
"<anonymized_userid>",7,60899,2135,"Thierry Baudet (FvD)",0.805819461719639,0.228073923726098,0
"<anonymized_userid>",7,60906,2136,"Thierry Baudet (FvD)",0.8059120861672,0.22818074991988,0
"<anonymized_userid>",7,60913,2137,"Thierry Baudet (FvD)",0.806004710614762,0.228287576113663,0
"<anonymized_userid>",7,60920,2138,"Thierry Baudet (FvD)",0.806097335062323,0.228394402307446,0
"<anonymized_userid>",7,60927,2139,"Thierry Baudet (FvD)",0.806189959509884,0.228501228501229,0
"<anonymized_userid>",7,60934,2140,"Thierry Baudet (FvD)",0.806282583957446,0.228608054695011,0
"<anonymized_userid>",7,60941,2141,"Thierry Baudet (FvD)",0.806375208405007,0.228714880888794,0
"<anonymized_userid>",7,60948,2142,"Thierry Baudet (FvD)",0.806467832852568,0.228821707082577,0
"<anonymized_userid>",7,60955,2143,"Thierry Baudet (FvD)",0.80656045730013,0.228928533276359,0
"<anonymized_userid>",7,60962,2144,"Thierry Baudet (FvD)",0.806653081747691,0.229035359470142,0
"<anonymized_userid>",7,60969,2145,"Thierry Baudet (FvD)",0.806745706195252,0.229142185663925,0
"<anonymized_userid>",7,60976,2146,"Thierry Baudet (FvD)",0.806838330642814,0.229249011857708,0
"<anonymized_userid>",7,60983,2147,"Thierry Baudet (FvD)",0.806930955090375,0.22935583805149,0
"<anonymized_userid>",7,60990,2148,"Thierry Baudet (FvD)",0.807023579537936,0.229462664245273,0
"<anonymized_userid>",7,60997,2149,"Thierry Baudet (FvD)",0.807116203985498,0.229569490439056,0
"<anonymized_userid>",7,61004,2150,"Thierry Baudet (FvD)",0.807208828433059,0.229676316632838,0
"<anonymized_userid>",7,61011,2151,"Thierry Baudet (FvD)",0.80730145288062,0.229783142826621,0
"<anonymized_userid>",7,61018,2152,"Thierry Baudet (FvD)",0.807394077328182,0.229889969020404,0
"<anonymized_userid>",7,61025,2153,"Thierry Baudet (FvD)",0.807486701775743,0.229996795214187,0
"<anonymized_userid>",7,61032,2154,"Thierry Baudet (FvD)",0.807579326223304,0.230103621407969,0
"<anonymized_userid>",7,61039,2155,"Thierry Baudet (FvD)",0.807671950670866,0.230210447601752,0
"<anonymized_userid>",7,61046,2156,"Thierry Baudet (FvD)",0.807764575118427,0.230317273795535,0
"<anonymized_userid>",7,61053,2157,"Thierry Baudet (FvD)",0.807857199565988,0.230424099989317,0
"<anonymized_userid>",7,61060,2158,"Thierry Baudet (FvD)",0.80794982401355,0.2305309261831,0
"<anonymized_userid>",7,61067,2159,"Thierry Baudet (FvD)",0.808042448461111,0.230637752376883,0
"<anonymized_userid>",7,61074,2160,"Thierry Baudet (FvD)",0.808135072908672,0.230744578570666,0
"<anonymized_userid>",7,61081,2161,"Thierry Baudet (FvD)",0.808227697356234,0.230851404764448,0
"<anonymized_userid>",7,61088,2162,"Thierry Baudet (FvD)",0.808320321803795,0.230958230958231,0
"<anonymized_userid>",7,61095,2163,"Thierry Baudet (FvD)",0.808412946251356,0.231065057152014,0
"<anonymized_userid>",7,61102,2164,"Thierry Baudet (FvD)",0.808505570698918,0.231171883345796,0
"<anonymized_userid>",7,61109,2165,"Thierry Baudet (FvD)",0.808598195146479,0.231278709539579,0
"<anonymized_userid>",7,61116,2166,"Thierry Baudet (FvD)",0.80869081959404,0.231385535733362,0
"<anonymized_userid>",7,61123,2167,"Thierry Baudet (FvD)",0.808783444041602,0.231492361927145,0
"<anonymized_userid>",7,61130,2168,"Thierry Baudet (FvD)",0.808876068489163,0.231599188120927,0
"<anonymized_userid>",7,61137,2169,"Thierry Baudet (FvD)",0.808968692936724,0.23170601431471,0
"<anonymized_userid>",7,61144,2170,"Thierry Baudet (FvD)",0.809061317384286,0.231812840508493,0
"<anonymized_userid>",7,61151,2171,"Thierry Baudet (FvD)",0.809153941831847,0.231919666702275,0
"<anonymized_userid>",7,61158,2172,"Thierry Baudet (FvD)",0.809246566279408,0.232026492896058,0
"<anonymized_userid>",7,61165,2173,"Thierry Baudet (FvD)",0.80933919072697,0.232133319089841,0
"<anonymized_userid>",7,61172,2174,"Thierry Baudet (FvD)",0.809431815174531,0.232240145283624,0
"<anonymized_userid>",7,61179,2175,"Thierry Baudet (FvD)",0.809524439622092,0.232346971477406,0
"<anonymized_userid>",7,61186,2176,"Thierry Baudet (FvD)",0.809617064069654,0.232453797671189,0
"<anonymized_userid>",7,61193,2177,"Thierry Baudet (FvD)",0.809709688517215,0.232560623864972,0
"<anonymized_userid>",7,61200,2178,"Thierry Baudet (FvD)",0.809802312964776,0.232667450058754,0
"<anonymized_userid>",7,61207,2179,"Thierry Baudet (FvD)",0.809894937412338,0.232774276252537,0
"<anonymized_userid>",7,61214,2180,"Thierry Baudet (FvD)",0.809987561859899,0.23288110244632,0
"<anonymized_userid>",7,61221,2181,"Thierry Baudet (FvD)",0.81008018630746,0.232987928640103,0
"<anonymized_userid>",7,61228,2182,"Thierry Baudet (FvD)",0.810172810755022,0.233094754833885,0
"<anonymized_userid>",7,61235,2183,"Thierry Baudet (FvD)",0.810265435202583,0.233201581027668,0
"<anonymized_userid>",7,61242,2184,"Thierry Baudet (FvD)",0.810358059650144,0.233308407221451,0
"<anonymized_userid>",7,61249,2185,"Thierry Baudet (FvD)",0.810450684097706,0.233415233415233,0
"<anonymized_userid>",7,61256,2186,"Thierry Baudet (FvD)",0.810543308545267,0.233522059609016,0
"<anonymized_userid>",7,61263,2187,"Thierry Baudet (FvD)",0.810635932992828,0.233628885802799,0
"<anonymized_userid>",7,61270,2188,"Thierry Baudet (FvD)",0.81072855744039,0.233735711996582,0
"<anonymized_userid>",7,61277,2189,"Thierry Baudet (FvD)",0.810821181887951,0.233842538190364,0
"<anonymized_userid>",7,61284,2190,"Thierry Baudet (FvD)",0.810913806335512,0.233949364384147,0
"<anonymized_userid>",7,61291,2191,"Thierry Baudet (FvD)",0.811006430783074,0.23405619057793,0
"<anonymized_userid>",7,61298,2192,"Thierry Baudet (FvD)",0.811099055230635,0.234163016771712,0
"<anonymized_userid>",7,61305,2193,"Thierry Baudet (FvD)",0.811191679678196,0.234269842965495,0
"<anonymized_userid>",7,61312,2194,"Thierry Baudet (FvD)",0.811284304125758,0.234376669159278,0
"<anonymized_userid>",7,61319,2195,"Thierry Baudet (FvD)",0.811376928573319,0.234483495353061,0
"<anonymized_userid>",7,61326,2196,"Thierry Baudet (FvD)",0.81146955302088,0.234590321546843,0
"<anonymized_userid>",7,61333,2197,"Thierry Baudet (FvD)",0.811562177468442,0.234697147740626,0
"<anonymized_userid>",7,61340,2198,"Thierry Baudet (FvD)",0.811654801916003,0.234803973934409,0
"<anonymized_userid>",7,61347,2199,"Thierry Baudet (FvD)",0.811747426363564,0.234910800128191,0
"<anonymized_userid>",7,61354,2200,"Thierry Baudet (FvD)",0.811840050811126,0.235017626321974,0
"<anonymized_userid>",7,61361,2201,"Thierry Baudet (FvD)",0.811932675258687,0.235124452515757,0
"<anonymized_userid>",7,61368,2202,"Thierry Baudet (FvD)",0.812025299706248,0.23523127870954,0
"<anonymized_userid>",7,61375,2203,"Thierry Baudet (FvD)",0.812117924153809,0.235338104903322,0
"<anonymized_userid>",7,61382,2204,"Thierry Baudet (FvD)",0.812210548601371,0.235444931097105,0
"<anonymized_userid>",7,61389,2205,"Thierry Baudet (FvD)",0.812303173048932,0.235551757290888,0
"<anonymized_userid>",7,61396,2206,"Thierry Baudet (FvD)",0.812395797496493,0.23565858348467,0
"<anonymized_userid>",7,61403,2207,"Thierry Baudet (FvD)",0.812488421944055,0.235765409678453,0
"<anonymized_userid>",7,61410,2208,"Thierry Baudet (FvD)",0.812581046391616,0.235872235872236,0
"<anonymized_userid>",7,61417,2209,"Thierry Baudet (FvD)",0.812673670839178,0.235979062066019,0
"<anonymized_userid>",7,61424,2210,"Thierry Baudet (FvD)",0.812766295286739,0.236085888259801,0
"<anonymized_userid>",7,61431,2211,"Thierry Baudet (FvD)",0.8128589197343,0.236192714453584,0
"<anonymized_userid>",7,61438,2212,"Thierry Baudet (FvD)",0.812951544181861,0.236299540647367,0
"<anonymized_userid>",7,61445,2213,"Thierry Baudet (FvD)",0.813044168629423,0.236406366841149,0
"<anonymized_userid>",7,61452,2214,"Thierry Baudet (FvD)",0.813136793076984,0.236513193034932,0
"<anonymized_userid>",7,61459,2215,"Thierry Baudet (FvD)",0.813229417524545,0.236620019228715,0
"<anonymized_userid>",7,61466,2216,"Thierry Baudet (FvD)",0.813322041972107,0.236726845422498,0
"<anonymized_userid>",7,61473,2217,"Thierry Baudet (FvD)",0.813414666419668,0.23683367161628,0
"<anonymized_userid>",7,61480,2218,"Thierry Baudet (FvD)",0.81350729086723,0.236940497810063,0
"<anonymized_userid>",7,61487,2219,"Thierry Baudet (FvD)",0.813599915314791,0.237047324003846,0
"<anonymized_userid>",7,61494,2220,"Thierry Baudet (FvD)",0.813692539762352,0.237154150197628,0
"<anonymized_userid>",7,61501,2221,"Thierry Baudet (FvD)",0.813785164209913,0.237260976391411,0
"<anonymized_userid>",7,61508,2222,"Thierry Baudet (FvD)",0.813877788657475,0.237367802585194,0
"<anonymized_userid>",7,61515,2223,"Thierry Baudet (FvD)",0.813970413105036,0.237474628778977,0
"<anonymized_userid>",7,61522,2224,"Thierry Baudet (FvD)",0.814063037552597,0.237581454972759,0
"<anonymized_userid>",7,61529,2225,"Thierry Baudet (FvD)",0.814155662000159,0.237688281166542,0
"<anonymized_userid>",7,61536,2226,"Thierry Baudet (FvD)",0.81424828644772,0.237795107360325,0
"<anonymized_userid>",7,61543,2227,"Thierry Baudet (FvD)",0.814340910895281,0.237901933554107,0
"<anonymized_userid>",7,61550,2228,"Thierry Baudet (FvD)",0.814433535342843,0.23800875974789,0
"<anonymized_userid>",7,61557,2229,"Thierry Baudet (FvD)",0.814526159790404,0.238115585941673,0
"<anonymized_userid>",7,61564,2230,"Thierry Baudet (FvD)",0.814618784237965,0.238222412135456,0
"<anonymized_userid>",7,61571,2231,"Thierry Baudet (FvD)",0.814711408685527,0.238329238329238,0
"<anonymized_userid>",7,61578,2232,"Thierry Baudet (FvD)",0.814804033133088,0.238436064523021,0
"<anonymized_userid>",7,61585,2233,"Thierry Baudet (FvD)",0.814896657580649,0.238542890716804,0
"<anonymized_userid>",7,61592,2234,"Thierry Baudet (FvD)",0.814989282028211,0.238649716910586,0
"<anonymized_userid>",7,61599,2235,"Thierry Baudet (FvD)",0.815081906475772,0.238756543104369,0
"<anonymized_userid>",7,61606,2236,"Thierry Baudet (FvD)",0.815174530923333,0.238863369298152,0
"<anonymized_userid>",7,61613,2237,"Thierry Baudet (FvD)",0.815267155370895,0.238970195491935,0
"<anonymized_userid>",6,61619,2238,"Thierry Baudet (FvD)",0.815346547754519,0.239077021685717,0
"<anonymized_userid>",6,61625,2239,"Thierry Baudet (FvD)",0.815425940138143,0.2391838478795,0
"<anonymized_userid>",6,61631,2240,"Thierry Baudet (FvD)",0.815505332521767,0.239290674073283,0
"<anonymized_userid>",6,61637,2241,"Thierry Baudet (FvD)",0.815584724905391,0.239397500267065,0
"<anonymized_userid>",6,61643,2242,"Thierry Baudet (FvD)",0.815664117289015,0.239504326460848,0
"<anonymized_userid>",6,61649,2243,"Thierry Baudet (FvD)",0.815743509672639,0.239611152654631,0
"<anonymized_userid>",6,61655,2244,"Thierry Baudet (FvD)",0.815822902056263,0.239717978848414,0
"<anonymized_userid>",6,61661,2245,"Thierry Baudet (FvD)",0.815902294439887,0.239824805042196,0
"<anonymized_userid>",6,61667,2246,"Thierry Baudet (FvD)",0.815981686823511,0.239931631235979,0
"<anonymized_userid>",6,61673,2247,"Thierry Baudet (FvD)",0.816061079207135,0.240038457429762,0
"<anonymized_userid>",6,61679,2248,"Thierry Baudet (FvD)",0.816140471590759,0.240145283623544,0
"<anonymized_userid>",6,61685,2249,"Thierry Baudet (FvD)",0.816219863974383,0.240252109817327,0
"<anonymized_userid>",6,61691,2250,"Thierry Baudet (FvD)",0.816299256358007,0.24035893601111,0
"<anonymized_userid>",6,61697,2251,"Thierry Baudet (FvD)",0.816378648741631,0.240465762204893,0
"<anonymized_userid>",6,61703,2252,"Thierry Baudet (FvD)",0.816458041125255,0.240572588398675,0
"<anonymized_userid>",6,61709,2253,"Thierry Baudet (FvD)",0.816537433508879,0.240679414592458,0
"<anonymized_userid>",6,61715,2254,"Thierry Baudet (FvD)",0.816616825892503,0.240786240786241,0
"<anonymized_userid>",6,61721,2255,"Thierry Baudet (FvD)",0.816696218276127,0.240893066980023,0
"<anonymized_userid>",6,61727,2256,"Thierry Baudet (FvD)",0.816775610659751,0.240999893173806,0
"<anonymized_userid>",6,61733,2257,"Thierry Baudet (FvD)",0.816855003043375,0.241106719367589,0
"<anonymized_userid>",6,61739,2258,"Thierry Baudet (FvD)",0.816934395426999,0.241213545561372,0
"<anonymized_userid>",6,61745,2259,"Thierry Baudet (FvD)",0.817013787810623,0.241320371755154,0
"<anonymized_userid>",6,61751,2260,"Thierry Baudet (FvD)",0.817093180194247,0.241427197948937,0
"<anonymized_userid>",6,61757,2261,"Thierry Baudet (FvD)",0.817172572577871,0.24153402414272,0
"<anonymized_userid>",6,61763,2262,"Thierry Baudet (FvD)",0.817251964961495,0.241640850336503,0
"<anonymized_userid>",6,61769,2263,"Thierry Baudet (FvD)",0.817331357345119,0.241747676530285,0
"<anonymized_userid>",6,61775,2264,"Thierry Baudet (FvD)",0.817410749728743,0.241854502724068,0
"<anonymized_userid>",6,61781,2265,"Thierry Baudet (FvD)",0.817490142112367,0.241961328917851,0
"<anonymized_userid>",6,61787,2266,"Thierry Baudet (FvD)",0.817569534495991,0.242068155111633,0
"<anonymized_userid>",6,61793,2267,"Thierry Baudet (FvD)",0.817648926879615,0.242174981305416,0
"<anonymized_userid>",6,61799,2268,"Thierry Baudet (FvD)",0.817728319263239,0.242281807499199,0
"<anonymized_userid>",6,61805,2269,"Thierry Baudet (FvD)",0.817807711646863,0.242388633692982,0
"<anonymized_userid>",6,61811,2270,"Thierry Baudet (FvD)",0.817887104030487,0.242495459886764,0
"<anonymized_userid>",6,61817,2271,"Thierry Baudet (FvD)",0.817966496414111,0.242602286080547,0
"<anonymized_userid>",6,61823,2272,"Thierry Baudet (FvD)",0.818045888797735,0.24270911227433,0
"<anonymized_userid>",6,61829,2273,"Thierry Baudet (FvD)",0.818125281181359,0.242815938468112,0
"<anonymized_userid>",6,61835,2274,"Thierry Baudet (FvD)",0.818204673564983,0.242922764661895,0
"<anonymized_userid>",6,61841,2275,"Thierry Baudet (FvD)",0.818284065948607,0.243029590855678,0
"<anonymized_userid>",6,61847,2276,"Thierry Baudet (FvD)",0.818363458332231,0.243136417049461,0
"<anonymized_userid>",6,61853,2277,"Thierry Baudet (FvD)",0.818442850715855,0.243243243243243,0
"<anonymized_userid>",6,61859,2278,"Thierry Baudet (FvD)",0.818522243099479,0.243350069437026,0
"<anonymized_userid>",6,61865,2279,"Thierry Baudet (FvD)",0.818601635483103,0.243456895630809,0
"<anonymized_userid>",6,61871,2280,"Thierry Baudet (FvD)",0.818681027866727,0.243563721824591,0
"<anonymized_userid>",6,61877,2281,"Thierry Baudet (FvD)",0.818760420250351,0.243670548018374,0
"<anonymized_userid>",6,61883,2282,"Thierry Baudet (FvD)",0.818839812633975,0.243777374212157,0
"<anonymized_userid>",6,61889,2283,"Thierry Baudet (FvD)",0.818919205017599,0.24388420040594,0
"<anonymized_userid>",6,61895,2284,"Thierry Baudet (FvD)",0.818998597401223,0.243991026599722,0
"<anonymized_userid>",6,61901,2285,"Thierry Baudet (FvD)",0.819077989784847,0.244097852793505,0
"<anonymized_userid>",6,61907,2286,"Thierry Baudet (FvD)",0.819157382168471,0.244204678987288,0
"<anonymized_userid>",6,61913,2287,"Thierry Baudet (FvD)",0.819236774552095,0.24431150518107,0
"<anonymized_userid>",6,61919,2288,"Thierry Baudet (FvD)",0.819316166935719,0.244418331374853,0
"<anonymized_userid>",6,61925,2289,"Thierry Baudet (FvD)",0.819395559319343,0.244525157568636,0
"<anonymized_userid>",6,61931,2290,"Thierry Baudet (FvD)",0.819474951702967,0.244631983762419,0
"<anonymized_userid>",6,61937,2291,"Thierry Baudet (FvD)",0.819554344086591,0.244738809956201,0
"<anonymized_userid>",6,61943,2292,"Thierry Baudet (FvD)",0.819633736470215,0.244845636149984,0
"<anonymized_userid>",6,61949,2293,"Thierry Baudet (FvD)",0.819713128853839,0.244952462343767,0
"<anonymized_userid>",6,61955,2294,"Thierry Baudet (FvD)",0.819792521237463,0.245059288537549,0
"<anonymized_userid>",6,61961,2295,"Thierry Baudet (FvD)",0.819871913621087,0.245166114731332,0
"<anonymized_userid>",6,61967,2296,"Thierry Baudet (FvD)",0.819951306004711,0.245272940925115,0
"<anonymized_userid>",6,61973,2297,"Thierry Baudet (FvD)",0.820030698388335,0.245379767118898,0
"<anonymized_userid>",6,61979,2298,"Thierry Baudet (FvD)",0.820110090771959,0.24548659331268,0
"<anonymized_userid>",6,61985,2299,"Thierry Baudet (FvD)",0.820189483155583,0.245593419506463,0
"<anonymized_userid>",6,61991,2300,"Thierry Baudet (FvD)",0.820268875539207,0.245700245700246,0
"<anonymized_userid>",6,61997,2301,"Thierry Baudet (FvD)",0.820348267922831,0.245807071894028,0
"<anonymized_userid>",6,62003,2302,"Thierry Baudet (FvD)",0.820427660306455,0.245913898087811,0
"<anonymized_userid>",6,62009,2303,"Thierry Baudet (FvD)",0.820507052690079,0.246020724281594,0
"<anonymized_userid>",6,62015,2304,"Thierry Baudet (FvD)",0.820586445073703,0.246127550475377,0
"<anonymized_userid>",6,62021,2305,"Thierry Baudet (FvD)",0.820665837457327,0.246234376669159,0
"<anonymized_userid>",6,62027,2306,"Thierry Baudet (FvD)",0.820745229840951,0.246341202862942,0
"<anonymized_userid>",6,62033,2307,"Thierry Baudet (FvD)",0.820824622224575,0.246448029056725,0
"<anonymized_userid>",6,62039,2308,"Thierry Baudet (FvD)",0.820904014608199,0.246554855250507,0
"<anonymized_userid>",6,62045,2309,"Thierry Baudet (FvD)",0.820983406991823,0.24666168144429,0
"<anonymized_userid>",6,62051,2310,"Thierry Baudet (FvD)",0.821062799375447,0.246768507638073,0
"<anonymized_userid>",6,62057,2311,"Thierry Baudet (FvD)",0.821142191759071,0.246875333831856,0
"<anonymized_userid>",6,62063,2312,"Thierry Baudet (FvD)",0.821221584142695,0.246982160025638,0
"<anonymized_userid>",6,62069,2313,"Thierry Baudet (FvD)",0.821300976526319,0.247088986219421,0
"<anonymized_userid>",6,62075,2314,"Thierry Baudet (FvD)",0.821380368909943,0.247195812413204,0
"<anonymized_userid>",6,62081,2315,"Thierry Baudet (FvD)",0.821459761293567,0.247302638606986,0
"<anonymized_userid>",6,62087,2316,"Thierry Baudet (FvD)",0.821539153677191,0.247409464800769,0
"<anonymized_userid>",6,62093,2317,"Thierry Baudet (FvD)",0.821618546060815,0.247516290994552,0
"<anonymized_userid>",6,62099,2318,"Thierry Baudet (FvD)",0.821697938444439,0.247623117188335,0
"<anonymized_userid>",6,62105,2319,"Thierry Baudet (FvD)",0.821777330828063,0.247729943382117,0
"<anonymized_userid>",6,62111,2320,"Thierry Baudet (FvD)",0.821856723211687,0.2478367695759,0
"<anonymized_userid>",6,62117,2321,"Thierry Baudet (FvD)",0.821936115595311,0.247943595769683,0
"<anonymized_userid>",6,62123,2322,"Thierry Baudet (FvD)",0.822015507978935,0.248050421963465,0
"<anonymized_userid>",6,62129,2323,"Thierry Baudet (FvD)",0.822094900362559,0.248157248157248,0
"<anonymized_userid>",6,62135,2324,"Thierry Baudet (FvD)",0.822174292746183,0.248264074351031,0
"<anonymized_userid>",6,62141,2325,"Thierry Baudet (FvD)",0.822253685129807,0.248370900544814,0
"<anonymized_userid>",6,62147,2326,"Thierry Baudet (FvD)",0.822333077513431,0.248477726738596,0
"<anonymized_userid>",6,62153,2327,"Thierry Baudet (FvD)",0.822412469897055,0.248584552932379,0
"<anonymized_userid>",6,62159,2328,"Thierry Baudet (FvD)",0.822491862280678,0.248691379126162,0
"<anonymized_userid>",6,62165,2329,"Thierry Baudet (FvD)",0.822571254664303,0.248798205319944,0
"<anonymized_userid>",6,62171,2330,"Thierry Baudet (FvD)",0.822650647047927,0.248905031513727,0
"<anonymized_userid>",6,62177,2331,"Thierry Baudet (FvD)",0.822730039431551,0.24901185770751,0
"<anonymized_userid>",6,62183,2332,"Thierry Baudet (FvD)",0.822809431815175,0.249118683901293,0
"<anonymized_userid>",6,62189,2333,"Thierry Baudet (FvD)",0.822888824198798,0.249225510095075,0
"<anonymized_userid>",6,62195,2334,"Thierry Baudet (FvD)",0.822968216582422,0.249332336288858,0
"<anonymized_userid>",6,62201,2335,"Thierry Baudet (FvD)",0.823047608966047,0.249439162482641,0
"<anonymized_userid>",6,62207,2336,"Thierry Baudet (FvD)",0.823127001349671,0.249545988676423,0
"<anonymized_userid>",6,62213,2337,"Thierry Baudet (FvD)",0.823206393733295,0.249652814870206,0
"<anonymized_userid>",6,62219,2338,"Thierry Baudet (FvD)",0.823285786116918,0.249759641063989,0
"<anonymized_userid>",6,62225,2339,"Thierry Baudet (FvD)",0.823365178500542,0.249866467257772,0
"<anonymized_userid>",6,62231,2340,"Thierry Baudet (FvD)",0.823444570884167,0.249973293451554,0
"<anonymized_userid>",6,62237,2341,"Thierry Baudet (FvD)",0.823523963267791,0.250080119645337,1
"<anonymized_userid>",6,62243,2342,"Thierry Baudet (FvD)",0.823603355651415,0.25018694583912,0
"<anonymized_userid>",6,62249,2343,"Thierry Baudet (FvD)",0.823682748035038,0.250293772032902,0
"<anonymized_userid>",6,62255,2344,"Thierry Baudet (FvD)",0.823762140418662,0.250400598226685,0
"<anonymized_userid>",6,62261,2345,"Thierry Baudet (FvD)",0.823841532802286,0.250507424420468,0
"<anonymized_userid>",6,62267,2346,"Thierry Baudet (FvD)",0.823920925185911,0.250614250614251,0
"<anonymized_userid>",6,62273,2347,"Thierry Baudet (FvD)",0.824000317569535,0.250721076808033,0
"<anonymized_userid>",6,62279,2348,"Thierry Baudet (FvD)",0.824079709953158,0.250827903001816,0
"<anonymized_userid>",6,62285,2349,"Thierry Baudet (FvD)",0.824159102336782,0.250934729195599,0
"<anonymized_userid>",6,62291,2350,"Thierry Baudet (FvD)",0.824238494720406,0.251041555389381,0
"<anonymized_userid>",6,62297,2351,"Thierry Baudet (FvD)",0.824317887104031,0.251148381583164,0
"<anonymized_userid>",6,62303,2352,"Thierry Baudet (FvD)",0.824397279487655,0.251255207776947,0
"<anonymized_userid>",6,62309,2353,"Thierry Baudet (FvD)",0.824476671871278,0.25136203397073,0
"<anonymized_userid>",6,62315,2354,"Thierry Baudet (FvD)",0.824556064254902,0.251468860164512,0
"<anonymized_userid>",6,62321,2355,"Thierry Baudet (FvD)",0.824635456638526,0.251575686358295,0
"<anonymized_userid>",6,62327,2356,"Thierry Baudet (FvD)",0.82471484902215,0.251682512552078,0
"<anonymized_userid>",6,62333,2357,"Thierry Baudet (FvD)",0.824794241405775,0.25178933874586,0
"<anonymized_userid>",6,62339,2358,"Thierry Baudet (FvD)",0.824873633789398,0.251896164939643,0
"<anonymized_userid>",6,62345,2359,"Thierry Baudet (FvD)",0.824953026173022,0.252002991133426,0
"<anonymized_userid>",6,62351,2360,"Thierry Baudet (FvD)",0.825032418556646,0.252109817327209,0
"<anonymized_userid>",6,62357,2361,"Thierry Baudet (FvD)",0.82511181094027,0.252216643520991,0
"<anonymized_userid>",6,62363,2362,"Thierry Baudet (FvD)",0.825191203323895,0.252323469714774,0
"<anonymized_userid>",6,62369,2363,"Thierry Baudet (FvD)",0.825270595707518,0.252430295908557,0
"<anonymized_userid>",6,62375,2364,"Thierry Baudet (FvD)",0.825349988091142,0.252537122102339,0
"<anonymized_userid>",6,62381,2365,"Thierry Baudet (FvD)",0.825429380474766,0.252643948296122,0
"<anonymized_userid>",6,62387,2366,"Thierry Baudet (FvD)",0.82550877285839,0.252750774489905,0
"<anonymized_userid>",6,62393,2367,"Thierry Baudet (FvD)",0.825588165242015,0.252857600683688,0
"<anonymized_userid>",6,62399,2368,"Thierry Baudet (FvD)",0.825667557625638,0.25296442687747,0
"<anonymized_userid>",6,62405,2369,"Thierry Baudet (FvD)",0.825746950009262,0.253071253071253,0
"<anonymized_userid>",6,62411,2370,"Thierry Baudet (FvD)",0.825826342392886,0.253178079265036,0
"<anonymized_userid>",6,62417,2371,"Thierry Baudet (FvD)",0.82590573477651,0.253284905458818,0
"<anonymized_userid>",6,62423,2372,"Thierry Baudet (FvD)",0.825985127160134,0.253391731652601,0
"<anonymized_userid>",6,62429,2373,"Thierry Baudet (FvD)",0.826064519543758,0.253498557846384,0
"<anonymized_userid>",6,62435,2374,"Thierry Baudet (FvD)",0.826143911927382,0.253605384040167,0
"<anonymized_userid>",6,62441,2375,"Thierry Baudet (FvD)",0.826223304311006,0.253712210233949,0
"<anonymized_userid>",6,62447,2376,"Thierry Baudet (FvD)",0.82630269669463,0.253819036427732,0
"<anonymized_userid>",6,62453,2377,"Thierry Baudet (FvD)",0.826382089078254,0.253925862621515,0
"<anonymized_userid>",6,62459,2378,"Thierry Baudet (FvD)",0.826461481461878,0.254032688815298,0
"<anonymized_userid>",6,62465,2379,"Thierry Baudet (FvD)",0.826540873845502,0.25413951500908,0
"<anonymized_userid>",6,62471,2380,"Thierry Baudet (FvD)",0.826620266229126,0.254246341202863,0
"<anonymized_userid>",6,62477,2381,"Thierry Baudet (FvD)",0.82669965861275,0.254353167396646,0
"<anonymized_userid>",6,62483,2382,"Thierry Baudet (FvD)",0.826779050996374,0.254459993590428,0
"<anonymized_userid>",6,62489,2383,"Thierry Baudet (FvD)",0.826858443379998,0.254566819784211,0
"<anonymized_userid>",6,62495,2384,"Thierry Baudet (FvD)",0.826937835763622,0.254673645977994,0
"<anonymized_userid>",6,62501,2385,"Thierry Baudet (FvD)",0.827017228147246,0.254780472171777,0
"<anonymized_userid>",6,62507,2386,"Thierry Baudet (FvD)",0.82709662053087,0.254887298365559,0
"<anonymized_userid>",6,62513,2387,"Thierry Baudet (FvD)",0.827176012914494,0.254994124559342,0
"<anonymized_userid>",6,62519,2388,"Thierry Baudet (FvD)",0.827255405298118,0.255100950753125,0
"<anonymized_userid>",6,62525,2389,"Thierry Baudet (FvD)",0.827334797681742,0.255207776946907,0
"<anonymized_userid>",6,62531,2390,"Thierry Baudet (FvD)",0.827414190065366,0.25531460314069,0
"<anonymized_userid>",6,62537,2391,"Thierry Baudet (FvD)",0.82749358244899,0.255421429334473,0
"<anonymized_userid>",6,62543,2392,"Thierry Baudet (FvD)",0.827572974832614,0.255528255528256,0
"<anonymized_userid>",6,62549,2393,"Thierry Baudet (FvD)",0.827652367216238,0.255635081722038,0
"<anonymized_userid>",6,62555,2394,"Thierry Baudet (FvD)",0.827731759599862,0.255741907915821,0
"<anonymized_userid>",6,62561,2395,"Thierry Baudet (FvD)",0.827811151983486,0.255848734109604,0
"<anonymized_userid>",6,62567,2396,"Thierry Baudet (FvD)",0.82789054436711,0.255955560303386,0
"<anonymized_userid>",6,62573,2397,"Thierry Baudet (FvD)",0.827969936750734,0.256062386497169,0
"<anonymized_userid>",6,62579,2398,"Thierry Baudet (FvD)",0.828049329134358,0.256169212690952,0
"<anonymized_userid>",6,62585,2399,"Thierry Baudet (FvD)",0.828128721517982,0.256276038884735,0
"<anonymized_userid>",6,62591,2400,"Thierry Baudet (FvD)",0.828208113901606,0.256382865078517,0
"<anonymized_userid>",6,62597,2401,"Thierry Baudet (FvD)",0.82828750628523,0.2564896912723,0
"<anonymized_userid>",6,62603,2402,"Thierry Baudet (FvD)",0.828366898668854,0.256596517466083,0
"<anonymized_userid>",6,62609,2403,"Thierry Baudet (FvD)",0.828446291052478,0.256703343659865,0
"<anonymized_userid>",6,62615,2404,"Thierry Baudet (FvD)",0.828525683436102,0.256810169853648,0
"<anonymized_userid>",6,62621,2405,"Thierry Baudet (FvD)",0.828605075819726,0.256916996047431,0
"<anonymized_userid>",6,62627,2406,"Thierry Baudet (FvD)",0.82868446820335,0.257023822241214,0
"<anonymized_userid>",6,62633,2407,"Thierry Baudet (FvD)",0.828763860586974,0.257130648434996,0
"<anonymized_userid>",6,62639,2408,"Thierry Baudet (FvD)",0.828843252970598,0.257237474628779,0
"<anonymized_userid>",6,62645,2409,"Thierry Baudet (FvD)",0.828922645354222,0.257344300822562,0
"<anonymized_userid>",6,62651,2410,"Thierry Baudet (FvD)",0.829002037737846,0.257451127016344,0
"<anonymized_userid>",6,62657,2411,"Thierry Baudet (FvD)",0.82908143012147,0.257557953210127,0
"<anonymized_userid>",6,62663,2412,"Thierry Baudet (FvD)",0.829160822505094,0.25766477940391,0
"<anonymized_userid>",6,62669,2413,"Thierry Baudet (FvD)",0.829240214888718,0.257771605597693,0
"<anonymized_userid>",6,62675,2414,"Thierry Baudet (FvD)",0.829319607272342,0.257878431791475,0
"<anonymized_userid>",6,62681,2415,"Thierry Baudet (FvD)",0.829398999655966,0.257985257985258,0
"<anonymized_userid>",6,62687,2416,"Thierry Baudet (FvD)",0.82947839203959,0.258092084179041,0
"<anonymized_userid>",6,62693,2417,"Thierry Baudet (FvD)",0.829557784423214,0.258198910372823,0
"<anonymized_userid>",6,62699,2418,"Thierry Baudet (FvD)",0.829637176806838,0.258305736566606,0
"<anonymized_userid>",6,62705,2419,"Thierry Baudet (FvD)",0.829716569190462,0.258412562760389,0
"<anonymized_userid>",6,62711,2420,"Thierry Baudet (FvD)",0.829795961574086,0.258519388954172,0
"<anonymized_userid>",6,62717,2421,"Thierry Baudet (FvD)",0.82987535395771,0.258626215147954,0
"<anonymized_userid>",6,62723,2422,"Thierry Baudet (FvD)",0.829954746341334,0.258733041341737,0
"<anonymized_userid>",6,62729,2423,"Thierry Baudet (FvD)",0.830034138724958,0.25883986753552,0
"<anonymized_userid>",6,62735,2424,"Thierry Baudet (FvD)",0.830113531108582,0.258946693729302,0
"<anonymized_userid>",6,62741,2425,"Thierry Baudet (FvD)",0.830192923492206,0.259053519923085,0
"<anonymized_userid>",6,62747,2426,"Thierry Baudet (FvD)",0.83027231587583,0.259160346116868,0
"<anonymized_userid>",6,62753,2427,"Thierry Baudet (FvD)",0.830351708259454,0.259267172310651,0
"<anonymized_userid>",6,62759,2428,"Thierry Baudet (FvD)",0.830431100643078,0.259373998504433,0
"<anonymized_userid>",6,62765,2429,"Thierry Baudet (FvD)",0.830510493026702,0.259480824698216,0
"<anonymized_userid>",6,62771,2430,"Thierry Baudet (FvD)",0.830589885410326,0.259587650891999,0
"<anonymized_userid>",6,62777,2431,"Thierry Baudet (FvD)",0.83066927779395,0.259694477085781,0
"<anonymized_userid>",6,62783,2432,"Thierry Baudet (FvD)",0.830748670177574,0.259801303279564,0
"<anonymized_userid>",6,62789,2433,"Thierry Baudet (FvD)",0.830828062561198,0.259908129473347,0
"<anonymized_userid>",6,62795,2434,"Thierry Baudet (FvD)",0.830907454944822,0.26001495566713,0
"<anonymized_userid>",6,62801,2435,"Thierry Baudet (FvD)",0.830986847328446,0.260121781860912,0
"<anonymized_userid>",6,62807,2436,"Thierry Baudet (FvD)",0.83106623971207,0.260228608054695,0
"<anonymized_userid>",6,62813,2437,"Thierry Baudet (FvD)",0.831145632095694,0.260335434248478,0
"<anonymized_userid>",6,62819,2438,"Thierry Baudet (FvD)",0.831225024479318,0.26044226044226,0
"<anonymized_userid>",6,62825,2439,"Thierry Baudet (FvD)",0.831304416862942,0.260549086636043,0
"<anonymized_userid>",6,62831,2440,"Thierry Baudet (FvD)",0.831383809246566,0.260655912829826,0
"<anonymized_userid>",6,62837,2441,"Thierry Baudet (FvD)",0.83146320163019,0.260762739023609,0
"<anonymized_userid>",6,62843,2442,"Thierry Baudet (FvD)",0.831542594013814,0.260869565217391,0
"<anonymized_userid>",6,62849,2443,"Thierry Baudet (FvD)",0.831621986397438,0.260976391411174,0
"<anonymized_userid>",6,62855,2444,"Thierry Baudet (FvD)",0.831701378781062,0.261083217604957,0
"<anonymized_userid>",6,62861,2445,"Thierry Baudet (FvD)",0.831780771164686,0.261190043798739,0
"<anonymized_userid>",6,62867,2446,"Thierry Baudet (FvD)",0.83186016354831,0.261296869992522,0
"<anonymized_userid>",6,62873,2447,"Thierry Baudet (FvD)",0.831939555931934,0.261403696186305,0
"<anonymized_userid>",6,62879,2448,"Thierry Baudet (FvD)",0.832018948315558,0.261510522380088,0
"<anonymized_userid>",6,62885,2449,"Thierry Baudet (FvD)",0.832098340699182,0.26161734857387,0
"<anonymized_userid>",6,62891,2450,"Thierry Baudet (FvD)",0.832177733082806,0.261724174767653,0
"<anonymized_userid>",6,62897,2451,"Thierry Baudet (FvD)",0.83225712546643,0.261831000961436,0
"<anonymized_userid>",6,62903,2452,"Thierry Baudet (FvD)",0.832336517850054,0.261937827155218,0
"<anonymized_userid>",6,62909,2453,"Thierry Baudet (FvD)",0.832415910233678,0.262044653349001,0
"<anonymized_userid>",6,62915,2454,"Thierry Baudet (FvD)",0.832495302617302,0.262151479542784,0
"<anonymized_userid>",6,62921,2455,"Thierry Baudet (FvD)",0.832574695000926,0.262258305736567,0
"<anonymized_userid>",6,62927,2456,"Thierry Baudet (FvD)",0.83265408738455,0.262365131930349,0
"<anonymized_userid>",6,62933,2457,"Thierry Baudet (FvD)",0.832733479768174,0.262471958124132,0
"<anonymized_userid>",6,62939,2458,"Thierry Baudet (FvD)",0.832812872151798,0.262578784317915,0
"<anonymized_userid>",6,62945,2459,"Thierry Baudet (FvD)",0.832892264535422,0.262685610511697,0
"<anonymized_userid>",6,62951,2460,"Thierry Baudet (FvD)",0.832971656919046,0.26279243670548,0
"<anonymized_userid>",6,62957,2461,"Thierry Baudet (FvD)",0.83305104930267,0.262899262899263,0
"<anonymized_userid>",6,62963,2462,"Thierry Baudet (FvD)",0.833130441686294,0.263006089093046,0
"<anonymized_userid>",6,62969,2463,"Thierry Baudet (FvD)",0.833209834069918,0.263112915286828,0
"<anonymized_userid>",6,62975,2464,"Thierry Baudet (FvD)",0.833289226453542,0.263219741480611,0
"<anonymized_userid>",6,62981,2465,"Thierry Baudet (FvD)",0.833368618837166,0.263326567674394,0
"<anonymized_userid>",6,62987,2466,"Thierry Baudet (FvD)",0.83344801122079,0.263433393868176,0
"<anonymized_userid>",6,62993,2467,"Thierry Baudet (FvD)",0.833527403604414,0.263540220061959,0
"<anonymized_userid>",6,62999,2468,"Thierry Baudet (FvD)",0.833606795988038,0.263647046255742,0
"<anonymized_userid>",6,63005,2469,"Thierry Baudet (FvD)",0.833686188371662,0.263753872449525,0
"<anonymized_userid>",6,63011,2470,"Thierry Baudet (FvD)",0.833765580755286,0.263860698643307,0
"<anonymized_userid>",6,63017,2471,"Thierry Baudet (FvD)",0.83384497313891,0.26396752483709,0
"<anonymized_userid>",6,63023,2472,"Thierry Baudet (FvD)",0.833924365522534,0.264074351030873,0
"<anonymized_userid>",6,63029,2473,"Thierry Baudet (FvD)",0.834003757906158,0.264181177224656,0
"<anonymized_userid>",6,63035,2474,"Thierry Baudet (FvD)",0.834083150289782,0.264288003418438,0
"<anonymized_userid>",6,63041,2475,"Thierry Baudet (FvD)",0.834162542673406,0.264394829612221,0
"<anonymized_userid>",6,63047,2476,"Thierry Baudet (FvD)",0.83424193505703,0.264501655806004,0
"<anonymized_userid>",6,63053,2477,"Thierry Baudet (FvD)",0.834321327440654,0.264608481999786,0
"<anonymized_userid>",6,63059,2478,"Thierry Baudet (FvD)",0.834400719824278,0.264715308193569,0
"<anonymized_userid>",6,63065,2479,"Thierry Baudet (FvD)",0.834480112207902,0.264822134387352,0
"<anonymized_userid>",6,63071,2480,"Thierry Baudet (FvD)",0.834559504591526,0.264928960581135,0
"<anonymized_userid>",6,63077,2481,"Thierry Baudet (FvD)",0.83463889697515,0.265035786774917,0
"<anonymized_userid>",6,63083,2482,"Thierry Baudet (FvD)",0.834718289358774,0.2651426129687,0
"<anonymized_userid>",6,63089,2483,"Thierry Baudet (FvD)",0.834797681742398,0.265249439162483,0
"<anonymized_userid>",6,63095,2484,"Thierry Baudet (FvD)",0.834877074126022,0.265356265356265,0
"<anonymized_userid>",6,63101,2485,"Thierry Baudet (FvD)",0.834956466509646,0.265463091550048,0
"<anonymized_userid>",6,63107,2486,"Thierry Baudet (FvD)",0.83503585889327,0.265569917743831,0
"<anonymized_userid>",6,63113,2487,"Thierry Baudet (FvD)",0.835115251276894,0.265676743937613,0
"<anonymized_userid>",6,63119,2488,"Thierry Baudet (FvD)",0.835194643660518,0.265783570131396,0
"<anonymized_userid>",6,63125,2489,"Thierry Baudet (FvD)",0.835274036044142,0.265890396325179,0
"<anonymized_userid>",6,63131,2490,"Thierry Baudet (FvD)",0.835353428427766,0.265997222518962,0
"<anonymized_userid>",6,63137,2491,"Thierry Baudet (FvD)",0.83543282081139,0.266104048712744,0
"<anonymized_userid>",6,63143,2492,"Thierry Baudet (FvD)",0.835512213195014,0.266210874906527,0
"<anonymized_userid>",6,63149,2493,"Thierry Baudet (FvD)",0.835591605578638,0.26631770110031,0
"<anonymized_userid>",6,63155,2494,"Thierry Baudet (FvD)",0.835670997962262,0.266424527294092,0
"<anonymized_userid>",6,63161,2495,"Thierry Baudet (FvD)",0.835750390345886,0.266531353487875,0
"<anonymized_userid>",6,63167,2496,"Thierry Baudet (FvD)",0.83582978272951,0.266638179681658,0
"<anonymized_userid>",6,63173,2497,"Thierry Baudet (FvD)",0.835909175113134,0.266745005875441,0
"<anonymized_userid>",6,63179,2498,"Thierry Baudet (FvD)",0.835988567496758,0.266851832069223,0
"<anonymized_userid>",6,63185,2499,"Thierry Baudet (FvD)",0.836067959880382,0.266958658263006,0
"<anonymized_userid>",6,63191,2500,"Thierry Baudet (FvD)",0.836147352264006,0.267065484456789,0
"<anonymized_userid>",6,63197,2501,"Thierry Baudet (FvD)",0.83622674464763,0.267172310650572,0
"<anonymized_userid>",6,63203,2502,"Thierry Baudet (FvD)",0.836306137031254,0.267279136844354,0
"<anonymized_userid>",6,63209,2503,"Thierry Baudet (FvD)",0.836385529414878,0.267385963038137,0
"<anonymized_userid>",6,63215,2504,"Thierry Baudet (FvD)",0.836464921798502,0.26749278923192,0
"<anonymized_userid>",6,63221,2505,"Thierry Baudet (FvD)",0.836544314182126,0.267599615425702,0
"<anonymized_userid>",6,63227,2506,"Thierry Baudet (FvD)",0.83662370656575,0.267706441619485,0
"<anonymized_userid>",6,63233,2507,"Thierry Baudet (FvD)",0.836703098949374,0.267813267813268,0
"<anonymized_userid>",6,63239,2508,"Thierry Baudet (FvD)",0.836782491332998,0.267920094007051,0
"<anonymized_userid>",6,63245,2509,"Thierry Baudet (FvD)",0.836861883716622,0.268026920200833,0
"<anonymized_userid>",6,63251,2510,"Thierry Baudet (FvD)",0.836941276100246,0.268133746394616,0
"<anonymized_userid>",6,63257,2511,"Thierry Baudet (FvD)",0.83702066848387,0.268240572588399,0
"<anonymized_userid>",6,63263,2512,"Thierry Baudet (FvD)",0.837100060867494,0.268347398782181,0
"<anonymized_userid>",5,63268,2513,"Thierry Baudet (FvD)",0.837166221187181,0.268454224975964,0
"<anonymized_userid>",5,63273,2514,"Thierry Baudet (FvD)",0.837232381506867,0.268561051169747,0
"<anonymized_userid>",5,63278,2515,"Thierry Baudet (FvD)",0.837298541826554,0.26866787736353,0
"<anonymized_userid>",5,63283,2516,"Thierry Baudet (FvD)",0.837364702146241,0.268774703557312,0
"<anonymized_userid>",5,63288,2517,"Thierry Baudet (FvD)",0.837430862465927,0.268881529751095,0
"<anonymized_userid>",5,63293,2518,"Thierry Baudet (FvD)",0.837497022785614,0.268988355944878,0
"<anonymized_userid>",5,63298,2519,"Thierry Baudet (FvD)",0.837563183105301,0.26909518213866,0
"<anonymized_userid>",5,63303,2520,"Thierry Baudet (FvD)",0.837629343424987,0.269202008332443,0
"<anonymized_userid>",5,63308,2521,"Thierry Baudet (FvD)",0.837695503744674,0.269308834526226,0
"<anonymized_userid>",5,63313,2522,"Thierry Baudet (FvD)",0.837761664064361,0.269415660720009,0
"<anonymized_userid>",5,63318,2523,"Thierry Baudet (FvD)",0.837827824384047,0.269522486913791,0
"<anonymized_userid>",5,63323,2524,"Thierry Baudet (FvD)",0.837893984703734,0.269629313107574,0
"<anonymized_userid>",5,63328,2525,"Thierry Baudet (FvD)",0.837960145023421,0.269736139301357,0
"<anonymized_userid>",5,63333,2526,"Thierry Baudet (FvD)",0.838026305343107,0.269842965495139,0
"<anonymized_userid>",5,63338,2527,"Thierry Baudet (FvD)",0.838092465662794,0.269949791688922,0
"<anonymized_userid>",5,63343,2528,"Thierry Baudet (FvD)",0.838158625982481,0.270056617882705,0
"<anonymized_userid>",5,63348,2529,"Thierry Baudet (FvD)",0.838224786302167,0.270163444076488,0
"<anonymized_userid>",5,63353,2530,"Thierry Baudet (FvD)",0.838290946621854,0.27027027027027,0
"<anonymized_userid>",5,63358,2531,"Thierry Baudet (FvD)",0.838357106941541,0.270377096464053,0
"<anonymized_userid>",5,63363,2532,"Thierry Baudet (FvD)",0.838423267261227,0.270483922657836,0
"<anonymized_userid>",5,63368,2533,"Thierry Baudet (FvD)",0.838489427580914,0.270590748851618,0
"<anonymized_userid>",5,63373,2534,"Thierry Baudet (FvD)",0.838555587900601,0.270697575045401,0
"<anonymized_userid>",5,63378,2535,"Thierry Baudet (FvD)",0.838621748220287,0.270804401239184,0
"<anonymized_userid>",5,63383,2536,"Thierry Baudet (FvD)",0.838687908539974,0.270911227432967,0
"<anonymized_userid>",5,63388,2537,"Thierry Baudet (FvD)",0.838754068859661,0.271018053626749,0
"<anonymized_userid>",5,63393,2538,"Thierry Baudet (FvD)",0.838820229179347,0.271124879820532,0
"<anonymized_userid>",5,63398,2539,"Thierry Baudet (FvD)",0.838886389499034,0.271231706014315,0
"<anonymized_userid>",5,63403,2540,"Thierry Baudet (FvD)",0.838952549818721,0.271338532208097,0
"<anonymized_userid>",5,63408,2541,"Thierry Baudet (FvD)",0.839018710138407,0.27144535840188,0
"<anonymized_userid>",5,63413,2542,"Thierry Baudet (FvD)",0.839084870458094,0.271552184595663,0
"<anonymized_userid>",5,63418,2543,"Thierry Baudet (FvD)",0.839151030777781,0.271659010789446,0
"<anonymized_userid>",5,63423,2544,"Thierry Baudet (FvD)",0.839217191097467,0.271765836983228,0
"<anonymized_userid>",5,63428,2545,"Thierry Baudet (FvD)",0.839283351417154,0.271872663177011,0
"<anonymized_userid>",5,63433,2546,"Thierry Baudet (FvD)",0.839349511736841,0.271979489370794,0
"<anonymized_userid>",5,63438,2547,"Thierry Baudet (FvD)",0.839415672056527,0.272086315564576,0
"<anonymized_userid>",5,63443,2548,"Thierry Baudet (FvD)",0.839481832376214,0.272193141758359,0
"<anonymized_userid>",5,63448,2549,"Thierry Baudet (FvD)",0.839547992695901,0.272299967952142,0
"<anonymized_userid>",5,63453,2550,"Thierry Baudet (FvD)",0.839614153015587,0.272406794145925,0
"<anonymized_userid>",5,63458,2551,"Thierry Baudet (FvD)",0.839680313335274,0.272513620339707,0
"<anonymized_userid>",5,63463,2552,"Thierry Baudet (FvD)",0.839746473654961,0.27262044653349,0
"<anonymized_userid>",5,63468,2553,"Thierry Baudet (FvD)",0.839812633974647,0.272727272727273,0
"<anonymized_userid>",5,63473,2554,"Thierry Baudet (FvD)",0.839878794294334,0.272834098921055,0
"<anonymized_userid>",5,63478,2555,"Thierry Baudet (FvD)",0.839944954614021,0.272940925114838,0
"<anonymized_userid>",5,63483,2556,"Thierry Baudet (FvD)",0.840011114933707,0.273047751308621,0
"<anonymized_userid>",5,63488,2557,"Thierry Baudet (FvD)",0.840077275253394,0.273154577502404,0
"<anonymized_userid>",5,63493,2558,"Thierry Baudet (FvD)",0.840143435573081,0.273261403696186,0
"<anonymized_userid>",5,63498,2559,"Thierry Baudet (FvD)",0.840209595892767,0.273368229889969,0
"<anonymized_userid>",5,63503,2560,"Thierry Baudet (FvD)",0.840275756212454,0.273475056083752,0
"<anonymized_userid>",5,63508,2561,"Thierry Baudet (FvD)",0.840341916532141,0.273581882277534,0
"<anonymized_userid>",5,63513,2562,"Thierry Baudet (FvD)",0.840408076851827,0.273688708471317,0
"<anonymized_userid>",5,63518,2563,"Thierry Baudet (FvD)",0.840474237171514,0.2737955346651,0
"<anonymized_userid>",5,63523,2564,"Thierry Baudet (FvD)",0.840540397491201,0.273902360858883,0
"<anonymized_userid>",5,63528,2565,"Thierry Baudet (FvD)",0.840606557810887,0.274009187052665,0
"<anonymized_userid>",5,63533,2566,"Thierry Baudet (FvD)",0.840672718130574,0.274116013246448,0
"<anonymized_userid>",5,63538,2567,"Thierry Baudet (FvD)",0.840738878450261,0.274222839440231,0
"<anonymized_userid>",5,63543,2568,"Thierry Baudet (FvD)",0.840805038769947,0.274329665634013,0
"<anonymized_userid>",5,63548,2569,"Thierry Baudet (FvD)",0.840871199089634,0.274436491827796,0
"<anonymized_userid>",5,63553,2570,"Thierry Baudet (FvD)",0.840937359409321,0.274543318021579,0
"<anonymized_userid>",5,63558,2571,"Thierry Baudet (FvD)",0.841003519729007,0.274650144215362,0
"<anonymized_userid>",5,63563,2572,"Thierry Baudet (FvD)",0.841069680048694,0.274756970409144,0
"<anonymized_userid>",5,63568,2573,"Thierry Baudet (FvD)",0.841135840368381,0.274863796602927,0
"<anonymized_userid>",5,63573,2574,"Thierry Baudet (FvD)",0.841202000688067,0.27497062279671,0
"<anonymized_userid>",5,63578,2575,"Thierry Baudet (FvD)",0.841268161007754,0.275077448990492,0
"<anonymized_userid>",5,63583,2576,"Thierry Baudet (FvD)",0.841334321327441,0.275184275184275,0
"<anonymized_userid>",5,63588,2577,"Thierry Baudet (FvD)",0.841400481647127,0.275291101378058,0
"<anonymized_userid>",5,63593,2578,"Thierry Baudet (FvD)",0.841466641966814,0.275397927571841,0
"<anonymized_userid>",5,63598,2579,"Thierry Baudet (FvD)",0.841532802286501,0.275504753765623,0
"<anonymized_userid>",5,63603,2580,"Thierry Baudet (FvD)",0.841598962606187,0.275611579959406,0
"<anonymized_userid>",5,63608,2581,"Thierry Baudet (FvD)",0.841665122925874,0.275718406153189,0
"<anonymized_userid>",5,63613,2582,"Thierry Baudet (FvD)",0.841731283245561,0.275825232346971,0
"<anonymized_userid>",5,63618,2583,"Thierry Baudet (FvD)",0.841797443565247,0.275932058540754,0
"<anonymized_userid>",5,63623,2584,"Thierry Baudet (FvD)",0.841863603884934,0.276038884734537,0
"<anonymized_userid>",5,63628,2585,"Thierry Baudet (FvD)",0.841929764204621,0.27614571092832,0
"<anonymized_userid>",5,63633,2586,"Thierry Baudet (FvD)",0.841995924524307,0.276252537122102,0
"<anonymized_userid>",5,63638,2587,"Thierry Baudet (FvD)",0.842062084843994,0.276359363315885,0
"<anonymized_userid>",5,63643,2588,"Thierry Baudet (FvD)",0.842128245163681,0.276466189509668,0
"<anonymized_userid>",5,63648,2589,"Thierry Baudet (FvD)",0.842194405483367,0.27657301570345,0
"<anonymized_userid>",5,63653,2590,"Thierry Baudet (FvD)",0.842260565803054,0.276679841897233,0
"<anonymized_userid>",5,63658,2591,"Thierry Baudet (FvD)",0.842326726122741,0.276786668091016,0
"<anonymized_userid>",5,63663,2592,"Thierry Baudet (FvD)",0.842392886442427,0.276893494284799,0
"<anonymized_userid>",5,63668,2593,"Thierry Baudet (FvD)",0.842459046762114,0.277000320478581,0
"<anonymized_userid>",5,63673,2594,"Thierry Baudet (FvD)",0.842525207081801,0.277107146672364,0
"<anonymized_userid>",5,63678,2595,"Thierry Baudet (FvD)",0.842591367401487,0.277213972866147,0
"<anonymized_userid>",5,63683,2596,"Thierry Baudet (FvD)",0.842657527721174,0.27732079905993,0
"<anonymized_userid>",5,63688,2597,"Thierry Baudet (FvD)",0.842723688040861,0.277427625253712,0
"<anonymized_userid>",5,63693,2598,"Thierry Baudet (FvD)",0.842789848360547,0.277534451447495,0
"<anonymized_userid>",5,63698,2599,"Thierry Baudet (FvD)",0.842856008680234,0.277641277641278,0
"<anonymized_userid>",5,63703,2600,"Thierry Baudet (FvD)",0.842922168999921,0.27774810383506,0
"<anonymized_userid>",5,63708,2601,"Thierry Baudet (FvD)",0.842988329319607,0.277854930028843,0
"<anonymized_userid>",5,63713,2602,"Thierry Baudet (FvD)",0.843054489639294,0.277961756222626,0
"<anonymized_userid>",5,63718,2603,"Thierry Baudet (FvD)",0.843120649958981,0.278068582416409,0
"<anonymized_userid>",5,63723,2604,"Thierry Baudet (FvD)",0.843186810278667,0.278175408610191,0
"<anonymized_userid>",5,63728,2605,"Thierry Baudet (FvD)",0.843252970598354,0.278282234803974,0
"<anonymized_userid>",5,63733,2606,"Thierry Baudet (FvD)",0.843319130918041,0.278389060997757,0
"<anonymized_userid>",5,63738,2607,"Thierry Baudet (FvD)",0.843385291237727,0.278495887191539,0
"<anonymized_userid>",5,63743,2608,"Thierry Baudet (FvD)",0.843451451557414,0.278602713385322,0
"<anonymized_userid>",5,63748,2609,"Thierry Baudet (FvD)",0.843517611877101,0.278709539579105,0
"<anonymized_userid>",5,63753,2610,"Thierry Baudet (FvD)",0.843583772196787,0.278816365772887,0
"<anonymized_userid>",5,63758,2611,"Thierry Baudet (FvD)",0.843649932516474,0.27892319196667,0
"<anonymized_userid>",5,63763,2612,"Thierry Baudet (FvD)",0.843716092836161,0.279030018160453,0
"<anonymized_userid>",5,63768,2613,"Thierry Baudet (FvD)",0.843782253155847,0.279136844354236,0
"<anonymized_userid>",5,63773,2614,"Thierry Baudet (FvD)",0.843848413475534,0.279243670548018,0
"<anonymized_userid>",5,63778,2615,"Thierry Baudet (FvD)",0.843914573795221,0.279350496741801,0
"<anonymized_userid>",5,63783,2616,"Thierry Baudet (FvD)",0.843980734114907,0.279457322935584,0
"<anonymized_userid>",5,63788,2617,"Thierry Baudet (FvD)",0.844046894434594,0.279564149129367,0
"<anonymized_userid>",5,63793,2618,"Thierry Baudet (FvD)",0.844113054754281,0.279670975323149,0
"<anonymized_userid>",5,63798,2619,"Thierry Baudet (FvD)",0.844179215073967,0.279777801516932,0
"<anonymized_userid>",5,63803,2620,"Thierry Baudet (FvD)",0.844245375393654,0.279884627710715,0
"<anonymized_userid>",5,63808,2621,"Thierry Baudet (FvD)",0.844311535713341,0.279991453904497,0
"<anonymized_userid>",5,63813,2622,"Thierry Baudet (FvD)",0.844377696033027,0.28009828009828,0
"<anonymized_userid>",5,63818,2623,"Thierry Baudet (FvD)",0.844443856352714,0.280205106292063,0
"<anonymized_userid>",5,63823,2624,"Thierry Baudet (FvD)",0.844510016672401,0.280311932485846,0
"<anonymized_userid>",5,63828,2625,"Thierry Baudet (FvD)",0.844576176992087,0.280418758679628,0
"<anonymized_userid>",5,63833,2626,"Thierry Baudet (FvD)",0.844642337311774,0.280525584873411,0
"<anonymized_userid>",5,63838,2627,"Thierry Baudet (FvD)",0.844708497631461,0.280632411067194,0
"<anonymized_userid>",5,63843,2628,"Thierry Baudet (FvD)",0.844774657951147,0.280739237260976,0
"<anonymized_userid>",5,63848,2629,"Thierry Baudet (FvD)",0.844840818270834,0.280846063454759,0
"<anonymized_userid>",5,63853,2630,"Thierry Baudet (FvD)",0.844906978590521,0.280952889648542,0
"<anonymized_userid>",5,63858,2631,"Thierry Baudet (FvD)",0.844973138910207,0.281059715842325,0
"<anonymized_userid>",5,63863,2632,"Thierry Baudet (FvD)",0.845039299229894,0.281166542036107,0
"<anonymized_userid>",5,63868,2633,"Thierry Baudet (FvD)",0.84510545954958,0.28127336822989,0
"<anonymized_userid>",5,63873,2634,"Thierry Baudet (FvD)",0.845171619869267,0.281380194423673,0
"<anonymized_userid>",5,63878,2635,"Thierry Baudet (FvD)",0.845237780188954,0.281487020617455,0
"<anonymized_userid>",5,63883,2636,"Thierry Baudet (FvD)",0.845303940508641,0.281593846811238,0
"<anonymized_userid>",5,63888,2637,"Thierry Baudet (FvD)",0.845370100828327,0.281700673005021,0
"<anonymized_userid>",5,63893,2638,"Thierry Baudet (FvD)",0.845436261148014,0.281807499198804,0
"<anonymized_userid>",5,63898,2639,"Thierry Baudet (FvD)",0.8455024214677,0.281914325392586,0
"<anonymized_userid>",5,63903,2640,"Thierry Baudet (FvD)",0.845568581787387,0.282021151586369,0
"<anonymized_userid>",5,63908,2641,"Thierry Baudet (FvD)",0.845634742107074,0.282127977780152,0
"<anonymized_userid>",5,63913,2642,"Thierry Baudet (FvD)",0.845700902426761,0.282234803973934,0
"<anonymized_userid>",5,63918,2643,"Thierry Baudet (FvD)",0.845767062746447,0.282341630167717,0
"<anonymized_userid>",5,63923,2644,"Thierry Baudet (FvD)",0.845833223066134,0.2824484563615,0
"<anonymized_userid>",5,63928,2645,"Thierry Baudet (FvD)",0.84589938338582,0.282555282555283,0
"<anonymized_userid>",5,63933,2646,"Thierry Baudet (FvD)",0.845965543705507,0.282662108749065,0
"<anonymized_userid>",5,63938,2647,"Thierry Baudet (FvD)",0.846031704025194,0.282768934942848,0
"<anonymized_userid>",5,63943,2648,"Thierry Baudet (FvD)",0.846097864344881,0.282875761136631,0
"<anonymized_userid>",5,63948,2649,"Thierry Baudet (FvD)",0.846164024664567,0.282982587330413,0
"<anonymized_userid>",5,63953,2650,"Thierry Baudet (FvD)",0.846230184984254,0.283089413524196,0
"<anonymized_userid>",5,63958,2651,"Thierry Baudet (FvD)",0.84629634530394,0.283196239717979,0
"<anonymized_userid>",5,63963,2652,"Thierry Baudet (FvD)",0.846362505623627,0.283303065911762,0
"<anonymized_userid>",5,63968,2653,"Thierry Baudet (FvD)",0.846428665943314,0.283409892105544,0
"<anonymized_userid>",5,63973,2654,"Thierry Baudet (FvD)",0.846494826263001,0.283516718299327,0
"<anonymized_userid>",5,63978,2655,"Thierry Baudet (FvD)",0.846560986582687,0.28362354449311,0
"<anonymized_userid>",5,63983,2656,"Thierry Baudet (FvD)",0.846627146902374,0.283730370686892,0
"<anonymized_userid>",5,63988,2657,"Thierry Baudet (FvD)",0.84669330722206,0.283837196880675,0
"<anonymized_userid>",5,63993,2658,"Thierry Baudet (FvD)",0.846759467541747,0.283944023074458,0
"<anonymized_userid>",5,63998,2659,"Thierry Baudet (FvD)",0.846825627861434,0.284050849268241,0
"<anonymized_userid>",5,64003,2660,"Thierry Baudet (FvD)",0.846891788181121,0.284157675462023,0
"<anonymized_userid>",5,64008,2661,"Thierry Baudet (FvD)",0.846957948500807,0.284264501655806,0
"<anonymized_userid>",5,64013,2662,"Thierry Baudet (FvD)",0.847024108820494,0.284371327849589,0
"<anonymized_userid>",5,64018,2663,"Thierry Baudet (FvD)",0.84709026914018,0.284478154043371,0
"<anonymized_userid>",5,64023,2664,"Thierry Baudet (FvD)",0.847156429459867,0.284584980237154,0
"<anonymized_userid>",5,64028,2665,"Thierry Baudet (FvD)",0.847222589779554,0.284691806430937,0
"<anonymized_userid>",5,64033,2666,"Thierry Baudet (FvD)",0.84728875009924,0.28479863262472,0
"<anonymized_userid>",5,64038,2667,"Thierry Baudet (FvD)",0.847354910418927,0.284905458818502,0
"<anonymized_userid>",5,64043,2668,"Thierry Baudet (FvD)",0.847421070738614,0.285012285012285,0
"<anonymized_userid>",5,64048,2669,"Thierry Baudet (FvD)",0.8474872310583,0.285119111206068,0
"<anonymized_userid>",5,64053,2670,"Thierry Baudet (FvD)",0.847553391377987,0.28522593739985,0
"<anonymized_userid>",5,64058,2671,"Thierry Baudet (FvD)",0.847619551697674,0.285332763593633,0
"<anonymized_userid>",5,64063,2672,"Thierry Baudet (FvD)",0.84768571201736,0.285439589787416,0
"<anonymized_userid>",5,64068,2673,"Thierry Baudet (FvD)",0.847751872337047,0.285546415981199,0
"<anonymized_userid>",5,64073,2674,"Thierry Baudet (FvD)",0.847818032656734,0.285653242174981,0
"<anonymized_userid>",5,64078,2675,"Thierry Baudet (FvD)",0.84788419297642,0.285760068368764,0
"<anonymized_userid>",5,64083,2676,"Thierry Baudet (FvD)",0.847950353296107,0.285866894562547,0
"<anonymized_userid>",5,64088,2677,"Thierry Baudet (FvD)",0.848016513615794,0.285973720756329,0
"<anonymized_userid>",5,64093,2678,"Thierry Baudet (FvD)",0.84808267393548,0.286080546950112,0
"<anonymized_userid>",5,64098,2679,"Thierry Baudet (FvD)",0.848148834255167,0.286187373143895,0
"<anonymized_userid>",5,64103,2680,"Thierry Baudet (FvD)",0.848214994574854,0.286294199337678,0
"<anonymized_userid>",5,64108,2681,"Thierry Baudet (FvD)",0.84828115489454,0.28640102553146,0
"<anonymized_userid>",5,64113,2682,"Thierry Baudet (FvD)",0.848347315214227,0.286507851725243,0
"<anonymized_userid>",5,64118,2683,"Thierry Baudet (FvD)",0.848413475533914,0.286614677919026,0
"<anonymized_userid>",5,64123,2684,"Thierry Baudet (FvD)",0.8484796358536,0.286721504112808,0
"<anonymized_userid>",5,64128,2685,"Thierry Baudet (FvD)",0.848545796173287,0.286828330306591,0
"<anonymized_userid>",5,64133,2686,"Thierry Baudet (FvD)",0.848611956492974,0.286935156500374,0
"<anonymized_userid>",5,64138,2687,"Thierry Baudet (FvD)",0.84867811681266,0.287041982694157,0
"<anonymized_userid>",5,64143,2688,"Thierry Baudet (FvD)",0.848744277132347,0.287148808887939,0
"<anonymized_userid>",5,64148,2689,"Thierry Baudet (FvD)",0.848810437452034,0.287255635081722,0
"<anonymized_userid>",5,64153,2690,"Thierry Baudet (FvD)",0.84887659777172,0.287362461275505,0
"<anonymized_userid>",5,64158,2691,"Thierry Baudet (FvD)",0.848942758091407,0.287469287469287,0
"<anonymized_userid>",5,64163,2692,"Thierry Baudet (FvD)",0.849008918411094,0.28757611366307,0
"<anonymized_userid>",5,64168,2693,"Thierry Baudet (FvD)",0.84907507873078,0.287682939856853,0
"<anonymized_userid>",5,64173,2694,"Thierry Baudet (FvD)",0.849141239050467,0.287789766050636,0
"<anonymized_userid>",5,64178,2695,"Thierry Baudet (FvD)",0.849207399370154,0.287896592244418,0
"<anonymized_userid>",5,64183,2696,"Thierry Baudet (FvD)",0.84927355968984,0.288003418438201,0
"<anonymized_userid>",5,64188,2697,"Thierry Baudet (FvD)",0.849339720009527,0.288110244631984,0
"<anonymized_userid>",5,64193,2698,"Thierry Baudet (FvD)",0.849405880329214,0.288217070825766,0
"<anonymized_userid>",5,64198,2699,"Thierry Baudet (FvD)",0.8494720406489,0.288323897019549,0
"<anonymized_userid>",5,64203,2700,"Thierry Baudet (FvD)",0.849538200968587,0.288430723213332,0
"<anonymized_userid>",5,64208,2701,"Thierry Baudet (FvD)",0.849604361288274,0.288537549407115,0
"<anonymized_userid>",5,64213,2702,"Thierry Baudet (FvD)",0.84967052160796,0.288644375600897,0
"<anonymized_userid>",5,64218,2703,"Thierry Baudet (FvD)",0.849736681927647,0.28875120179468,0
"<anonymized_userid>",5,64223,2704,"Thierry Baudet (FvD)",0.849802842247334,0.288858027988463,0
"<anonymized_userid>",5,64228,2705,"Thierry Baudet (FvD)",0.84986900256702,0.288964854182245,0
"<anonymized_userid>",5,64233,2706,"Thierry Baudet (FvD)",0.849935162886707,0.289071680376028,0
"<anonymized_userid>",5,64238,2707,"Thierry Baudet (FvD)",0.850001323206394,0.289178506569811,0
"<anonymized_userid>",5,64243,2708,"Thierry Baudet (FvD)",0.85006748352608,0.289285332763594,0
"<anonymized_userid>",5,64248,2709,"Thierry Baudet (FvD)",0.850133643845767,0.289392158957376,0
"<anonymized_userid>",5,64253,2710,"Thierry Baudet (FvD)",0.850199804165454,0.289498985151159,0
"<anonymized_userid>",5,64258,2711,"Thierry Baudet (FvD)",0.85026596448514,0.289605811344942,0
"<anonymized_userid>",5,64263,2712,"Thierry Baudet (FvD)",0.850332124804827,0.289712637538725,0
"<anonymized_userid>",5,64268,2713,"Thierry Baudet (FvD)",0.850398285124514,0.289819463732507,0
"<anonymized_userid>",5,64273,2714,"Thierry Baudet (FvD)",0.8504644454442,0.28992628992629,0
"<anonymized_userid>",5,64278,2715,"Thierry Baudet (FvD)",0.850530605763887,0.290033116120073,0
"<anonymized_userid>",5,64283,2716,"Thierry Baudet (FvD)",0.850596766083574,0.290139942313855,0
"<anonymized_userid>",5,64288,2717,"Thierry Baudet (FvD)",0.85066292640326,0.290246768507638,0
"<anonymized_userid>",5,64293,2718,"Thierry Baudet (FvD)",0.850729086722947,0.290353594701421,0
"<anonymized_userid>",5,64298,2719,"Thierry Baudet (FvD)",0.850795247042634,0.290460420895204,0
"<anonymized_userid>",5,64303,2720,"Thierry Baudet (FvD)",0.85086140736232,0.290567247088986,0
"<anonymized_userid>",5,64308,2721,"Thierry Baudet (FvD)",0.850927567682007,0.290674073282769,0
"<anonymized_userid>",5,64313,2722,"Thierry Baudet (FvD)",0.850993728001694,0.290780899476552,0
"<anonymized_userid>",5,64318,2723,"Thierry Baudet (FvD)",0.85105988832138,0.290887725670334,0
"<anonymized_userid>",5,64323,2724,"Thierry Baudet (FvD)",0.851126048641067,0.290994551864117,0
"<anonymized_userid>",5,64328,2725,"Thierry Baudet (FvD)",0.851192208960754,0.2911013780579,0
"<anonymized_userid>",5,64333,2726,"Thierry Baudet (FvD)",0.85125836928044,0.291208204251683,0
"<anonymized_userid>",5,64338,2727,"Thierry Baudet (FvD)",0.851324529600127,0.291315030445465,0
"<anonymized_userid>",5,64343,2728,"Thierry Baudet (FvD)",0.851390689919814,0.291421856639248,0
"<anonymized_userid>",5,64348,2729,"Thierry Baudet (FvD)",0.8514568502395,0.291528682833031,0
"<anonymized_userid>",5,64353,2730,"Thierry Baudet (FvD)",0.851523010559187,0.291635509026813,0
"<anonymized_userid>",5,64358,2731,"Thierry Baudet (FvD)",0.851589170878874,0.291742335220596,0
"<anonymized_userid>",5,64363,2732,"Thierry Baudet (FvD)",0.85165533119856,0.291849161414379,0
"<anonymized_userid>",5,64368,2733,"Thierry Baudet (FvD)",0.851721491518247,0.291955987608161,0
"<anonymized_userid>",5,64373,2734,"Thierry Baudet (FvD)",0.851787651837934,0.292062813801944,0
"<anonymized_userid>",5,64378,2735,"Thierry Baudet (FvD)",0.85185381215762,0.292169639995727,0
"<anonymized_userid>",5,64383,2736,"Thierry Baudet (FvD)",0.851919972477307,0.29227646618951,0
"<anonymized_userid>",5,64388,2737,"Thierry Baudet (FvD)",0.851986132796994,0.292383292383292,0
"<anonymized_userid>",5,64393,2738,"Thierry Baudet (FvD)",0.85205229311668,0.292490118577075,0
"<anonymized_userid>",5,64398,2739,"Thierry Baudet (FvD)",0.852118453436367,0.292596944770858,0
"<anonymized_userid>",5,64403,2740,"Thierry Baudet (FvD)",0.852184613756054,0.292703770964641,0
"<anonymized_userid>",5,64408,2741,"Thierry Baudet (FvD)",0.85225077407574,0.292810597158423,0
"<anonymized_userid>",5,64413,2742,"Thierry Baudet (FvD)",0.852316934395427,0.292917423352206,0
"<anonymized_userid>",5,64418,2743,"Thierry Baudet (FvD)",0.852383094715114,0.293024249545989,0
"<anonymized_userid>",5,64423,2744,"Thierry Baudet (FvD)",0.8524492550348,0.293131075739771,0
"<anonymized_userid>",5,64428,2745,"Thierry Baudet (FvD)",0.852515415354487,0.293237901933554,0
"<anonymized_userid>",5,64433,2746,"Thierry Baudet (FvD)",0.852581575674174,0.293344728127337,0
"<anonymized_userid>",5,64438,2747,"Thierry Baudet (FvD)",0.85264773599386,0.29345155432112,0
"<anonymized_userid>",5,64443,2748,"Thierry Baudet (FvD)",0.852713896313547,0.293558380514902,0
"<anonymized_userid>",5,64448,2749,"Thierry Baudet (FvD)",0.852780056633234,0.293665206708685,0
"<anonymized_userid>",5,64453,2750,"Thierry Baudet (FvD)",0.85284621695292,0.293772032902468,0
"<anonymized_userid>",5,64458,2751,"Thierry Baudet (FvD)",0.852912377272607,0.29387885909625,0
"<anonymized_userid>",5,64463,2752,"Thierry Baudet (FvD)",0.852978537592294,0.293985685290033,0
"<anonymized_userid>",5,64468,2753,"Thierry Baudet (FvD)",0.85304469791198,0.294092511483816,0
"<anonymized_userid>",5,64473,2754,"Thierry Baudet (FvD)",0.853110858231667,0.294199337677599,0
"<anonymized_userid>",5,64478,2755,"Thierry Baudet (FvD)",0.853177018551354,0.294306163871381,0
"<anonymized_userid>",5,64483,2756,"Thierry Baudet (FvD)",0.85324317887104,0.294412990065164,0
"<anonymized_userid>",5,64488,2757,"Thierry Baudet (FvD)",0.853309339190727,0.294519816258947,0
"<anonymized_userid>",5,64493,2758,"Thierry Baudet (FvD)",0.853375499510414,0.294626642452729,0
"<anonymized_userid>",5,64498,2759,"Thierry Baudet (FvD)",0.8534416598301,0.294733468646512,0
"<anonymized_userid>",5,64503,2760,"Thierry Baudet (FvD)",0.853507820149787,0.294840294840295,0
"<anonymized_userid>",5,64508,2761,"Thierry Baudet (FvD)",0.853573980469474,0.294947121034078,0
"<anonymized_userid>",5,64513,2762,"Thierry Baudet (FvD)",0.85364014078916,0.29505394722786,0
"<anonymized_userid>",5,64518,2763,"Thierry Baudet (FvD)",0.853706301108847,0.295160773421643,0
"<anonymized_userid>",5,64523,2764,"Thierry Baudet (FvD)",0.853772461428534,0.295267599615426,0
"<anonymized_userid>",5,64528,2765,"Thierry Baudet (FvD)",0.85383862174822,0.295374425809208,0
"<anonymized_userid>",5,64533,2766,"Thierry Baudet (FvD)",0.853904782067907,0.295481252002991,0
"<anonymized_userid>",5,64538,2767,"Thierry Baudet (FvD)",0.853970942387594,0.295588078196774,0
"<anonymized_userid>",5,64543,2768,"Thierry Baudet (FvD)",0.85403710270728,0.295694904390557,0
"<anonymized_userid>",5,64548,2769,"Thierry Baudet (FvD)",0.854103263026967,0.295801730584339,0
"<anonymized_userid>",5,64553,2770,"Thierry Baudet (FvD)",0.854169423346654,0.295908556778122,0
"<anonymized_userid>",5,64558,2771,"Thierry Baudet (FvD)",0.85423558366634,0.296015382971905,0
"<anonymized_userid>",5,64563,2772,"Thierry Baudet (FvD)",0.854301743986027,0.296122209165687,0
"<anonymized_userid>",5,64568,2773,"Thierry Baudet (FvD)",0.854367904305714,0.29622903535947,0
"<anonymized_userid>",5,64573,2774,"Thierry Baudet (FvD)",0.8544340646254,0.296335861553253,0
"<anonymized_userid>",5,64578,2775,"Thierry Baudet (FvD)",0.854500224945087,0.296442687747036,0
"<anonymized_userid>",5,64583,2776,"Thierry Baudet (FvD)",0.854566385264774,0.296549513940818,0
"<anonymized_userid>",5,64588,2777,"Thierry Baudet (FvD)",0.85463254558446,0.296656340134601,0
"<anonymized_userid>",5,64593,2778,"Thierry Baudet (FvD)",0.854698705904147,0.296763166328384,0
"<anonymized_userid>",5,64598,2779,"Thierry Baudet (FvD)",0.854764866223834,0.296869992522166,0
"<anonymized_userid>",5,64603,2780,"Thierry Baudet (FvD)",0.85483102654352,0.296976818715949,0
"<anonymized_userid>",5,64608,2781,"Thierry Baudet (FvD)",0.854897186863207,0.297083644909732,0
"<anonymized_userid>",5,64613,2782,"Thierry Baudet (FvD)",0.854963347182894,0.297190471103515,0
"<anonymized_userid>",5,64618,2783,"Thierry Baudet (FvD)",0.85502950750258,0.297297297297297,0
"<anonymized_userid>",5,64623,2784,"Thierry Baudet (FvD)",0.855095667822267,0.29740412349108,0
"<anonymized_userid>",5,64628,2785,"Thierry Baudet (FvD)",0.855161828141954,0.297510949684863,0
"<anonymized_userid>",5,64633,2786,"Thierry Baudet (FvD)",0.85522798846164,0.297617775878645,0
"<anonymized_userid>",5,64638,2787,"Thierry Baudet (FvD)",0.855294148781327,0.297724602072428,0
"<anonymized_userid>",5,64643,2788,"Thierry Baudet (FvD)",0.855360309101014,0.297831428266211,0
"<anonymized_userid>",5,64648,2789,"Thierry Baudet (FvD)",0.8554264694207,0.297938254459994,0
"<anonymized_userid>",5,64653,2790,"Thierry Baudet (FvD)",0.855492629740387,0.298045080653776,0
"<anonymized_userid>",5,64658,2791,"Thierry Baudet (FvD)",0.855558790060074,0.298151906847559,0
"<anonymized_userid>",5,64663,2792,"Thierry Baudet (FvD)",0.85562495037976,0.298258733041342,0
"<anonymized_userid>",5,64668,2793,"Thierry Baudet (FvD)",0.855691110699447,0.298365559235124,0
"<anonymized_userid>",5,64673,2794,"Thierry Baudet (FvD)",0.855757271019134,0.298472385428907,0
"<anonymized_userid>",5,64678,2795,"Thierry Baudet (FvD)",0.85582343133882,0.29857921162269,0
"<anonymized_userid>",5,64683,2796,"Thierry Baudet (FvD)",0.855889591658507,0.298686037816473,0
"<anonymized_userid>",5,64688,2797,"Thierry Baudet (FvD)",0.855955751978194,0.298792864010255,0
"<anonymized_userid>",5,64693,2798,"Thierry Baudet (FvD)",0.85602191229788,0.298899690204038,0
"<anonymized_userid>",5,64698,2799,"Thierry Baudet (FvD)",0.856088072617567,0.299006516397821,0
"<anonymized_userid>",5,64703,2800,"Thierry Baudet (FvD)",0.856154232937254,0.299113342591603,0
"<anonymized_userid>",5,64708,2801,"Thierry Baudet (FvD)",0.85622039325694,0.299220168785386,0
"<anonymized_userid>",5,64713,2802,"Thierry Baudet (FvD)",0.856286553576627,0.299326994979169,0
"<anonymized_userid>",5,64718,2803,"Thierry Baudet (FvD)",0.856352713896314,0.299433821172952,0
"<anonymized_userid>",5,64723,2804,"Thierry Baudet (FvD)",0.856418874216,0.299540647366734,0
"<anonymized_userid>",5,64728,2805,"Thierry Baudet (FvD)",0.856485034535687,0.299647473560517,0
"<anonymized_userid>",5,64733,2806,"Thierry Baudet (FvD)",0.856551194855374,0.2997542997543,0
"<anonymized_userid>",5,64738,2807,"Thierry Baudet (FvD)",0.85661735517506,0.299861125948082,0
"<anonymized_userid>",5,64743,2808,"Thierry Baudet (FvD)",0.856683515494747,0.299967952141865,0
"<anonymized_userid>",5,64748,2809,"Thierry Baudet (FvD)",0.856749675814434,0.300074778335648,0
"<anonymized_userid>",5,64753,2810,"Thierry Baudet (FvD)",0.85681583613412,0.300181604529431,0
"<anonymized_userid>",5,64758,2811,"Thierry Baudet (FvD)",0.856881996453807,0.300288430723213,0
"<anonymized_userid>",5,64763,2812,"Thierry Baudet (FvD)",0.856948156773494,0.300395256916996,0
"<anonymized_userid>",5,64768,2813,"Thierry Baudet (FvD)",0.85701431709318,0.300502083110779,0
"<anonymized_userid>",5,64773,2814,"Thierry Baudet (FvD)",0.857080477412867,0.300608909304561,0
"<anonymized_userid>",5,64778,2815,"Thierry Baudet (FvD)",0.857146637732554,0.300715735498344,0
"<anonymized_userid>",5,64783,2816,"Thierry Baudet (FvD)",0.85721279805224,0.300822561692127,0
"<anonymized_userid>",5,64788,2817,"Thierry Baudet (FvD)",0.857278958371927,0.30092938788591,0
"<anonymized_userid>",5,64793,2818,"Thierry Baudet (FvD)",0.857345118691614,0.301036214079692,0
"<anonymized_userid>",5,64798,2819,"Thierry Baudet (FvD)",0.8574112790113,0.301143040273475,0
"<anonymized_userid>",5,64803,2820,"Thierry Baudet (FvD)",0.857477439330987,0.301249866467258,0
"<anonymized_userid>",5,64808,2821,"Thierry Baudet (FvD)",0.857543599650674,0.30135669266104,0
"<anonymized_userid>",5,64813,2822,"Thierry Baudet (FvD)",0.85760975997036,0.301463518854823,0
"<anonymized_userid>",5,64818,2823,"Thierry Baudet (FvD)",0.857675920290047,0.301570345048606,0
"<anonymized_userid>",5,64823,2824,"Thierry Baudet (FvD)",0.857742080609734,0.301677171242389,0
"<anonymized_userid>",5,64828,2825,"Thierry Baudet (FvD)",0.85780824092942,0.301783997436171,0
"<anonymized_userid>",5,64833,2826,"Thierry Baudet (FvD)",0.857874401249107,0.301890823629954,0
"<anonymized_userid>",5,64838,2827,"Thierry Baudet (FvD)",0.857940561568794,0.301997649823737,0
"<anonymized_userid>",5,64843,2828,"Thierry Baudet (FvD)",0.85800672188848,0.302104476017519,0
"<anonymized_userid>",5,64848,2829,"Thierry Baudet (FvD)",0.858072882208167,0.302211302211302,0
"<anonymized_userid>",5,64853,2830,"Thierry Baudet (FvD)",0.858139042527853,0.302318128405085,0
"<anonymized_userid>",5,64858,2831,"Thierry Baudet (FvD)",0.85820520284754,0.302424954598868,0
"<anonymized_userid>",5,64863,2832,"Thierry Baudet (FvD)",0.858271363167227,0.30253178079265,0
"<anonymized_userid>",5,64868,2833,"Thierry Baudet (FvD)",0.858337523486914,0.302638606986433,0
"<anonymized_userid>",5,64873,2834,"Thierry Baudet (FvD)",0.8584036838066,0.302745433180216,0
"<anonymized_userid>",5,64878,2835,"Thierry Baudet (FvD)",0.858469844126287,0.302852259373999,0
"<anonymized_userid>",5,64883,2836,"Thierry Baudet (FvD)",0.858536004445973,0.302959085567781,0
"<anonymized_userid>",5,64888,2837,"Thierry Baudet (FvD)",0.85860216476566,0.303065911761564,0
"<anonymized_userid>",4,64892,2838,"Thierry Baudet (FvD)",0.85865509302141,0.303172737955347,0
"<anonymized_userid>",4,64896,2839,"Thierry Baudet (FvD)",0.858708021277159,0.303279564149129,0
"<anonymized_userid>",4,64900,2840,"Thierry Baudet (FvD)",0.858760949532908,0.303386390342912,0
"<anonymized_userid>",4,64904,2841,"Thierry Baudet (FvD)",0.858813877788657,0.303493216536695,0
"<anonymized_userid>",4,64908,2842,"Thierry Baudet (FvD)",0.858866806044407,0.303600042730478,0
"<anonymized_userid>",4,64912,2843,"Thierry Baudet (FvD)",0.858919734300156,0.30370686892426,0
"<anonymized_userid>",4,64916,2844,"Thierry Baudet (FvD)",0.858972662555905,0.303813695118043,0
"<anonymized_userid>",4,64920,2845,"Thierry Baudet (FvD)",0.859025590811655,0.303920521311826,0
"<anonymized_userid>",4,64924,2846,"Thierry Baudet (FvD)",0.859078519067404,0.304027347505608,0
"<anonymized_userid>",4,64928,2847,"Thierry Baudet (FvD)",0.859131447323153,0.304134173699391,0
"<anonymized_userid>",4,64932,2848,"Thierry Baudet (FvD)",0.859184375578903,0.304240999893174,0
"<anonymized_userid>",4,64936,2849,"Thierry Baudet (FvD)",0.859237303834652,0.304347826086957,0
"<anonymized_userid>",4,64940,2850,"Thierry Baudet (FvD)",0.859290232090401,0.304454652280739,0
"<anonymized_userid>",4,64944,2851,"Thierry Baudet (FvD)",0.859343160346151,0.304561478474522,0
"<anonymized_userid>",4,64948,2852,"Thierry Baudet (FvD)",0.8593960886019,0.304668304668305,0
"<anonymized_userid>",4,64952,2853,"Thierry Baudet (FvD)",0.859449016857649,0.304775130862087,0
"<anonymized_userid>",4,64956,2854,"Thierry Baudet (FvD)",0.859501945113399,0.30488195705587,0
"<anonymized_userid>",4,64960,2855,"Thierry Baudet (FvD)",0.859554873369148,0.304988783249653,0
"<anonymized_userid>",4,64964,2856,"Thierry Baudet (FvD)",0.859607801624897,0.305095609443436,0
"<anonymized_userid>",4,64968,2857,"Thierry Baudet (FvD)",0.859660729880647,0.305202435637218,0
"<anonymized_userid>",4,64972,2858,"Thierry Baudet (FvD)",0.859713658136396,0.305309261831001,0
"<anonymized_userid>",4,64976,2859,"Thierry Baudet (FvD)",0.859766586392145,0.305416088024784,0
"<anonymized_userid>",4,64980,2860,"Thierry Baudet (FvD)",0.859819514647895,0.305522914218566,0
"<anonymized_userid>",4,64984,2861,"Thierry Baudet (FvD)",0.859872442903644,0.305629740412349,0
"<anonymized_userid>",4,64988,2862,"Thierry Baudet (FvD)",0.859925371159393,0.305736566606132,0
"<anonymized_userid>",4,64992,2863,"Thierry Baudet (FvD)",0.859978299415143,0.305843392799915,0
"<anonymized_userid>",4,64996,2864,"Thierry Baudet (FvD)",0.860031227670892,0.305950218993697,0
"<anonymized_userid>",4,65000,2865,"Thierry Baudet (FvD)",0.860084155926641,0.30605704518748,0
"<anonymized_userid>",4,65004,2866,"Thierry Baudet (FvD)",0.860137084182391,0.306163871381263,0
"<anonymized_userid>",4,65008,2867,"Thierry Baudet (FvD)",0.86019001243814,0.306270697575045,0
"<anonymized_userid>",4,65012,2868,"Thierry Baudet (FvD)",0.860242940693889,0.306377523768828,0
"<anonymized_userid>",4,65016,2869,"Thierry Baudet (FvD)",0.860295868949639,0.306484349962611,0
"<anonymized_userid>",4,65020,2870,"Thierry Baudet (FvD)",0.860348797205388,0.306591176156394,0
"<anonymized_userid>",4,65024,2871,"Thierry Baudet (FvD)",0.860401725461137,0.306698002350176,0
"<anonymized_userid>",4,65028,2872,"Thierry Baudet (FvD)",0.860454653716887,0.306804828543959,0
"<anonymized_userid>",4,65032,2873,"Thierry Baudet (FvD)",0.860507581972636,0.306911654737742,0
"<anonymized_userid>",4,65036,2874,"Thierry Baudet (FvD)",0.860560510228385,0.307018480931524,0
"<anonymized_userid>",4,65040,2875,"Thierry Baudet (FvD)",0.860613438484135,0.307125307125307,0
"<anonymized_userid>",4,65044,2876,"Thierry Baudet (FvD)",0.860666366739884,0.30723213331909,0
"<anonymized_userid>",4,65048,2877,"Thierry Baudet (FvD)",0.860719294995633,0.307338959512873,0
"<anonymized_userid>",4,65052,2878,"Thierry Baudet (FvD)",0.860772223251383,0.307445785706655,0
"<anonymized_userid>",4,65056,2879,"Thierry Baudet (FvD)",0.860825151507132,0.307552611900438,0
"<anonymized_userid>",4,65060,2880,"Thierry Baudet (FvD)",0.860878079762881,0.307659438094221,0
"<anonymized_userid>",4,65064,2881,"Thierry Baudet (FvD)",0.860931008018631,0.307766264288003,0
"<anonymized_userid>",4,65068,2882,"Thierry Baudet (FvD)",0.86098393627438,0.307873090481786,0
"<anonymized_userid>",4,65072,2883,"Thierry Baudet (FvD)",0.861036864530129,0.307979916675569,0
"<anonymized_userid>",4,65076,2884,"Thierry Baudet (FvD)",0.861089792785879,0.308086742869352,0
"<anonymized_userid>",4,65080,2885,"Thierry Baudet (FvD)",0.861142721041628,0.308193569063134,0
"<anonymized_userid>",4,65084,2886,"Thierry Baudet (FvD)",0.861195649297377,0.308300395256917,0
"<anonymized_userid>",4,65088,2887,"Thierry Baudet (FvD)",0.861248577553127,0.3084072214507,0
"<anonymized_userid>",4,65092,2888,"Thierry Baudet (FvD)",0.861301505808876,0.308514047644482,0
"<anonymized_userid>",4,65096,2889,"Thierry Baudet (FvD)",0.861354434064625,0.308620873838265,0
"<anonymized_userid>",4,65100,2890,"Thierry Baudet (FvD)",0.861407362320375,0.308727700032048,0
"<anonymized_userid>",4,65104,2891,"Thierry Baudet (FvD)",0.861460290576124,0.308834526225831,0
"<anonymized_userid>",4,65108,2892,"Thierry Baudet (FvD)",0.861513218831873,0.308941352419613,0
"<anonymized_userid>",4,65112,2893,"Thierry Baudet (FvD)",0.861566147087623,0.309048178613396,0
"<anonymized_userid>",4,65116,2894,"Thierry Baudet (FvD)",0.861619075343372,0.309155004807179,0
"<anonymized_userid>",4,65120,2895,"Thierry Baudet (FvD)",0.861672003599121,0.309261831000961,0
"<anonymized_userid>",4,65124,2896,"Thierry Baudet (FvD)",0.861724931854871,0.309368657194744,0
"<anonymized_userid>",4,65128,2897,"Thierry Baudet (FvD)",0.86177786011062,0.309475483388527,0
"<anonymized_userid>",4,65132,2898,"Thierry Baudet (FvD)",0.861830788366369,0.30958230958231,0
"<anonymized_userid>",4,65136,2899,"Thierry Baudet (FvD)",0.861883716622119,0.309689135776092,0
"<anonymized_userid>",4,65140,2900,"Thierry Baudet (FvD)",0.861936644877868,0.309795961969875,0
"<anonymized_userid>",4,65144,2901,"Thierry Baudet (FvD)",0.861989573133617,0.309902788163658,0
"<anonymized_userid>",4,65148,2902,"Thierry Baudet (FvD)",0.862042501389367,0.31000961435744,0
"<anonymized_userid>",4,65152,2903,"Thierry Baudet (FvD)",0.862095429645116,0.310116440551223,0
"<anonymized_userid>",4,65156,2904,"Thierry Baudet (FvD)",0.862148357900865,0.310223266745006,0
"<anonymized_userid>",4,65160,2905,"Thierry Baudet (FvD)",0.862201286156615,0.310330092938789,0
"<anonymized_userid>",4,65164,2906,"Thierry Baudet (FvD)",0.862254214412364,0.310436919132571,0
"<anonymized_userid>",4,65168,2907,"Thierry Baudet (FvD)",0.862307142668113,0.310543745326354,0
"<anonymized_userid>",4,65172,2908,"Thierry Baudet (FvD)",0.862360070923863,0.310650571520137,0
"<anonymized_userid>",4,65176,2909,"Thierry Baudet (FvD)",0.862412999179612,0.310757397713919,0
"<anonymized_userid>",4,65180,2910,"Thierry Baudet (FvD)",0.862465927435361,0.310864223907702,0
"<anonymized_userid>",4,65184,2911,"Thierry Baudet (FvD)",0.862518855691111,0.310971050101485,0
"<anonymized_userid>",4,65188,2912,"Thierry Baudet (FvD)",0.86257178394686,0.311077876295268,0
"<anonymized_userid>",4,65192,2913,"Thierry Baudet (FvD)",0.862624712202609,0.31118470248905,0
"<anonymized_userid>",4,65196,2914,"Thierry Baudet (FvD)",0.862677640458359,0.311291528682833,0
"<anonymized_userid>",4,65200,2915,"Thierry Baudet (FvD)",0.862730568714108,0.311398354876616,0
"<anonymized_userid>",4,65204,2916,"Thierry Baudet (FvD)",0.862783496969857,0.311505181070398,0
"<anonymized_userid>",4,65208,2917,"Thierry Baudet (FvD)",0.862836425225607,0.311612007264181,0
"<anonymized_userid>",4,65212,2918,"Thierry Baudet (FvD)",0.862889353481356,0.311718833457964,0
"<anonymized_userid>",4,65216,2919,"Thierry Baudet (FvD)",0.862942281737105,0.311825659651747,0
"<anonymized_userid>",4,65220,2920,"Thierry Baudet (FvD)",0.862995209992855,0.311932485845529,0
"<anonymized_userid>",4,65224,2921,"Thierry Baudet (FvD)",0.863048138248604,0.312039312039312,0
"<anonymized_userid>",4,65228,2922,"Thierry Baudet (FvD)",0.863101066504353,0.312146138233095,0
"<anonymized_userid>",4,65232,2923,"Thierry Baudet (FvD)",0.863153994760103,0.312252964426877,0
"<anonymized_userid>",4,65236,2924,"Thierry Baudet (FvD)",0.863206923015852,0.31235979062066,0
"<anonymized_userid>",4,65240,2925,"Thierry Baudet (FvD)",0.863259851271601,0.312466616814443,0
"<anonymized_userid>",4,65244,2926,"Thierry Baudet (FvD)",0.863312779527351,0.312573443008226,0
"<anonymized_userid>",4,65248,2927,"Thierry Baudet (FvD)",0.8633657077831,0.312680269202008,0
"<anonymized_userid>",4,65252,2928,"Thierry Baudet (FvD)",0.863418636038849,0.312787095395791,0
"<anonymized_userid>",4,65256,2929,"Thierry Baudet (FvD)",0.863471564294599,0.312893921589574,0
"<anonymized_userid>",4,65260,2930,"Thierry Baudet (FvD)",0.863524492550348,0.313000747783356,0
"<anonymized_userid>",4,65264,2931,"Thierry Baudet (FvD)",0.863577420806097,0.313107573977139,0
"<anonymized_userid>",4,65268,2932,"Thierry Baudet (FvD)",0.863630349061847,0.313214400170922,0
"<anonymized_userid>",4,65272,2933,"Thierry Baudet (FvD)",0.863683277317596,0.313321226364705,0
"<anonymized_userid>",4,65276,2934,"Thierry Baudet (FvD)",0.863736205573345,0.313428052558487,0
"<anonymized_userid>",4,65280,2935,"Thierry Baudet (FvD)",0.863789133829095,0.31353487875227,0
"<anonymized_userid>",4,65284,2936,"Thierry Baudet (FvD)",0.863842062084844,0.313641704946053,0
"<anonymized_userid>",4,65288,2937,"Thierry Baudet (FvD)",0.863894990340593,0.313748531139835,0
"<anonymized_userid>",4,65292,2938,"Thierry Baudet (FvD)",0.863947918596343,0.313855357333618,0
"<anonymized_userid>",4,65296,2939,"Thierry Baudet (FvD)",0.864000846852092,0.313962183527401,0
"<anonymized_userid>",4,65300,2940,"Thierry Baudet (FvD)",0.864053775107841,0.314069009721184,0
"<anonymized_userid>",4,65304,2941,"Thierry Baudet (FvD)",0.864106703363591,0.314175835914966,0
"<anonymized_userid>",4,65308,2942,"Thierry Baudet (FvD)",0.86415963161934,0.314282662108749,0
"<anonymized_userid>",4,65312,2943,"Thierry Baudet (FvD)",0.864212559875089,0.314389488302532,0
"<anonymized_userid>",4,65316,2944,"Thierry Baudet (FvD)",0.864265488130839,0.314496314496314,0
"<anonymized_userid>",4,65320,2945,"Thierry Baudet (FvD)",0.864318416386588,0.314603140690097,0
"<anonymized_userid>",4,65324,2946,"Thierry Baudet (FvD)",0.864371344642337,0.31470996688388,0
"<anonymized_userid>",4,65328,2947,"Thierry Baudet (FvD)",0.864424272898087,0.314816793077663,0
"<anonymized_userid>",4,65332,2948,"Thierry Baudet (FvD)",0.864477201153836,0.314923619271445,0
"<anonymized_userid>",4,65336,2949,"Thierry Baudet (FvD)",0.864530129409585,0.315030445465228,0
"<anonymized_userid>",4,65340,2950,"Thierry Baudet (FvD)",0.864583057665335,0.315137271659011,0
"<anonymized_userid>",4,65344,2951,"Thierry Baudet (FvD)",0.864635985921084,0.315244097852794,0
"<anonymized_userid>",4,65348,2952,"Thierry Baudet (FvD)",0.864688914176833,0.315350924046576,0
"<anonymized_userid>",4,65352,2953,"Thierry Baudet (FvD)",0.864741842432583,0.315457750240359,0
"<anonymized_userid>",4,65356,2954,"Thierry Baudet (FvD)",0.864794770688332,0.315564576434142,0
"<anonymized_userid>",4,65360,2955,"Thierry Baudet (FvD)",0.864847698944081,0.315671402627924,0
"<anonymized_userid>",4,65364,2956,"Thierry Baudet (FvD)",0.864900627199831,0.315778228821707,0
"<anonymized_userid>",4,65368,2957,"Thierry Baudet (FvD)",0.86495355545558,0.31588505501549,0
"<anonymized_userid>",4,65372,2958,"Thierry Baudet (FvD)",0.865006483711329,0.315991881209273,0
"<anonymized_userid>",4,65376,2959,"Thierry Baudet (FvD)",0.865059411967079,0.316098707403055,0
"<anonymized_userid>",4,65380,2960,"Thierry Baudet (FvD)",0.865112340222828,0.316205533596838,0
"<anonymized_userid>",4,65384,2961,"Thierry Baudet (FvD)",0.865165268478577,0.316312359790621,0
"<anonymized_userid>",4,65388,2962,"Thierry Baudet (FvD)",0.865218196734327,0.316419185984403,0
"<anonymized_userid>",4,65392,2963,"Thierry Baudet (FvD)",0.865271124990076,0.316526012178186,0
"<anonymized_userid>",4,65396,2964,"Thierry Baudet (FvD)",0.865324053245825,0.316632838371969,0
"<anonymized_userid>",4,65400,2965,"Thierry Baudet (FvD)",0.865376981501575,0.316739664565752,0
"<anonymized_userid>",4,65404,2966,"Thierry Baudet (FvD)",0.865429909757324,0.316846490759534,0
"<anonymized_userid>",4,65408,2967,"Thierry Baudet (FvD)",0.865482838013073,0.316953316953317,0
"<anonymized_userid>",4,65412,2968,"Thierry Baudet (FvD)",0.865535766268823,0.3170601431471,0
"<anonymized_userid>",4,65416,2969,"Thierry Baudet (FvD)",0.865588694524572,0.317166969340882,0
"<anonymized_userid>",4,65420,2970,"Thierry Baudet (FvD)",0.865641622780321,0.317273795534665,0
"<anonymized_userid>",4,65424,2971,"Thierry Baudet (FvD)",0.865694551036071,0.317380621728448,0
"<anonymized_userid>",4,65428,2972,"Thierry Baudet (FvD)",0.86574747929182,0.317487447922231,0
"<anonymized_userid>",4,65432,2973,"Thierry Baudet (FvD)",0.865800407547569,0.317594274116013,0
"<anonymized_userid>",4,65436,2974,"Thierry Baudet (FvD)",0.865853335803319,0.317701100309796,0
"<anonymized_userid>",4,65440,2975,"Thierry Baudet (FvD)",0.865906264059068,0.317807926503579,0
"<anonymized_userid>",4,65444,2976,"Thierry Baudet (FvD)",0.865959192314817,0.317914752697361,0
"<anonymized_userid>",4,65448,2977,"Thierry Baudet (FvD)",0.866012120570567,0.318021578891144,0
"<anonymized_userid>",4,65452,2978,"Thierry Baudet (FvD)",0.866065048826316,0.318128405084927,0
"<anonymized_userid>",4,65456,2979,"Thierry Baudet (FvD)",0.866117977082065,0.31823523127871,0
"<anonymized_userid>",4,65460,2980,"Thierry Baudet (FvD)",0.866170905337815,0.318342057472492,0
"<anonymized_userid>",4,65464,2981,"Thierry Baudet (FvD)",0.866223833593564,0.318448883666275,0
"<anonymized_userid>",4,65468,2982,"Thierry Baudet (FvD)",0.866276761849313,0.318555709860058,0
"<anonymized_userid>",4,65472,2983,"Thierry Baudet (FvD)",0.866329690105063,0.31866253605384,0
"<anonymized_userid>",4,65476,2984,"Thierry Baudet (FvD)",0.866382618360812,0.318769362247623,0
"<anonymized_userid>",4,65480,2985,"Thierry Baudet (FvD)",0.866435546616561,0.318876188441406,0
"<anonymized_userid>",4,65484,2986,"Thierry Baudet (FvD)",0.866488474872311,0.318983014635189,0
"<anonymized_userid>",4,65488,2987,"Thierry Baudet (FvD)",0.86654140312806,0.319089840828971,0
"<anonymized_userid>",4,65492,2988,"Thierry Baudet (FvD)",0.866594331383809,0.319196667022754,0
"<anonymized_userid>",4,65496,2989,"Thierry Baudet (FvD)",0.866647259639559,0.319303493216537,0
"<anonymized_userid>",4,65500,2990,"Thierry Baudet (FvD)",0.866700187895308,0.319410319410319,0
"<anonymized_userid>",4,65504,2991,"Thierry Baudet (FvD)",0.866753116151057,0.319517145604102,0
"<anonymized_userid>",4,65508,2992,"Thierry Baudet (FvD)",0.866806044406807,0.319623971797885,0
"<anonymized_userid>",4,65512,2993,"Thierry Baudet (FvD)",0.866858972662556,0.319730797991668,0
"<anonymized_userid>",4,65516,2994,"Thierry Baudet (FvD)",0.866911900918305,0.31983762418545,0
"<anonymized_userid>",4,65520,2995,"Thierry Baudet (FvD)",0.866964829174055,0.319944450379233,0
"<anonymized_userid>",4,65524,2996,"Thierry Baudet (FvD)",0.867017757429804,0.320051276573016,0
"<anonymized_userid>",4,65528,2997,"Thierry Baudet (FvD)",0.867070685685553,0.320158102766798,0
"<anonymized_userid>",4,65532,2998,"Thierry Baudet (FvD)",0.867123613941303,0.320264928960581,0
"<anonymized_userid>",4,65536,2999,"Thierry Baudet (FvD)",0.867176542197052,0.320371755154364,0
"<anonymized_userid>",4,65540,3000,"Thierry Baudet (FvD)",0.867229470452801,0.320478581348147,0
"<anonymized_userid>",4,65544,3001,"Thierry Baudet (FvD)",0.867282398708551,0.320585407541929,0
"<anonymized_userid>",4,65548,3002,"Thierry Baudet (FvD)",0.8673353269643,0.320692233735712,0
"<anonymized_userid>",4,65552,3003,"Thierry Baudet (FvD)",0.867388255220049,0.320799059929495,0
"<anonymized_userid>",4,65556,3004,"Thierry Baudet (FvD)",0.867441183475799,0.320905886123277,0
"<anonymized_userid>",4,65560,3005,"Thierry Baudet (FvD)",0.867494111731548,0.32101271231706,0
"<anonymized_userid>",4,65564,3006,"Thierry Baudet (FvD)",0.867547039987297,0.321119538510843,0
"<anonymized_userid>",4,65568,3007,"Thierry Baudet (FvD)",0.867599968243047,0.321226364704626,0
"<anonymized_userid>",4,65572,3008,"Thierry Baudet (FvD)",0.867652896498796,0.321333190898408,0
"<anonymized_userid>",4,65576,3009,"Thierry Baudet (FvD)",0.867705824754545,0.321440017092191,0
"<anonymized_userid>",4,65580,3010,"Thierry Baudet (FvD)",0.867758753010295,0.321546843285974,0
"<anonymized_userid>",4,65584,3011,"Thierry Baudet (FvD)",0.867811681266044,0.321653669479756,0
"<anonymized_userid>",4,65588,3012,"Thierry Baudet (FvD)",0.867864609521793,0.321760495673539,0
"<anonymized_userid>",4,65592,3013,"Thierry Baudet (FvD)",0.867917537777543,0.321867321867322,0
"<anonymized_userid>",4,65596,3014,"Thierry Baudet (FvD)",0.867970466033292,0.321974148061105,0
"<anonymized_userid>",4,65600,3015,"Thierry Baudet (FvD)",0.868023394289041,0.322080974254887,0
"<anonymized_userid>",4,65604,3016,"Thierry Baudet (FvD)",0.868076322544791,0.32218780044867,0
"<anonymized_userid>",4,65608,3017,"Thierry Baudet (FvD)",0.86812925080054,0.322294626642453,0
"<anonymized_userid>",4,65612,3018,"Thierry Baudet (FvD)",0.868182179056289,0.322401452836235,0
"<anonymized_userid>",4,65616,3019,"Thierry Baudet (FvD)",0.868235107312039,0.322508279030018,0
"<anonymized_userid>",4,65620,3020,"Thierry Baudet (FvD)",0.868288035567788,0.322615105223801,0
"<anonymized_userid>",4,65624,3021,"Thierry Baudet (FvD)",0.868340963823537,0.322721931417584,0
"<anonymized_userid>",4,65628,3022,"Thierry Baudet (FvD)",0.868393892079287,0.322828757611366,0
"<anonymized_userid>",4,65632,3023,"Thierry Baudet (FvD)",0.868446820335036,0.322935583805149,0
"<anonymized_userid>",4,65636,3024,"Thierry Baudet (FvD)",0.868499748590785,0.323042409998932,0
"<anonymized_userid>",4,65640,3025,"Thierry Baudet (FvD)",0.868552676846534,0.323149236192714,0
"<anonymized_userid>",4,65644,3026,"Thierry Baudet (FvD)",0.868605605102284,0.323256062386497,0
"<anonymized_userid>",4,65648,3027,"Thierry Baudet (FvD)",0.868658533358033,0.32336288858028,0
"<anonymized_userid>",4,65652,3028,"Thierry Baudet (FvD)",0.868711461613783,0.323469714774063,0
"<anonymized_userid>",4,65656,3029,"Thierry Baudet (FvD)",0.868764389869532,0.323576540967845,0
"<anonymized_userid>",4,65660,3030,"Thierry Baudet (FvD)",0.868817318125281,0.323683367161628,0
"<anonymized_userid>",4,65664,3031,"Thierry Baudet (FvD)",0.86887024638103,0.323790193355411,0
"<anonymized_userid>",4,65668,3032,"Thierry Baudet (FvD)",0.86892317463678,0.323897019549193,0
"<anonymized_userid>",4,65672,3033,"Thierry Baudet (FvD)",0.868976102892529,0.324003845742976,0
"<anonymized_userid>",4,65676,3034,"Thierry Baudet (FvD)",0.869029031148279,0.324110671936759,0
"<anonymized_userid>",4,65680,3035,"Thierry Baudet (FvD)",0.869081959404028,0.324217498130542,0
"<anonymized_userid>",4,65684,3036,"Thierry Baudet (FvD)",0.869134887659777,0.324324324324324,0
"<anonymized_userid>",4,65688,3037,"Thierry Baudet (FvD)",0.869187815915527,0.324431150518107,0
"<anonymized_userid>",4,65692,3038,"Thierry Baudet (FvD)",0.869240744171276,0.32453797671189,0
"<anonymized_userid>",4,65696,3039,"Thierry Baudet (FvD)",0.869293672427025,0.324644802905672,0
"<anonymized_userid>",4,65700,3040,"Thierry Baudet (FvD)",0.869346600682774,0.324751629099455,0
"<anonymized_userid>",4,65704,3041,"Thierry Baudet (FvD)",0.869399528938524,0.324858455293238,0
"<anonymized_userid>",4,65708,3042,"Thierry Baudet (FvD)",0.869452457194273,0.324965281487021,0
"<anonymized_userid>",4,65712,3043,"Thierry Baudet (FvD)",0.869505385450023,0.325072107680803,0
"<anonymized_userid>",4,65716,3044,"Thierry Baudet (FvD)",0.869558313705772,0.325178933874586,0
"<anonymized_userid>",4,65720,3045,"Thierry Baudet (FvD)",0.869611241961521,0.325285760068369,0
"<anonymized_userid>",4,65724,3046,"Thierry Baudet (FvD)",0.86966417021727,0.325392586262152,0
"<anonymized_userid>",4,65728,3047,"Thierry Baudet (FvD)",0.86971709847302,0.325499412455934,0
"<anonymized_userid>",4,65732,3048,"Thierry Baudet (FvD)",0.869770026728769,0.325606238649717,0
"<anonymized_userid>",4,65736,3049,"Thierry Baudet (FvD)",0.869822954984518,0.3257130648435,0
"<anonymized_userid>",4,65740,3050,"Thierry Baudet (FvD)",0.869875883240268,0.325819891037282,0
"<anonymized_userid>",4,65744,3051,"Thierry Baudet (FvD)",0.869928811496017,0.325926717231065,0
"<anonymized_userid>",4,65748,3052,"Thierry Baudet (FvD)",0.869981739751767,0.326033543424848,0
"<anonymized_userid>",4,65752,3053,"Thierry Baudet (FvD)",0.870034668007516,0.32614036961863,0
"<anonymized_userid>",4,65756,3054,"Thierry Baudet (FvD)",0.870087596263265,0.326247195812413,0
"<anonymized_userid>",4,65760,3055,"Thierry Baudet (FvD)",0.870140524519014,0.326354022006196,0
"<anonymized_userid>",4,65764,3056,"Thierry Baudet (FvD)",0.870193452774764,0.326460848199979,0
"<anonymized_userid>",4,65768,3057,"Thierry Baudet (FvD)",0.870246381030513,0.326567674393761,0
"<anonymized_userid>",4,65772,3058,"Thierry Baudet (FvD)",0.870299309286262,0.326674500587544,0
"<anonymized_userid>",4,65776,3059,"Thierry Baudet (FvD)",0.870352237542012,0.326781326781327,0
"<anonymized_userid>",4,65780,3060,"Thierry Baudet (FvD)",0.870405165797761,0.326888152975109,0
"<anonymized_userid>",4,65784,3061,"Thierry Baudet (FvD)",0.87045809405351,0.326994979168892,0
"<anonymized_userid>",4,65788,3062,"Thierry Baudet (FvD)",0.87051102230926,0.327101805362675,0
"<anonymized_userid>",4,65792,3063,"Thierry Baudet (FvD)",0.870563950565009,0.327208631556458,0
"<anonymized_userid>",4,65796,3064,"Thierry Baudet (FvD)",0.870616878820758,0.32731545775024,0
"<anonymized_userid>",4,65800,3065,"Thierry Baudet (FvD)",0.870669807076508,0.327422283944023,0
"<anonymized_userid>",4,65804,3066,"Thierry Baudet (FvD)",0.870722735332257,0.327529110137806,0
"<anonymized_userid>",4,65808,3067,"Thierry Baudet (FvD)",0.870775663588007,0.327635936331588,0
"<anonymized_userid>",4,65812,3068,"Thierry Baudet (FvD)",0.870828591843756,0.327742762525371,0
"<anonymized_userid>",4,65816,3069,"Thierry Baudet (FvD)",0.870881520099505,0.327849588719154,0
"<anonymized_userid>",4,65820,3070,"Thierry Baudet (FvD)",0.870934448355254,0.327956414912937,0
"<anonymized_userid>",4,65824,3071,"Thierry Baudet (FvD)",0.870987376611004,0.328063241106719,0
"<anonymized_userid>",4,65828,3072,"Thierry Baudet (FvD)",0.871040304866753,0.328170067300502,0
"<anonymized_userid>",4,65832,3073,"Thierry Baudet (FvD)",0.871093233122502,0.328276893494285,0
"<anonymized_userid>",4,65836,3074,"Thierry Baudet (FvD)",0.871146161378252,0.328383719688068,0
"<anonymized_userid>",4,65840,3075,"Thierry Baudet (FvD)",0.871199089634001,0.32849054588185,0
"<anonymized_userid>",4,65844,3076,"Thierry Baudet (FvD)",0.87125201788975,0.328597372075633,0
"<anonymized_userid>",4,65848,3077,"Thierry Baudet (FvD)",0.8713049461455,0.328704198269416,0
"<anonymized_userid>",4,65852,3078,"Thierry Baudet (FvD)",0.871357874401249,0.328811024463198,0
"<anonymized_userid>",4,65856,3079,"Thierry Baudet (FvD)",0.871410802656998,0.328917850656981,0
"<anonymized_userid>",4,65860,3080,"Thierry Baudet (FvD)",0.871463730912748,0.329024676850764,0
"<anonymized_userid>",4,65864,3081,"Thierry Baudet (FvD)",0.871516659168497,0.329131503044547,0
"<anonymized_userid>",4,65868,3082,"Thierry Baudet (FvD)",0.871569587424246,0.329238329238329,0
"<anonymized_userid>",4,65872,3083,"Thierry Baudet (FvD)",0.871622515679996,0.329345155432112,0
"<anonymized_userid>",4,65876,3084,"Thierry Baudet (FvD)",0.871675443935745,0.329451981625895,0
"<anonymized_userid>",4,65880,3085,"Thierry Baudet (FvD)",0.871728372191494,0.329558807819677,0
"<anonymized_userid>",4,65884,3086,"Thierry Baudet (FvD)",0.871781300447244,0.32966563401346,0
"<anonymized_userid>",4,65888,3087,"Thierry Baudet (FvD)",0.871834228702993,0.329772460207243,0
"<anonymized_userid>",4,65892,3088,"Thierry Baudet (FvD)",0.871887156958742,0.329879286401026,0
"<anonymized_userid>",4,65896,3089,"Thierry Baudet (FvD)",0.871940085214492,0.329986112594808,0
"<anonymized_userid>",4,65900,3090,"Thierry Baudet (FvD)",0.871993013470241,0.330092938788591,0
"<anonymized_userid>",4,65904,3091,"Thierry Baudet (FvD)",0.87204594172599,0.330199764982374,0
"<anonymized_userid>",4,65908,3092,"Thierry Baudet (FvD)",0.87209886998174,0.330306591176156,0
"<anonymized_userid>",4,65912,3093,"Thierry Baudet (FvD)",0.872151798237489,0.330413417369939,0
"<anonymized_userid>",4,65916,3094,"Thierry Baudet (FvD)",0.872204726493238,0.330520243563722,0
"<anonymized_userid>",4,65920,3095,"Thierry Baudet (FvD)",0.872257654748988,0.330627069757505,0
"<anonymized_userid>",4,65924,3096,"Thierry Baudet (FvD)",0.872310583004737,0.330733895951287,0
"<anonymized_userid>",4,65928,3097,"Thierry Baudet (FvD)",0.872363511260486,0.33084072214507,0
"<anonymized_userid>",4,65932,3098,"Thierry Baudet (FvD)",0.872416439516236,0.330947548338853,0
"<anonymized_userid>",4,65936,3099,"Thierry Baudet (FvD)",0.872469367771985,0.331054374532635,0
"<anonymized_userid>",4,65940,3100,"Thierry Baudet (FvD)",0.872522296027734,0.331161200726418,0
"<anonymized_userid>",4,65944,3101,"Thierry Baudet (FvD)",0.872575224283484,0.331268026920201,0
"<anonymized_userid>",4,65948,3102,"Thierry Baudet (FvD)",0.872628152539233,0.331374853113984,0
"<anonymized_userid>",4,65952,3103,"Thierry Baudet (FvD)",0.872681080794982,0.331481679307766,0
"<anonymized_userid>",4,65956,3104,"Thierry Baudet (FvD)",0.872734009050732,0.331588505501549,0
"<anonymized_userid>",4,65960,3105,"Thierry Baudet (FvD)",0.872786937306481,0.331695331695332,0
"<anonymized_userid>",4,65964,3106,"Thierry Baudet (FvD)",0.87283986556223,0.331802157889114,0
"<anonymized_userid>",4,65968,3107,"Thierry Baudet (FvD)",0.87289279381798,0.331908984082897,0
"<anonymized_userid>",4,65972,3108,"Thierry Baudet (FvD)",0.872945722073729,0.33201581027668,0
"<anonymized_userid>",4,65976,3109,"Thierry Baudet (FvD)",0.872998650329478,0.332122636470463,0
"<anonymized_userid>",4,65980,3110,"Thierry Baudet (FvD)",0.873051578585228,0.332229462664245,0
"<anonymized_userid>",4,65984,3111,"Thierry Baudet (FvD)",0.873104506840977,0.332336288858028,0
"<anonymized_userid>",4,65988,3112,"Thierry Baudet (FvD)",0.873157435096726,0.332443115051811,0
"<anonymized_userid>",4,65992,3113,"Thierry Baudet (FvD)",0.873210363352476,0.332549941245593,0
"<anonymized_userid>",4,65996,3114,"Thierry Baudet (FvD)",0.873263291608225,0.332656767439376,0
"<anonymized_userid>",4,66000,3115,"Thierry Baudet (FvD)",0.873316219863974,0.332763593633159,0
"<anonymized_userid>",4,66004,3116,"Thierry Baudet (FvD)",0.873369148119724,0.332870419826942,0
"<anonymized_userid>",4,66008,3117,"Thierry Baudet (FvD)",0.873422076375473,0.332977246020724,0
"<anonymized_userid>",4,66012,3118,"Thierry Baudet (FvD)",0.873475004631222,0.333084072214507,0
"<anonymized_userid>",4,66016,3119,"Thierry Baudet (FvD)",0.873527932886972,0.33319089840829,0
"<anonymized_userid>",4,66020,3120,"Thierry Baudet (FvD)",0.873580861142721,0.333297724602072,0
"<anonymized_userid>",4,66024,3121,"Thierry Baudet (FvD)",0.87363378939847,0.333404550795855,0
"<anonymized_userid>",4,66028,3122,"Thierry Baudet (FvD)",0.87368671765422,0.333511376989638,0
"<anonymized_userid>",4,66032,3123,"Thierry Baudet (FvD)",0.873739645909969,0.333618203183421,0
"<anonymized_userid>",4,66036,3124,"Thierry Baudet (FvD)",0.873792574165718,0.333725029377203,0
"<anonymized_userid>",4,66040,3125,"Thierry Baudet (FvD)",0.873845502421468,0.333831855570986,0
"<anonymized_userid>",4,66044,3126,"Thierry Baudet (FvD)",0.873898430677217,0.333938681764769,0
"<anonymized_userid>",4,66048,3127,"Thierry Baudet (FvD)",0.873951358932966,0.334045507958551,0
"<anonymized_userid>",4,66052,3128,"Thierry Baudet (FvD)",0.874004287188716,0.334152334152334,0
"<anonymized_userid>",4,66056,3129,"Thierry Baudet (FvD)",0.874057215444465,0.334259160346117,0
"<anonymized_userid>",4,66060,3130,"Thierry Baudet (FvD)",0.874110143700214,0.3343659865399,0
"<anonymized_userid>",4,66064,3131,"Thierry Baudet (FvD)",0.874163071955964,0.334472812733682,0
"<anonymized_userid>",4,66068,3132,"Thierry Baudet (FvD)",0.874216000211713,0.334579638927465,0
"<anonymized_userid>",4,66072,3133,"Thierry Baudet (FvD)",0.874268928467462,0.334686465121248,0
"<anonymized_userid>",4,66076,3134,"Thierry Baudet (FvD)",0.874321856723212,0.33479329131503,0
"<anonymized_userid>",4,66080,3135,"Thierry Baudet (FvD)",0.874374784978961,0.334900117508813,0
"<anonymized_userid>",4,66084,3136,"Thierry Baudet (FvD)",0.87442771323471,0.335006943702596,0
"<anonymized_userid>",4,66088,3137,"Thierry Baudet (FvD)",0.87448064149046,0.335113769896379,0
"<anonymized_userid>",4,66092,3138,"Thierry Baudet (FvD)",0.874533569746209,0.335220596090161,0
"<anonymized_userid>",4,66096,3139,"Thierry Baudet (FvD)",0.874586498001958,0.335327422283944,0
"<anonymized_userid>",4,66100,3140,"Thierry Baudet (FvD)",0.874639426257708,0.335434248477727,0
"<anonymized_userid>",4,66104,3141,"Thierry Baudet (FvD)",0.874692354513457,0.335541074671509,0
"<anonymized_userid>",4,66108,3142,"Thierry Baudet (FvD)",0.874745282769206,0.335647900865292,0
"<anonymized_userid>",4,66112,3143,"Thierry Baudet (FvD)",0.874798211024956,0.335754727059075,0
"<anonymized_userid>",4,66116,3144,"Thierry Baudet (FvD)",0.874851139280705,0.335861553252858,0
"<anonymized_userid>",4,66120,3145,"Thierry Baudet (FvD)",0.874904067536454,0.33596837944664,0
"<anonymized_userid>",4,66124,3146,"Thierry Baudet (FvD)",0.874956995792204,0.336075205640423,0
"<anonymized_userid>",4,66128,3147,"Thierry Baudet (FvD)",0.875009924047953,0.336182031834206,0
"<anonymized_userid>",4,66132,3148,"Thierry Baudet (FvD)",0.875062852303702,0.336288858027988,0
"<anonymized_userid>",4,66136,3149,"Thierry Baudet (FvD)",0.875115780559452,0.336395684221771,0
"<anonymized_userid>",4,66140,3150,"Thierry Baudet (FvD)",0.875168708815201,0.336502510415554,0
"<anonymized_userid>",4,66144,3151,"Thierry Baudet (FvD)",0.87522163707095,0.336609336609337,0
"<anonymized_userid>",4,66148,3152,"Thierry Baudet (FvD)",0.8752745653267,0.336716162803119,0
"<anonymized_userid>",4,66152,3153,"Thierry Baudet (FvD)",0.875327493582449,0.336822988996902,0
"<anonymized_userid>",4,66156,3154,"Thierry Baudet (FvD)",0.875380421838198,0.336929815190685,0
"<anonymized_userid>",4,66160,3155,"Thierry Baudet (FvD)",0.875433350093948,0.337036641384467,0
"<anonymized_userid>",4,66164,3156,"Thierry Baudet (FvD)",0.875486278349697,0.33714346757825,0
"<anonymized_userid>",4,66168,3157,"Thierry Baudet (FvD)",0.875539206605446,0.337250293772033,0
"<anonymized_userid>",4,66172,3158,"Thierry Baudet (FvD)",0.875592134861196,0.337357119965816,0
"<anonymized_userid>",4,66176,3159,"Thierry Baudet (FvD)",0.875645063116945,0.337463946159598,0
"<anonymized_userid>",4,66180,3160,"Thierry Baudet (FvD)",0.875697991372694,0.337570772353381,0
"<anonymized_userid>",4,66184,3161,"Thierry Baudet (FvD)",0.875750919628444,0.337677598547164,0
"<anonymized_userid>",4,66188,3162,"Thierry Baudet (FvD)",0.875803847884193,0.337784424740946,0
"<anonymized_userid>",4,66192,3163,"Thierry Baudet (FvD)",0.875856776139942,0.337891250934729,0
"<anonymized_userid>",4,66196,3164,"Thierry Baudet (FvD)",0.875909704395692,0.337998077128512,0
"<anonymized_userid>",4,66200,3165,"Thierry Baudet (FvD)",0.875962632651441,0.338104903322295,0
"<anonymized_userid>",4,66204,3166,"Thierry Baudet (FvD)",0.87601556090719,0.338211729516077,0
"<anonymized_userid>",4,66208,3167,"Thierry Baudet (FvD)",0.87606848916294,0.33831855570986,0
"<anonymized_userid>",4,66212,3168,"Thierry Baudet (FvD)",0.876121417418689,0.338425381903643,0
"<anonymized_userid>",4,66216,3169,"Thierry Baudet (FvD)",0.876174345674438,0.338532208097426,0
"<anonymized_userid>",4,66220,3170,"Thierry Baudet (FvD)",0.876227273930188,0.338639034291208,0
"<anonymized_userid>",4,66224,3171,"Thierry Baudet (FvD)",0.876280202185937,0.338745860484991,0
"<anonymized_userid>",4,66228,3172,"Thierry Baudet (FvD)",0.876333130441686,0.338852686678774,0
"<anonymized_userid>",4,66232,3173,"Thierry Baudet (FvD)",0.876386058697436,0.338959512872556,0
"<anonymized_userid>",4,66236,3174,"Thierry Baudet (FvD)",0.876438986953185,0.339066339066339,0
"<anonymized_userid>",4,66240,3175,"Thierry Baudet (FvD)",0.876491915208934,0.339173165260122,0
"<anonymized_userid>",4,66244,3176,"Thierry Baudet (FvD)",0.876544843464684,0.339279991453904,0
"<anonymized_userid>",4,66248,3177,"Thierry Baudet (FvD)",0.876597771720433,0.339386817647687,0
"<anonymized_userid>",4,66252,3178,"Thierry Baudet (FvD)",0.876650699976182,0.33949364384147,0
"<anonymized_userid>",4,66256,3179,"Thierry Baudet (FvD)",0.876703628231932,0.339600470035253,0
"<anonymized_userid>",4,66260,3180,"Thierry Baudet (FvD)",0.876756556487681,0.339707296229035,0
"<anonymized_userid>",4,66264,3181,"Thierry Baudet (FvD)",0.87680948474343,0.339814122422818,0
"<anonymized_userid>",4,66268,3182,"Thierry Baudet (FvD)",0.87686241299918,0.339920948616601,0
"<anonymized_userid>",4,66272,3183,"Thierry Baudet (FvD)",0.876915341254929,0.340027774810383,0
"<anonymized_userid>",4,66276,3184,"Thierry Baudet (FvD)",0.876968269510678,0.340134601004166,0
"<anonymized_userid>",4,66280,3185,"Thierry Baudet (FvD)",0.877021197766428,0.340241427197949,0
"<anonymized_userid>",4,66284,3186,"Thierry Baudet (FvD)",0.877074126022177,0.340348253391732,0
"<anonymized_userid>",4,66288,3187,"Thierry Baudet (FvD)",0.877127054277926,0.340455079585514,0
"<anonymized_userid>",4,66292,3188,"Thierry Baudet (FvD)",0.877179982533676,0.340561905779297,0
"<anonymized_userid>",4,66296,3189,"Thierry Baudet (FvD)",0.877232910789425,0.34066873197308,0
"<anonymized_userid>",4,66300,3190,"Thierry Baudet (FvD)",0.877285839045174,0.340775558166863,0
"<anonymized_userid>",4,66304,3191,"Thierry Baudet (FvD)",0.877338767300924,0.340882384360645,0
"<anonymized_userid>",4,66308,3192,"Thierry Baudet (FvD)",0.877391695556673,0.340989210554428,0
"<anonymized_userid>",4,66312,3193,"Thierry Baudet (FvD)",0.877444623812422,0.341096036748211,0
"<anonymized_userid>",4,66316,3194,"Thierry Baudet (FvD)",0.877497552068172,0.341202862941993,0
"<anonymized_userid>",4,66320,3195,"Thierry Baudet (FvD)",0.877550480323921,0.341309689135776,0
"<anonymized_userid>",4,66324,3196,"Thierry Baudet (FvD)",0.87760340857967,0.341416515329559,0
"<anonymized_userid>",4,66328,3197,"Thierry Baudet (FvD)",0.87765633683542,0.341523341523342,0
"<anonymized_userid>",4,66332,3198,"Thierry Baudet (FvD)",0.877709265091169,0.341630167717124,0
"<anonymized_userid>",4,66336,3199,"Thierry Baudet (FvD)",0.877762193346918,0.341736993910907,0
"<anonymized_userid>",4,66340,3200,"Thierry Baudet (FvD)",0.877815121602668,0.34184382010469,0
"<anonymized_userid>",4,66344,3201,"Thierry Baudet (FvD)",0.877868049858417,0.341950646298472,0
"<anonymized_userid>",4,66348,3202,"Thierry Baudet (FvD)",0.877920978114166,0.342057472492255,0
"<anonymized_userid>",4,66352,3203,"Thierry Baudet (FvD)",0.877973906369916,0.342164298686038,0
"<anonymized_userid>",4,66356,3204,"Thierry Baudet (FvD)",0.878026834625665,0.342271124879821,0
"<anonymized_userid>",4,66360,3205,"Thierry Baudet (FvD)",0.878079762881414,0.342377951073603,0
"<anonymized_userid>",4,66364,3206,"Thierry Baudet (FvD)",0.878132691137164,0.342484777267386,0
"<anonymized_userid>",4,66368,3207,"Thierry Baudet (FvD)",0.878185619392913,0.342591603461169,0
"<anonymized_userid>",4,66372,3208,"Thierry Baudet (FvD)",0.878238547648662,0.342698429654951,0
"<anonymized_userid>",4,66376,3209,"Thierry Baudet (FvD)",0.878291475904412,0.342805255848734,0
"<anonymized_userid>",4,66380,3210,"Thierry Baudet (FvD)",0.878344404160161,0.342912082042517,0
"<anonymized_userid>",4,66384,3211,"Thierry Baudet (FvD)",0.87839733241591,0.3430189082363,0
"<anonymized_userid>",4,66388,3212,"Thierry Baudet (FvD)",0.87845026067166,0.343125734430082,0
"<anonymized_userid>",4,66392,3213,"Thierry Baudet (FvD)",0.878503188927409,0.343232560623865,0
"<anonymized_userid>",4,66396,3214,"Thierry Baudet (FvD)",0.878556117183158,0.343339386817648,0
"<anonymized_userid>",4,66400,3215,"Thierry Baudet (FvD)",0.878609045438908,0.34344621301143,0
"<anonymized_userid>",4,66404,3216,"Thierry Baudet (FvD)",0.878661973694657,0.343553039205213,0
"<anonymized_userid>",4,66408,3217,"Thierry Baudet (FvD)",0.878714901950406,0.343659865398996,0
"<anonymized_userid>",4,66412,3218,"Thierry Baudet (FvD)",0.878767830206156,0.343766691592779,0
"<anonymized_userid>",4,66416,3219,"Thierry Baudet (FvD)",0.878820758461905,0.343873517786561,0
"<anonymized_userid>",4,66420,3220,"Thierry Baudet (FvD)",0.878873686717654,0.343980343980344,0
"<anonymized_userid>",4,66424,3221,"Thierry Baudet (FvD)",0.878926614973404,0.344087170174127,0
"<anonymized_userid>",4,66428,3222,"Thierry Baudet (FvD)",0.878979543229153,0.344193996367909,0
"<anonymized_userid>",4,66432,3223,"Thierry Baudet (FvD)",0.879032471484902,0.344300822561692,0
"<anonymized_userid>",4,66436,3224,"Thierry Baudet (FvD)",0.879085399740652,0.344407648755475,0
"<anonymized_userid>",4,66440,3225,"Thierry Baudet (FvD)",0.879138327996401,0.344514474949258,0
"<anonymized_userid>",4,66444,3226,"Thierry Baudet (FvD)",0.87919125625215,0.34462130114304,0
"<anonymized_userid>",4,66448,3227,"Thierry Baudet (FvD)",0.8792441845079,0.344728127336823,0
"<anonymized_userid>",4,66452,3228,"Thierry Baudet (FvD)",0.879297112763649,0.344834953530606,0
"<anonymized_userid>",4,66456,3229,"Thierry Baudet (FvD)",0.879350041019398,0.344941779724388,0
"<anonymized_userid>",4,66460,3230,"Thierry Baudet (FvD)",0.879402969275147,0.345048605918171,0
"<anonymized_userid>",4,66464,3231,"Thierry Baudet (FvD)",0.879455897530897,0.345155432111954,0
"<anonymized_userid>",4,66468,3232,"Thierry Baudet (FvD)",0.879508825786646,0.345262258305737,0
"<anonymized_userid>",4,66472,3233,"Thierry Baudet (FvD)",0.879561754042396,0.345369084499519,0
"<anonymized_userid>",4,66476,3234,"Thierry Baudet (FvD)",0.879614682298145,0.345475910693302,0
"<anonymized_userid>",4,66480,3235,"Thierry Baudet (FvD)",0.879667610553894,0.345582736887085,0
"<anonymized_userid>",4,66484,3236,"Thierry Baudet (FvD)",0.879720538809644,0.345689563080867,0
"<anonymized_userid>",4,66488,3237,"Thierry Baudet (FvD)",0.879773467065393,0.34579638927465,0
"<anonymized_userid>",4,66492,3238,"Thierry Baudet (FvD)",0.879826395321142,0.345903215468433,0
"<anonymized_userid>",4,66496,3239,"Thierry Baudet (FvD)",0.879879323576891,0.346010041662216,0
"<anonymized_userid>",4,66500,3240,"Thierry Baudet (FvD)",0.879932251832641,0.346116867855998,0
"<anonymized_userid>",4,66504,3241,"Thierry Baudet (FvD)",0.87998518008839,0.346223694049781,0
"<anonymized_userid>",4,66508,3242,"Thierry Baudet (FvD)",0.88003810834414,0.346330520243564,0
"<anonymized_userid>",4,66512,3243,"Thierry Baudet (FvD)",0.880091036599889,0.346437346437346,0
"<anonymized_userid>",4,66516,3244,"Thierry Baudet (FvD)",0.880143964855638,0.346544172631129,0
"<anonymized_userid>",4,66520,3245,"Thierry Baudet (FvD)",0.880196893111387,0.346650998824912,0
"<anonymized_userid>",4,66524,3246,"Thierry Baudet (FvD)",0.880249821367137,0.346757825018695,0
"<anonymized_userid>",4,66528,3247,"Thierry Baudet (FvD)",0.880302749622886,0.346864651212477,0
"<anonymized_userid>",4,66532,3248,"Thierry Baudet (FvD)",0.880355677878636,0.34697147740626,0
"<anonymized_userid>",4,66536,3249,"Thierry Baudet (FvD)",0.880408606134385,0.347078303600043,0
"<anonymized_userid>",4,66540,3250,"Thierry Baudet (FvD)",0.880461534390134,0.347185129793825,0
"<anonymized_userid>",4,66544,3251,"Thierry Baudet (FvD)",0.880514462645884,0.347291955987608,0
"<anonymized_userid>",4,66548,3252,"Thierry Baudet (FvD)",0.880567390901633,0.347398782181391,0
"<anonymized_userid>",4,66552,3253,"Thierry Baudet (FvD)",0.880620319157382,0.347505608375174,0
"<anonymized_userid>",4,66556,3254,"Thierry Baudet (FvD)",0.880673247413131,0.347612434568956,0
"<anonymized_userid>",4,66560,3255,"Thierry Baudet (FvD)",0.880726175668881,0.347719260762739,0
"<anonymized_userid>",4,66564,3256,"Thierry Baudet (FvD)",0.88077910392463,0.347826086956522,0
"<anonymized_userid>",4,66568,3257,"Thierry Baudet (FvD)",0.88083203218038,0.347932913150304,0
"<anonymized_userid>",4,66572,3258,"Thierry Baudet (FvD)",0.880884960436129,0.348039739344087,0
"<anonymized_userid>",4,66576,3259,"Thierry Baudet (FvD)",0.880937888691878,0.34814656553787,0
"<anonymized_userid>",4,66580,3260,"Thierry Baudet (FvD)",0.880990816947627,0.348253391731653,0
"<anonymized_userid>",4,66584,3261,"Thierry Baudet (FvD)",0.881043745203377,0.348360217925435,0
"<anonymized_userid>",4,66588,3262,"Thierry Baudet (FvD)",0.881096673459126,0.348467044119218,0
"<anonymized_userid>",4,66592,3263,"Thierry Baudet (FvD)",0.881149601714875,0.348573870313001,0
"<anonymized_userid>",4,66596,3264,"Thierry Baudet (FvD)",0.881202529970625,0.348680696506783,0
"<anonymized_userid>",4,66600,3265,"Thierry Baudet (FvD)",0.881255458226374,0.348787522700566,0
"<anonymized_userid>",4,66604,3266,"Thierry Baudet (FvD)",0.881308386482124,0.348894348894349,0
"<anonymized_userid>",4,66608,3267,"Thierry Baudet (FvD)",0.881361314737873,0.349001175088132,0
"<anonymized_userid>",4,66612,3268,"Thierry Baudet (FvD)",0.881414242993622,0.349108001281914,0
"<anonymized_userid>",4,66616,3269,"Thierry Baudet (FvD)",0.881467171249371,0.349214827475697,0
"<anonymized_userid>",4,66620,3270,"Thierry Baudet (FvD)",0.881520099505121,0.34932165366948,0
"<anonymized_userid>",4,66624,3271,"Thierry Baudet (FvD)",0.88157302776087,0.349428479863262,0
"<anonymized_userid>",4,66628,3272,"Thierry Baudet (FvD)",0.88162595601662,0.349535306057045,0
"<anonymized_userid>",4,66632,3273,"Thierry Baudet (FvD)",0.881678884272369,0.349642132250828,0
"<anonymized_userid>",4,66636,3274,"Thierry Baudet (FvD)",0.881731812528118,0.349748958444611,0
"<anonymized_userid>",4,66640,3275,"Thierry Baudet (FvD)",0.881784740783867,0.349855784638393,0
"<anonymized_userid>",4,66644,3276,"Thierry Baudet (FvD)",0.881837669039617,0.349962610832176,0
"<anonymized_userid>",4,66648,3277,"Thierry Baudet (FvD)",0.881890597295366,0.350069437025959,0
"<anonymized_userid>",4,66652,3278,"Thierry Baudet (FvD)",0.881943525551115,0.350176263219741,0
"<anonymized_userid>",4,66656,3279,"Thierry Baudet (FvD)",0.881996453806865,0.350283089413524,0
"<anonymized_userid>",4,66660,3280,"Thierry Baudet (FvD)",0.882049382062614,0.350389915607307,0
"<anonymized_userid>",4,66664,3281,"Thierry Baudet (FvD)",0.882102310318364,0.35049674180109,0
"<anonymized_userid>",4,66668,3282,"Thierry Baudet (FvD)",0.882155238574113,0.350603567994872,0
"<anonymized_userid>",4,66672,3283,"Thierry Baudet (FvD)",0.882208166829862,0.350710394188655,0
"<anonymized_userid>",4,66676,3284,"Thierry Baudet (FvD)",0.882261095085611,0.350817220382438,0
"<anonymized_userid>",4,66680,3285,"Thierry Baudet (FvD)",0.882314023341361,0.350924046576221,0
"<anonymized_userid>",4,66684,3286,"Thierry Baudet (FvD)",0.88236695159711,0.351030872770003,0
"<anonymized_userid>",4,66688,3287,"Thierry Baudet (FvD)",0.882419879852859,0.351137698963786,0
"<anonymized_userid>",4,66692,3288,"Thierry Baudet (FvD)",0.882472808108609,0.351244525157569,0
"<anonymized_userid>",4,66696,3289,"Thierry Baudet (FvD)",0.882525736364358,0.351351351351351,0
"<anonymized_userid>",4,66700,3290,"Thierry Baudet (FvD)",0.882578664620107,0.351458177545134,0
"<anonymized_userid>",4,66704,3291,"Thierry Baudet (FvD)",0.882631592875857,0.351565003738917,0
"<anonymized_userid>",4,66708,3292,"Thierry Baudet (FvD)",0.882684521131606,0.3516718299327,0
"<anonymized_userid>",4,66712,3293,"Thierry Baudet (FvD)",0.882737449387355,0.351778656126482,0
"<anonymized_userid>",4,66716,3294,"Thierry Baudet (FvD)",0.882790377643105,0.351885482320265,0
"<anonymized_userid>",4,66720,3295,"Thierry Baudet (FvD)",0.882843305898854,0.351992308514048,0
"<anonymized_userid>",4,66724,3296,"Thierry Baudet (FvD)",0.882896234154603,0.35209913470783,0
"<anonymized_userid>",4,66728,3297,"Thierry Baudet (FvD)",0.882949162410353,0.352205960901613,0
"<anonymized_userid>",4,66732,3298,"Thierry Baudet (FvD)",0.883002090666102,0.352312787095396,0
"<anonymized_userid>",4,66736,3299,"Thierry Baudet (FvD)",0.883055018921851,0.352419613289178,0
"<anonymized_userid>",4,66740,3300,"Thierry Baudet (FvD)",0.883107947177601,0.352526439482961,0
"<anonymized_userid>",4,66744,3301,"Thierry Baudet (FvD)",0.88316087543335,0.352633265676744,0
"<anonymized_userid>",3,66747,3302,"Thierry Baudet (FvD)",0.883200571625162,0.352740091870527,0
"<anonymized_userid>",3,66750,3303,"Thierry Baudet (FvD)",0.883240267816974,0.352846918064309,0
"<anonymized_userid>",3,66753,3304,"Thierry Baudet (FvD)",0.883279964008786,0.352953744258092,0
"<anonymized_userid>",3,66756,3305,"Thierry Baudet (FvD)",0.883319660200598,0.353060570451875,0
"<anonymized_userid>",3,66759,3306,"Thierry Baudet (FvD)",0.88335935639241,0.353167396645657,0
"<anonymized_userid>",3,66762,3307,"Thierry Baudet (FvD)",0.883399052584222,0.35327422283944,0
"<anonymized_userid>",3,66765,3308,"Thierry Baudet (FvD)",0.883438748776034,0.353381049033223,0
"<anonymized_userid>",3,66768,3309,"Thierry Baudet (FvD)",0.883478444967846,0.353487875227006,0
"<anonymized_userid>",3,66771,3310,"Thierry Baudet (FvD)",0.883518141159658,0.353594701420788,0
"<anonymized_userid>",3,66774,3311,"Thierry Baudet (FvD)",0.88355783735147,0.353701527614571,0
"<anonymized_userid>",3,66777,3312,"Thierry Baudet (FvD)",0.883597533543282,0.353808353808354,0
"<anonymized_userid>",3,66780,3313,"Thierry Baudet (FvD)",0.883637229735094,0.353915180002137,0
"<anonymized_userid>",3,66783,3314,"Thierry Baudet (FvD)",0.883676925926906,0.354022006195919,0
"<anonymized_userid>",3,66786,3315,"Thierry Baudet (FvD)",0.883716622118718,0.354128832389702,0
"<anonymized_userid>",3,66789,3316,"Thierry Baudet (FvD)",0.88375631831053,0.354235658583485,0
"<anonymized_userid>",3,66792,3317,"Thierry Baudet (FvD)",0.883796014502342,0.354342484777267,0
"<anonymized_userid>",3,66795,3318,"Thierry Baudet (FvD)",0.883835710694154,0.35444931097105,0
"<anonymized_userid>",3,66798,3319,"Thierry Baudet (FvD)",0.883875406885966,0.354556137164833,0
"<anonymized_userid>",3,66801,3320,"Thierry Baudet (FvD)",0.883915103077778,0.354662963358616,0
"<anonymized_userid>",3,66804,3321,"Thierry Baudet (FvD)",0.88395479926959,0.354769789552398,0
"<anonymized_userid>",3,66807,3322,"Thierry Baudet (FvD)",0.883994495461402,0.354876615746181,0
"<anonymized_userid>",3,66810,3323,"Thierry Baudet (FvD)",0.884034191653214,0.354983441939964,0
"<anonymized_userid>",3,66813,3324,"Thierry Baudet (FvD)",0.884073887845026,0.355090268133746,0
"<anonymized_userid>",3,66816,3325,"Thierry Baudet (FvD)",0.884113584036838,0.355197094327529,0
"<anonymized_userid>",3,66819,3326,"Thierry Baudet (FvD)",0.88415328022865,0.355303920521312,0
"<anonymized_userid>",3,66822,3327,"Thierry Baudet (FvD)",0.884192976420462,0.355410746715095,0
"<anonymized_userid>",3,66825,3328,"Thierry Baudet (FvD)",0.884232672612274,0.355517572908877,0
"<anonymized_userid>",3,66828,3329,"Thierry Baudet (FvD)",0.884272368804086,0.35562439910266,0
"<anonymized_userid>",3,66831,3330,"Thierry Baudet (FvD)",0.884312064995898,0.355731225296443,0
"<anonymized_userid>",3,66834,3331,"Thierry Baudet (FvD)",0.88435176118771,0.355838051490225,0
"<anonymized_userid>",3,66837,3332,"Thierry Baudet (FvD)",0.884391457379522,0.355944877684008,0
"<anonymized_userid>",3,66840,3333,"Thierry Baudet (FvD)",0.884431153571334,0.356051703877791,0
"<anonymized_userid>",3,66843,3334,"Thierry Baudet (FvD)",0.884470849763146,0.356158530071574,0
"<anonymized_userid>",3,66846,3335,"Thierry Baudet (FvD)",0.884510545954958,0.356265356265356,0
"<anonymized_userid>",3,66849,3336,"Thierry Baudet (FvD)",0.88455024214677,0.356372182459139,0
"<anonymized_userid>",3,66852,3337,"Thierry Baudet (FvD)",0.884589938338582,0.356479008652922,0
"<anonymized_userid>",3,66855,3338,"Thierry Baudet (FvD)",0.884629634530394,0.356585834846704,0
"<anonymized_userid>",3,66858,3339,"Thierry Baudet (FvD)",0.884669330722206,0.356692661040487,0
"<anonymized_userid>",3,66861,3340,"Thierry Baudet (FvD)",0.884709026914018,0.35679948723427,0
"<anonymized_userid>",3,66864,3341,"Thierry Baudet (FvD)",0.88474872310583,0.356906313428053,0
"<anonymized_userid>",3,66867,3342,"Thierry Baudet (FvD)",0.884788419297642,0.357013139621835,0
"<anonymized_userid>",3,66870,3343,"Thierry Baudet (FvD)",0.884828115489454,0.357119965815618,0
"<anonymized_userid>",3,66873,3344,"Thierry Baudet (FvD)",0.884867811681266,0.357226792009401,0
"<anonymized_userid>",3,66876,3345,"Thierry Baudet (FvD)",0.884907507873078,0.357333618203183,0
"<anonymized_userid>",3,66879,3346,"Thierry Baudet (FvD)",0.88494720406489,0.357440444396966,0
"<anonymized_userid>",3,66882,3347,"Thierry Baudet (FvD)",0.884986900256702,0.357547270590749,0
"<anonymized_userid>",3,66885,3348,"Thierry Baudet (FvD)",0.885026596448514,0.357654096784532,0
"<anonymized_userid>",3,66888,3349,"Thierry Baudet (FvD)",0.885066292640326,0.357760922978314,0
"<anonymized_userid>",3,66891,3350,"Thierry Baudet (FvD)",0.885105988832138,0.357867749172097,0
"<anonymized_userid>",3,66894,3351,"Thierry Baudet (FvD)",0.88514568502395,0.35797457536588,0
"<anonymized_userid>",3,66897,3352,"Thierry Baudet (FvD)",0.885185381215762,0.358081401559662,0
"<anonymized_userid>",3,66900,3353,"Thierry Baudet (FvD)",0.885225077407574,0.358188227753445,0
"<anonymized_userid>",3,66903,3354,"Thierry Baudet (FvD)",0.885264773599386,0.358295053947228,0
"<anonymized_userid>",3,66906,3355,"Thierry Baudet (FvD)",0.885304469791198,0.358401880141011,0
"<anonymized_userid>",3,66909,3356,"Thierry Baudet (FvD)",0.88534416598301,0.358508706334793,0
"<anonymized_userid>",3,66912,3357,"Thierry Baudet (FvD)",0.885383862174822,0.358615532528576,0
"<anonymized_userid>",3,66915,3358,"Thierry Baudet (FvD)",0.885423558366634,0.358722358722359,0
"<anonymized_userid>",3,66918,3359,"Thierry Baudet (FvD)",0.885463254558446,0.358829184916141,0
"<anonymized_userid>",3,66921,3360,"Thierry Baudet (FvD)",0.885502950750258,0.358936011109924,0
"<anonymized_userid>",3,66924,3361,"Thierry Baudet (FvD)",0.88554264694207,0.359042837303707,0
"<anonymized_userid>",3,66927,3362,"Thierry Baudet (FvD)",0.885582343133882,0.35914966349749,0
"<anonymized_userid>",3,66930,3363,"Thierry Baudet (FvD)",0.885622039325694,0.359256489691272,0
"<anonymized_userid>",3,66933,3364,"Thierry Baudet (FvD)",0.885661735517506,0.359363315885055,0
"<anonymized_userid>",3,66936,3365,"Thierry Baudet (FvD)",0.885701431709318,0.359470142078838,0
"<anonymized_userid>",3,66939,3366,"Thierry Baudet (FvD)",0.88574112790113,0.35957696827262,0
"<anonymized_userid>",3,66942,3367,"Thierry Baudet (FvD)",0.885780824092942,0.359683794466403,0
"<anonymized_userid>",3,66945,3368,"Thierry Baudet (FvD)",0.885820520284754,0.359790620660186,0
"<anonymized_userid>",3,66948,3369,"Thierry Baudet (FvD)",0.885860216476566,0.359897446853969,0
"<anonymized_userid>",3,66951,3370,"Thierry Baudet (FvD)",0.885899912668378,0.360004273047751,0
"<anonymized_userid>",3,66954,3371,"Thierry Baudet (FvD)",0.88593960886019,0.360111099241534,0
"<anonymized_userid>",3,66957,3372,"Thierry Baudet (FvD)",0.885979305052002,0.360217925435317,0
"<anonymized_userid>",3,66960,3373,"Thierry Baudet (FvD)",0.886019001243814,0.360324751629099,0
"<anonymized_userid>",3,66963,3374,"Thierry Baudet (FvD)",0.886058697435626,0.360431577822882,0
"<anonymized_userid>",3,66966,3375,"Thierry Baudet (FvD)",0.886098393627438,0.360538404016665,0
"<anonymized_userid>",3,66969,3376,"Thierry Baudet (FvD)",0.88613808981925,0.360645230210448,0
"<anonymized_userid>",3,66972,3377,"Thierry Baudet (FvD)",0.886177786011062,0.36075205640423,0
"<anonymized_userid>",3,66975,3378,"Thierry Baudet (FvD)",0.886217482202874,0.360858882598013,0
"<anonymized_userid>",3,66978,3379,"Thierry Baudet (FvD)",0.886257178394686,0.360965708791796,0
"<anonymized_userid>",3,66981,3380,"Thierry Baudet (FvD)",0.886296874586498,0.361072534985578,0
"<anonymized_userid>",3,66984,3381,"Thierry Baudet (FvD)",0.88633657077831,0.361179361179361,0
"<anonymized_userid>",3,66987,3382,"Thierry Baudet (FvD)",0.886376266970122,0.361286187373144,0
"<anonymized_userid>",3,66990,3383,"Thierry Baudet (FvD)",0.886415963161934,0.361393013566927,0
"<anonymized_userid>",3,66993,3384,"Thierry Baudet (FvD)",0.886455659353746,0.361499839760709,0
"<anonymized_userid>",3,66996,3385,"Thierry Baudet (FvD)",0.886495355545558,0.361606665954492,0
"<anonymized_userid>",3,66999,3386,"Thierry Baudet (FvD)",0.88653505173737,0.361713492148275,0
"<anonymized_userid>",3,67002,3387,"Thierry Baudet (FvD)",0.886574747929182,0.361820318342057,0
"<anonymized_userid>",3,67005,3388,"Thierry Baudet (FvD)",0.886614444120994,0.36192714453584,0
"<anonymized_userid>",3,67008,3389,"Thierry Baudet (FvD)",0.886654140312806,0.362033970729623,0
"<anonymized_userid>",3,67011,3390,"Thierry Baudet (FvD)",0.886693836504618,0.362140796923406,0
"<anonymized_userid>",3,67014,3391,"Thierry Baudet (FvD)",0.88673353269643,0.362247623117188,0
"<anonymized_userid>",3,67017,3392,"Thierry Baudet (FvD)",0.886773228888242,0.362354449310971,0
"<anonymized_userid>",3,67020,3393,"Thierry Baudet (FvD)",0.886812925080054,0.362461275504754,0
"<anonymized_userid>",3,67023,3394,"Thierry Baudet (FvD)",0.886852621271866,0.362568101698536,0
"<anonymized_userid>",3,67026,3395,"Thierry Baudet (FvD)",0.886892317463678,0.362674927892319,0
"<anonymized_userid>",3,67029,3396,"Thierry Baudet (FvD)",0.88693201365549,0.362781754086102,0
"<anonymized_userid>",3,67032,3397,"Thierry Baudet (FvD)",0.886971709847302,0.362888580279885,0
"<anonymized_userid>",3,67035,3398,"Thierry Baudet (FvD)",0.887011406039114,0.362995406473667,0
"<anonymized_userid>",3,67038,3399,"Thierry Baudet (FvD)",0.887051102230926,0.36310223266745,0
"<anonymized_userid>",3,67041,3400,"Thierry Baudet (FvD)",0.887090798422738,0.363209058861233,0
"<anonymized_userid>",3,67044,3401,"Thierry Baudet (FvD)",0.88713049461455,0.363315885055015,0
"<anonymized_userid>",3,67047,3402,"Thierry Baudet (FvD)",0.887170190806362,0.363422711248798,0
"<anonymized_userid>",3,67050,3403,"Thierry Baudet (FvD)",0.887209886998174,0.363529537442581,0
"<anonymized_userid>",3,67053,3404,"Thierry Baudet (FvD)",0.887249583189986,0.363636363636364,0
"<anonymized_userid>",3,67056,3405,"Thierry Baudet (FvD)",0.887289279381798,0.363743189830146,0
"<anonymized_userid>",3,67059,3406,"Thierry Baudet (FvD)",0.88732897557361,0.363850016023929,0
"<anonymized_userid>",3,67062,3407,"Thierry Baudet (FvD)",0.887368671765422,0.363956842217712,0
"<anonymized_userid>",3,67065,3408,"Thierry Baudet (FvD)",0.887408367957234,0.364063668411495,0
"<anonymized_userid>",3,67068,3409,"Thierry Baudet (FvD)",0.887448064149046,0.364170494605277,0
"<anonymized_userid>",3,67071,3410,"Thierry Baudet (FvD)",0.887487760340858,0.36427732079906,0
"<anonymized_userid>",3,67074,3411,"Thierry Baudet (FvD)",0.88752745653267,0.364384146992843,0
"<anonymized_userid>",3,67077,3412,"Thierry Baudet (FvD)",0.887567152724482,0.364490973186625,0
"<anonymized_userid>",3,67080,3413,"Thierry Baudet (FvD)",0.887606848916294,0.364597799380408,0
"<anonymized_userid>",3,67083,3414,"Thierry Baudet (FvD)",0.887646545108106,0.364704625574191,0
"<anonymized_userid>",3,67086,3415,"Thierry Baudet (FvD)",0.887686241299918,0.364811451767974,0
"<anonymized_userid>",3,67089,3416,"Thierry Baudet (FvD)",0.88772593749173,0.364918277961756,0
"<anonymized_userid>",3,67092,3417,"Thierry Baudet (FvD)",0.887765633683542,0.365025104155539,0
"<anonymized_userid>",3,67095,3418,"Thierry Baudet (FvD)",0.887805329875354,0.365131930349322,0
"<anonymized_userid>",3,67098,3419,"Thierry Baudet (FvD)",0.887845026067166,0.365238756543104,0
"<anonymized_userid>",3,67101,3420,"Thierry Baudet (FvD)",0.887884722258978,0.365345582736887,0
"<anonymized_userid>",3,67104,3421,"Thierry Baudet (FvD)",0.88792441845079,0.36545240893067,0
"<anonymized_userid>",3,67107,3422,"Thierry Baudet (FvD)",0.887964114642602,0.365559235124453,0
"<anonymized_userid>",3,67110,3423,"Thierry Baudet (FvD)",0.888003810834414,0.365666061318235,0
"<anonymized_userid>",3,67113,3424,"Thierry Baudet (FvD)",0.888043507026226,0.365772887512018,0
"<anonymized_userid>",3,67116,3425,"Thierry Baudet (FvD)",0.888083203218038,0.365879713705801,0
"<anonymized_userid>",3,67119,3426,"Thierry Baudet (FvD)",0.88812289940985,0.365986539899583,0
"<anonymized_userid>",3,67122,3427,"Thierry Baudet (FvD)",0.888162595601662,0.366093366093366,0
"<anonymized_userid>",3,67125,3428,"Thierry Baudet (FvD)",0.888202291793474,0.366200192287149,0
"<anonymized_userid>",3,67128,3429,"Thierry Baudet (FvD)",0.888241987985286,0.366307018480932,0
"<anonymized_userid>",3,67131,3430,"Thierry Baudet (FvD)",0.888281684177098,0.366413844674714,0
"<anonymized_userid>",3,67134,3431,"Thierry Baudet (FvD)",0.88832138036891,0.366520670868497,0
"<anonymized_userid>",3,67137,3432,"Thierry Baudet (FvD)",0.888361076560722,0.36662749706228,0
"<anonymized_userid>",3,67140,3433,"Thierry Baudet (FvD)",0.888400772752534,0.366734323256062,0
"<anonymized_userid>",3,67143,3434,"Thierry Baudet (FvD)",0.888440468944346,0.366841149449845,0
"<anonymized_userid>",3,67146,3435,"Thierry Baudet (FvD)",0.888480165136158,0.366947975643628,0
"<anonymized_userid>",3,67149,3436,"Thierry Baudet (FvD)",0.88851986132797,0.367054801837411,0
"<anonymized_userid>",3,67152,3437,"Thierry Baudet (FvD)",0.888559557519782,0.367161628031193,0
"<anonymized_userid>",3,67155,3438,"Thierry Baudet (FvD)",0.888599253711594,0.367268454224976,0
"<anonymized_userid>",3,67158,3439,"Thierry Baudet (FvD)",0.888638949903406,0.367375280418759,0
"<anonymized_userid>",3,67161,3440,"Thierry Baudet (FvD)",0.888678646095218,0.367482106612541,0
"<anonymized_userid>",3,67164,3441,"Thierry Baudet (FvD)",0.88871834228703,0.367588932806324,0
"<anonymized_userid>",3,67167,3442,"Thierry Baudet (FvD)",0.888758038478842,0.367695759000107,0
"<anonymized_userid>",3,67170,3443,"Thierry Baudet (FvD)",0.888797734670654,0.36780258519389,0
"<anonymized_userid>",3,67173,3444,"Thierry Baudet (FvD)",0.888837430862466,0.367909411387672,0
"<anonymized_userid>",3,67176,3445,"Thierry Baudet (FvD)",0.888877127054278,0.368016237581455,0
"<anonymized_userid>",3,67179,3446,"Thierry Baudet (FvD)",0.88891682324609,0.368123063775238,0
"<anonymized_userid>",3,67182,3447,"Thierry Baudet (FvD)",0.888956519437902,0.36822988996902,0
"<anonymized_userid>",3,67185,3448,"Thierry Baudet (FvD)",0.888996215629714,0.368336716162803,0
"<anonymized_userid>",3,67188,3449,"Thierry Baudet (FvD)",0.889035911821526,0.368443542356586,0
"<anonymized_userid>",3,67191,3450,"Thierry Baudet (FvD)",0.889075608013338,0.368550368550369,0
"<anonymized_userid>",3,67194,3451,"Thierry Baudet (FvD)",0.88911530420515,0.368657194744151,0
"<anonymized_userid>",3,67197,3452,"Thierry Baudet (FvD)",0.889155000396962,0.368764020937934,0
"<anonymized_userid>",3,67200,3453,"Thierry Baudet (FvD)",0.889194696588774,0.368870847131717,0
"<anonymized_userid>",3,67203,3454,"Thierry Baudet (FvD)",0.889234392780586,0.368977673325499,0
"<anonymized_userid>",3,67206,3455,"Thierry Baudet (FvD)",0.889274088972398,0.369084499519282,0
"<anonymized_userid>",3,67209,3456,"Thierry Baudet (FvD)",0.88931378516421,0.369191325713065,0
"<anonymized_userid>",3,67212,3457,"Thierry Baudet (FvD)",0.889353481356022,0.369298151906848,0
"<anonymized_userid>",3,67215,3458,"Thierry Baudet (FvD)",0.889393177547834,0.36940497810063,0
"<anonymized_userid>",3,67218,3459,"Thierry Baudet (FvD)",0.889432873739646,0.369511804294413,0
"<anonymized_userid>",3,67221,3460,"Thierry Baudet (FvD)",0.889472569931458,0.369618630488196,0
"<anonymized_userid>",3,67224,3461,"Thierry Baudet (FvD)",0.88951226612327,0.369725456681978,0
"<anonymized_userid>",3,67227,3462,"Thierry Baudet (FvD)",0.889551962315082,0.369832282875761,0
"<anonymized_userid>",3,67230,3463,"Thierry Baudet (FvD)",0.889591658506894,0.369939109069544,0
"<anonymized_userid>",3,67233,3464,"Thierry Baudet (FvD)",0.889631354698706,0.370045935263327,0
"<anonymized_userid>",3,67236,3465,"Thierry Baudet (FvD)",0.889671050890518,0.370152761457109,0
"<anonymized_userid>",3,67239,3466,"Thierry Baudet (FvD)",0.88971074708233,0.370259587650892,0
"<anonymized_userid>",3,67242,3467,"Thierry Baudet (FvD)",0.889750443274142,0.370366413844675,0
"<anonymized_userid>",3,67245,3468,"Thierry Baudet (FvD)",0.889790139465954,0.370473240038457,0
"<anonymized_userid>",3,67248,3469,"Thierry Baudet (FvD)",0.889829835657766,0.37058006623224,0
"<anonymized_userid>",3,67251,3470,"Thierry Baudet (FvD)",0.889869531849578,0.370686892426023,0
"<anonymized_userid>",3,67254,3471,"Thierry Baudet (FvD)",0.88990922804139,0.370793718619806,0
"<anonymized_userid>",3,67257,3472,"Thierry Baudet (FvD)",0.889948924233202,0.370900544813588,0
"<anonymized_userid>",3,67260,3473,"Thierry Baudet (FvD)",0.889988620425014,0.371007371007371,0
"<anonymized_userid>",3,67263,3474,"Thierry Baudet (FvD)",0.890028316616826,0.371114197201154,0
"<anonymized_userid>",3,67266,3475,"Thierry Baudet (FvD)",0.890068012808638,0.371221023394936,0
"<anonymized_userid>",3,67269,3476,"Thierry Baudet (FvD)",0.89010770900045,0.371327849588719,0
"<anonymized_userid>",3,67272,3477,"Thierry Baudet (FvD)",0.890147405192262,0.371434675782502,0
"<anonymized_userid>",3,67275,3478,"Thierry Baudet (FvD)",0.890187101384074,0.371541501976285,0
"<anonymized_userid>",3,67278,3479,"Thierry Baudet (FvD)",0.890226797575886,0.371648328170067,0
"<anonymized_userid>",3,67281,3480,"Thierry Baudet (FvD)",0.890266493767698,0.37175515436385,0
"<anonymized_userid>",3,67284,3481,"Thierry Baudet (FvD)",0.89030618995951,0.371861980557633,0
"<anonymized_userid>",3,67287,3482,"Thierry Baudet (FvD)",0.890345886151322,0.371968806751415,0
"<anonymized_userid>",3,67290,3483,"Thierry Baudet (FvD)",0.890385582343134,0.372075632945198,0
"<anonymized_userid>",3,67293,3484,"Thierry Baudet (FvD)",0.890425278534946,0.372182459138981,0
"<anonymized_userid>",3,67296,3485,"Thierry Baudet (FvD)",0.890464974726758,0.372289285332764,0
"<anonymized_userid>",3,67299,3486,"Thierry Baudet (FvD)",0.89050467091857,0.372396111526546,0
"<anonymized_userid>",3,67302,3487,"Thierry Baudet (FvD)",0.890544367110382,0.372502937720329,0
"<anonymized_userid>",3,67305,3488,"Thierry Baudet (FvD)",0.890584063302194,0.372609763914112,0
"<anonymized_userid>",3,67308,3489,"Thierry Baudet (FvD)",0.890623759494006,0.372716590107894,0
"<anonymized_userid>",3,67311,3490,"Thierry Baudet (FvD)",0.890663455685818,0.372823416301677,0
"<anonymized_userid>",3,67314,3491,"Thierry Baudet (FvD)",0.89070315187763,0.37293024249546,0
"<anonymized_userid>",3,67317,3492,"Thierry Baudet (FvD)",0.890742848069442,0.373037068689243,0
"<anonymized_userid>",3,67320,3493,"Thierry Baudet (FvD)",0.890782544261254,0.373143894883025,0
"<anonymized_userid>",3,67323,3494,"Thierry Baudet (FvD)",0.890822240453066,0.373250721076808,0
"<anonymized_userid>",3,67326,3495,"Thierry Baudet (FvD)",0.890861936644878,0.373357547270591,0
"<anonymized_userid>",3,67329,3496,"Thierry Baudet (FvD)",0.89090163283669,0.373464373464373,0
"<anonymized_userid>",3,67332,3497,"Thierry Baudet (FvD)",0.890941329028502,0.373571199658156,0
"<anonymized_userid>",3,67335,3498,"Thierry Baudet (FvD)",0.890981025220314,0.373678025851939,0
"<anonymized_userid>",3,67338,3499,"Thierry Baudet (FvD)",0.891020721412126,0.373784852045722,0
"<anonymized_userid>",3,67341,3500,"Thierry Baudet (FvD)",0.891060417603938,0.373891678239504,0
"<anonymized_userid>",3,67344,3501,"Thierry Baudet (FvD)",0.89110011379575,0.373998504433287,0
"<anonymized_userid>",3,67347,3502,"Thierry Baudet (FvD)",0.891139809987562,0.37410533062707,0
"<anonymized_userid>",3,67350,3503,"Thierry Baudet (FvD)",0.891179506179374,0.374212156820852,0
"<anonymized_userid>",3,67353,3504,"Thierry Baudet (FvD)",0.891219202371186,0.374318983014635,0
"<anonymized_userid>",3,67356,3505,"Thierry Baudet (FvD)",0.891258898562998,0.374425809208418,0
"<anonymized_userid>",3,67359,3506,"Thierry Baudet (FvD)",0.89129859475481,0.374532635402201,0
"<anonymized_userid>",3,67362,3507,"Thierry Baudet (FvD)",0.891338290946622,0.374639461595983,0
"<anonymized_userid>",3,67365,3508,"Thierry Baudet (FvD)",0.891377987138434,0.374746287789766,0
"<anonymized_userid>",3,67368,3509,"Thierry Baudet (FvD)",0.891417683330246,0.374853113983549,0
"<anonymized_userid>",3,67371,3510,"Thierry Baudet (FvD)",0.891457379522058,0.374959940177331,0
"<anonymized_userid>",3,67374,3511,"Thierry Baudet (FvD)",0.89149707571387,0.375066766371114,0
"<anonymized_userid>",3,67377,3512,"Thierry Baudet (FvD)",0.891536771905682,0.375173592564897,0
"<anonymized_userid>",3,67380,3513,"Thierry Baudet (FvD)",0.891576468097494,0.37528041875868,0
"<anonymized_userid>",3,67383,3514,"Thierry Baudet (FvD)",0.891616164289306,0.375387244952462,0
"<anonymized_userid>",3,67386,3515,"Thierry Baudet (FvD)",0.891655860481118,0.375494071146245,0
"<anonymized_userid>",3,67389,3516,"Thierry Baudet (FvD)",0.89169555667293,0.375600897340028,0
"<anonymized_userid>",3,67392,3517,"Thierry Baudet (FvD)",0.891735252864742,0.37570772353381,0
"<anonymized_userid>",3,67395,3518,"Thierry Baudet (FvD)",0.891774949056554,0.375814549727593,0
"<anonymized_userid>",3,67398,3519,"Thierry Baudet (FvD)",0.891814645248366,0.375921375921376,0
"<anonymized_userid>",3,67401,3520,"Thierry Baudet (FvD)",0.891854341440178,0.376028202115159,0
"<anonymized_userid>",3,67404,3521,"Thierry Baudet (FvD)",0.89189403763199,0.376135028308941,0
"<anonymized_userid>",3,67407,3522,"Thierry Baudet (FvD)",0.891933733823802,0.376241854502724,0
"<anonymized_userid>",3,67410,3523,"Thierry Baudet (FvD)",0.891973430015614,0.376348680696507,0
"<anonymized_userid>",3,67413,3524,"Thierry Baudet (FvD)",0.892013126207426,0.37645550689029,0
"<anonymized_userid>",3,67416,3525,"Thierry Baudet (FvD)",0.892052822399238,0.376562333084072,0
"<anonymized_userid>",3,67419,3526,"Thierry Baudet (FvD)",0.89209251859105,0.376669159277855,0
"<anonymized_userid>",3,67422,3527,"Thierry Baudet (FvD)",0.892132214782862,0.376775985471638,0
"<anonymized_userid>",3,67425,3528,"Thierry Baudet (FvD)",0.892171910974674,0.37688281166542,0
"<anonymized_userid>",3,67428,3529,"Thierry Baudet (FvD)",0.892211607166486,0.376989637859203,0
"<anonymized_userid>",3,67431,3530,"Thierry Baudet (FvD)",0.892251303358298,0.377096464052986,0
"<anonymized_userid>",3,67434,3531,"Thierry Baudet (FvD)",0.89229099955011,0.377203290246769,0
"<anonymized_userid>",3,67437,3532,"Thierry Baudet (FvD)",0.892330695741922,0.377310116440551,0
"<anonymized_userid>",3,67440,3533,"Thierry Baudet (FvD)",0.892370391933734,0.377416942634334,0
"<anonymized_userid>",3,67443,3534,"Thierry Baudet (FvD)",0.892410088125546,0.377523768828117,0
"<anonymized_userid>",3,67446,3535,"Thierry Baudet (FvD)",0.892449784317358,0.377630595021899,0
"<anonymized_userid>",3,67449,3536,"Thierry Baudet (FvD)",0.89248948050917,0.377737421215682,0
"<anonymized_userid>",3,67452,3537,"Thierry Baudet (FvD)",0.892529176700982,0.377844247409465,0
"<anonymized_userid>",3,67455,3538,"Thierry Baudet (FvD)",0.892568872892794,0.377951073603248,0
"<anonymized_userid>",3,67458,3539,"Thierry Baudet (FvD)",0.892608569084606,0.37805789979703,0
"<anonymized_userid>",3,67461,3540,"Thierry Baudet (FvD)",0.892648265276418,0.378164725990813,0
"<anonymized_userid>",3,67464,3541,"Thierry Baudet (FvD)",0.89268796146823,0.378271552184596,0
"<anonymized_userid>",3,67467,3542,"Thierry Baudet (FvD)",0.892727657660042,0.378378378378378,0
"<anonymized_userid>",3,67470,3543,"Thierry Baudet (FvD)",0.892767353851854,0.378485204572161,0
"<anonymized_userid>",3,67473,3544,"Thierry Baudet (FvD)",0.892807050043666,0.378592030765944,0
"<anonymized_userid>",3,67476,3545,"Thierry Baudet (FvD)",0.892846746235478,0.378698856959727,0
"<anonymized_userid>",3,67479,3546,"Thierry Baudet (FvD)",0.89288644242729,0.378805683153509,0
"<anonymized_userid>",3,67482,3547,"Thierry Baudet (FvD)",0.892926138619102,0.378912509347292,0
"<anonymized_userid>",3,67485,3548,"Thierry Baudet (FvD)",0.892965834810914,0.379019335541075,0
"<anonymized_userid>",3,67488,3549,"Thierry Baudet (FvD)",0.893005531002726,0.379126161734857,0
"<anonymized_userid>",3,67491,3550,"Thierry Baudet (FvD)",0.893045227194538,0.37923298792864,0
"<anonymized_userid>",3,67494,3551,"Thierry Baudet (FvD)",0.89308492338635,0.379339814122423,0
"<anonymized_userid>",3,67497,3552,"Thierry Baudet (FvD)",0.893124619578162,0.379446640316206,0
"<anonymized_userid>",3,67500,3553,"Thierry Baudet (FvD)",0.893164315769974,0.379553466509988,0
"<anonymized_userid>",3,67503,3554,"Thierry Baudet (FvD)",0.893204011961786,0.379660292703771,0
"<anonymized_userid>",3,67506,3555,"Thierry Baudet (FvD)",0.893243708153598,0.379767118897554,0
"<anonymized_userid>",3,67509,3556,"Thierry Baudet (FvD)",0.89328340434541,0.379873945091336,0
"<anonymized_userid>",3,67512,3557,"Thierry Baudet (FvD)",0.893323100537222,0.379980771285119,0
"<anonymized_userid>",3,67515,3558,"Thierry Baudet (FvD)",0.893362796729034,0.380087597478902,0
"<anonymized_userid>",3,67518,3559,"Thierry Baudet (FvD)",0.893402492920846,0.380194423672685,0
"<anonymized_userid>",3,67521,3560,"Thierry Baudet (FvD)",0.893442189112658,0.380301249866467,0
"<anonymized_userid>",3,67524,3561,"Thierry Baudet (FvD)",0.89348188530447,0.38040807606025,0
"<anonymized_userid>",3,67527,3562,"Thierry Baudet (FvD)",0.893521581496282,0.380514902254033,0
"<anonymized_userid>",3,67530,3563,"Thierry Baudet (FvD)",0.893561277688094,0.380621728447815,0
"<anonymized_userid>",3,67533,3564,"Thierry Baudet (FvD)",0.893600973879906,0.380728554641598,0
"<anonymized_userid>",3,67536,3565,"Thierry Baudet (FvD)",0.893640670071718,0.380835380835381,0
"<anonymized_userid>",3,67539,3566,"Thierry Baudet (FvD)",0.89368036626353,0.380942207029164,0
"<anonymized_userid>",3,67542,3567,"Thierry Baudet (FvD)",0.893720062455342,0.381049033222946,0
"<anonymized_userid>",3,67545,3568,"Thierry Baudet (FvD)",0.893759758647154,0.381155859416729,0
"<anonymized_userid>",3,67548,3569,"Thierry Baudet (FvD)",0.893799454838966,0.381262685610512,0
"<anonymized_userid>",3,67551,3570,"Thierry Baudet (FvD)",0.893839151030778,0.381369511804294,0
"<anonymized_userid>",3,67554,3571,"Thierry Baudet (FvD)",0.89387884722259,0.381476337998077,0
"<anonymized_userid>",3,67557,3572,"Thierry Baudet (FvD)",0.893918543414402,0.38158316419186,0
"<anonymized_userid>",3,67560,3573,"Thierry Baudet (FvD)",0.893958239606214,0.381689990385643,0
"<anonymized_userid>",3,67563,3574,"Thierry Baudet (FvD)",0.893997935798026,0.381796816579425,0
"<anonymized_userid>",3,67566,3575,"Thierry Baudet (FvD)",0.894037631989838,0.381903642773208,0
"<anonymized_userid>",3,67569,3576,"Thierry Baudet (FvD)",0.89407732818165,0.382010468966991,0
"<anonymized_userid>",3,67572,3577,"Thierry Baudet (FvD)",0.894117024373462,0.382117295160773,0
"<anonymized_userid>",3,67575,3578,"Thierry Baudet (FvD)",0.894156720565274,0.382224121354556,0
"<anonymized_userid>",3,67578,3579,"Thierry Baudet (FvD)",0.894196416757086,0.382330947548339,0
"<anonymized_userid>",3,67581,3580,"Thierry Baudet (FvD)",0.894236112948898,0.382437773742122,0
"<anonymized_userid>",3,67584,3581,"Thierry Baudet (FvD)",0.89427580914071,0.382544599935904,0
"<anonymized_userid>",3,67587,3582,"Thierry Baudet (FvD)",0.894315505332522,0.382651426129687,0
"<anonymized_userid>",3,67590,3583,"Thierry Baudet (FvD)",0.894355201524334,0.38275825232347,0
"<anonymized_userid>",3,67593,3584,"Thierry Baudet (FvD)",0.894394897716146,0.382865078517252,0
"<anonymized_userid>",3,67596,3585,"Thierry Baudet (FvD)",0.894434593907958,0.382971904711035,0
"<anonymized_userid>",3,67599,3586,"Thierry Baudet (FvD)",0.89447429009977,0.383078730904818,0
"<anonymized_userid>",3,67602,3587,"Thierry Baudet (FvD)",0.894513986291582,0.383185557098601,0
"<anonymized_userid>",3,67605,3588,"Thierry Baudet (FvD)",0.894553682483394,0.383292383292383,0
"<anonymized_userid>",3,67608,3589,"Thierry Baudet (FvD)",0.894593378675206,0.383399209486166,0
"<anonymized_userid>",3,67611,3590,"Thierry Baudet (FvD)",0.894633074867018,0.383506035679949,0
"<anonymized_userid>",3,67614,3591,"Thierry Baudet (FvD)",0.89467277105883,0.383612861873731,0
"<anonymized_userid>",3,67617,3592,"Thierry Baudet (FvD)",0.894712467250642,0.383719688067514,0
"<anonymized_userid>",3,67620,3593,"Thierry Baudet (FvD)",0.894752163442454,0.383826514261297,0
"<anonymized_userid>",3,67623,3594,"Thierry Baudet (FvD)",0.894791859634266,0.38393334045508,0
"<anonymized_userid>",3,67626,3595,"Thierry Baudet (FvD)",0.894831555826078,0.384040166648862,0
"<anonymized_userid>",3,67629,3596,"Thierry Baudet (FvD)",0.89487125201789,0.384146992842645,0
"<anonymized_userid>",3,67632,3597,"Thierry Baudet (FvD)",0.894910948209702,0.384253819036428,0
"<anonymized_userid>",3,67635,3598,"Thierry Baudet (FvD)",0.894950644401514,0.38436064523021,0
"<anonymized_userid>",3,67638,3599,"Thierry Baudet (FvD)",0.894990340593326,0.384467471423993,0
"<anonymized_userid>",3,67641,3600,"Thierry Baudet (FvD)",0.895030036785138,0.384574297617776,0
"<anonymized_userid>",3,67644,3601,"Thierry Baudet (FvD)",0.89506973297695,0.384681123811559,0
"<anonymized_userid>",3,67647,3602,"Thierry Baudet (FvD)",0.895109429168762,0.384787950005341,0
"<anonymized_userid>",3,67650,3603,"Thierry Baudet (FvD)",0.895149125360574,0.384894776199124,0
"<anonymized_userid>",3,67653,3604,"Thierry Baudet (FvD)",0.895188821552386,0.385001602392907,0
"<anonymized_userid>",3,67656,3605,"Thierry Baudet (FvD)",0.895228517744198,0.385108428586689,0
"<anonymized_userid>",3,67659,3606,"Thierry Baudet (FvD)",0.89526821393601,0.385215254780472,0
"<anonymized_userid>",3,67662,3607,"Thierry Baudet (FvD)",0.895307910127822,0.385322080974255,0
"<anonymized_userid>",3,67665,3608,"Thierry Baudet (FvD)",0.895347606319634,0.385428907168038,0
"<anonymized_userid>",3,67668,3609,"Thierry Baudet (FvD)",0.895387302511446,0.38553573336182,0
"<anonymized_userid>",3,67671,3610,"Thierry Baudet (FvD)",0.895426998703258,0.385642559555603,0
"<anonymized_userid>",3,67674,3611,"Thierry Baudet (FvD)",0.89546669489507,0.385749385749386,0
"<anonymized_userid>",3,67677,3612,"Thierry Baudet (FvD)",0.895506391086882,0.385856211943168,0
"<anonymized_userid>",3,67680,3613,"Thierry Baudet (FvD)",0.895546087278694,0.385963038136951,0
"<anonymized_userid>",3,67683,3614,"Thierry Baudet (FvD)",0.895585783470506,0.386069864330734,0
"<anonymized_userid>",3,67686,3615,"Thierry Baudet (FvD)",0.895625479662318,0.386176690524517,0
"<anonymized_userid>",3,67689,3616,"Thierry Baudet (FvD)",0.89566517585413,0.386283516718299,0
"<anonymized_userid>",3,67692,3617,"Thierry Baudet (FvD)",0.895704872045942,0.386390342912082,0
"<anonymized_userid>",3,67695,3618,"Thierry Baudet (FvD)",0.895744568237754,0.386497169105865,0
"<anonymized_userid>",3,67698,3619,"Thierry Baudet (FvD)",0.895784264429566,0.386603995299647,0
"<anonymized_userid>",3,67701,3620,"Thierry Baudet (FvD)",0.895823960621378,0.38671082149343,0
"<anonymized_userid>",3,67704,3621,"Thierry Baudet (FvD)",0.89586365681319,0.386817647687213,0
"<anonymized_userid>",3,67707,3622,"Thierry Baudet (FvD)",0.895903353005002,0.386924473880996,0
"<anonymized_userid>",3,67710,3623,"Thierry Baudet (FvD)",0.895943049196814,0.387031300074778,0
"<anonymized_userid>",3,67713,3624,"Thierry Baudet (FvD)",0.895982745388626,0.387138126268561,0
"<anonymized_userid>",3,67716,3625,"Thierry Baudet (FvD)",0.896022441580438,0.387244952462344,0
"<anonymized_userid>",3,67719,3626,"Thierry Baudet (FvD)",0.89606213777225,0.387351778656126,0
"<anonymized_userid>",3,67722,3627,"Thierry Baudet (FvD)",0.896101833964062,0.387458604849909,0
"<anonymized_userid>",3,67725,3628,"Thierry Baudet (FvD)",0.896141530155874,0.387565431043692,0
"<anonymized_userid>",3,67728,3629,"Thierry Baudet (FvD)",0.896181226347686,0.387672257237475,0
"<anonymized_userid>",3,67731,3630,"Thierry Baudet (FvD)",0.896220922539498,0.387779083431257,0
"<anonymized_userid>",3,67734,3631,"Thierry Baudet (FvD)",0.89626061873131,0.38788590962504,0
"<anonymized_userid>",3,67737,3632,"Thierry Baudet (FvD)",0.896300314923122,0.387992735818823,0
"<anonymized_userid>",3,67740,3633,"Thierry Baudet (FvD)",0.896340011114934,0.388099562012605,0
"<anonymized_userid>",3,67743,3634,"Thierry Baudet (FvD)",0.896379707306746,0.388206388206388,0
"<anonymized_userid>",3,67746,3635,"Thierry Baudet (FvD)",0.896419403498558,0.388313214400171,0
"<anonymized_userid>",3,67749,3636,"Thierry Baudet (FvD)",0.89645909969037,0.388420040593954,0
"<anonymized_userid>",3,67752,3637,"Thierry Baudet (FvD)",0.896498795882182,0.388526866787736,0
"<anonymized_userid>",3,67755,3638,"Thierry Baudet (FvD)",0.896538492073994,0.388633692981519,0
"<anonymized_userid>",3,67758,3639,"Thierry Baudet (FvD)",0.896578188265806,0.388740519175302,0
"<anonymized_userid>",3,67761,3640,"Thierry Baudet (FvD)",0.896617884457618,0.388847345369084,0
"<anonymized_userid>",3,67764,3641,"Thierry Baudet (FvD)",0.89665758064943,0.388954171562867,0
"<anonymized_userid>",3,67767,3642,"Thierry Baudet (FvD)",0.896697276841242,0.38906099775665,0
"<anonymized_userid>",3,67770,3643,"Thierry Baudet (FvD)",0.896736973033054,0.389167823950433,0
"<anonymized_userid>",3,67773,3644,"Thierry Baudet (FvD)",0.896776669224866,0.389274650144215,0
"<anonymized_userid>",3,67776,3645,"Thierry Baudet (FvD)",0.896816365416678,0.389381476337998,0
"<anonymized_userid>",3,67779,3646,"Thierry Baudet (FvD)",0.89685606160849,0.389488302531781,0
"<anonymized_userid>",3,67782,3647,"Thierry Baudet (FvD)",0.896895757800302,0.389595128725564,0
"<anonymized_userid>",3,67785,3648,"Thierry Baudet (FvD)",0.896935453992114,0.389701954919346,0
"<anonymized_userid>",3,67788,3649,"Thierry Baudet (FvD)",0.896975150183926,0.389808781113129,0
"<anonymized_userid>",3,67791,3650,"Thierry Baudet (FvD)",0.897014846375738,0.389915607306912,0
"<anonymized_userid>",3,67794,3651,"Thierry Baudet (FvD)",0.89705454256755,0.390022433500694,0
"<anonymized_userid>",3,67797,3652,"Thierry Baudet (FvD)",0.897094238759362,0.390129259694477,0
"<anonymized_userid>",3,67800,3653,"Thierry Baudet (FvD)",0.897133934951174,0.39023608588826,0
"<anonymized_userid>",3,67803,3654,"Thierry Baudet (FvD)",0.897173631142986,0.390342912082043,0
"<anonymized_userid>",3,67806,3655,"Thierry Baudet (FvD)",0.897213327334798,0.390449738275825,0
"<anonymized_userid>",3,67809,3656,"Thierry Baudet (FvD)",0.89725302352661,0.390556564469608,0
"<anonymized_userid>",3,67812,3657,"Thierry Baudet (FvD)",0.897292719718422,0.390663390663391,0
"<anonymized_userid>",3,67815,3658,"Thierry Baudet (FvD)",0.897332415910234,0.390770216857173,0
"<anonymized_userid>",3,67818,3659,"Thierry Baudet (FvD)",0.897372112102046,0.390877043050956,0
"<anonymized_userid>",3,67821,3660,"Thierry Baudet (FvD)",0.897411808293858,0.390983869244739,0
"<anonymized_userid>",3,67824,3661,"Thierry Baudet (FvD)",0.89745150448567,0.391090695438522,0
"<anonymized_userid>",3,67827,3662,"Thierry Baudet (FvD)",0.897491200677482,0.391197521632304,0
"<anonymized_userid>",3,67830,3663,"Thierry Baudet (FvD)",0.897530896869294,0.391304347826087,0
"<anonymized_userid>",3,67833,3664,"Thierry Baudet (FvD)",0.897570593061106,0.39141117401987,0
"<anonymized_userid>",3,67836,3665,"Thierry Baudet (FvD)",0.897610289252918,0.391518000213652,0
"<anonymized_userid>",3,67839,3666,"Thierry Baudet (FvD)",0.89764998544473,0.391624826407435,0
"<anonymized_userid>",3,67842,3667,"Thierry Baudet (FvD)",0.897689681636542,0.391731652601218,0
"<anonymized_userid>",3,67845,3668,"Thierry Baudet (FvD)",0.897729377828354,0.391838478795001,0
"<anonymized_userid>",3,67848,3669,"Thierry Baudet (FvD)",0.897769074020166,0.391945304988783,0
"<anonymized_userid>",3,67851,3670,"Thierry Baudet (FvD)",0.897808770211978,0.392052131182566,0
"<anonymized_userid>",3,67854,3671,"Thierry Baudet (FvD)",0.89784846640379,0.392158957376349,0
"<anonymized_userid>",3,67857,3672,"Thierry Baudet (FvD)",0.897888162595602,0.392265783570131,0
"<anonymized_userid>",3,67860,3673,"Thierry Baudet (FvD)",0.897927858787414,0.392372609763914,0
"<anonymized_userid>",3,67863,3674,"Thierry Baudet (FvD)",0.897967554979226,0.392479435957697,0
"<anonymized_userid>",3,67866,3675,"Thierry Baudet (FvD)",0.898007251171038,0.39258626215148,0
"<anonymized_userid>",3,67869,3676,"Thierry Baudet (FvD)",0.89804694736285,0.392693088345262,0
"<anonymized_userid>",3,67872,3677,"Thierry Baudet (FvD)",0.898086643554662,0.392799914539045,0
"<anonymized_userid>",3,67875,3678,"Thierry Baudet (FvD)",0.898126339746474,0.392906740732828,0
"<anonymized_userid>",3,67878,3679,"Thierry Baudet (FvD)",0.898166035938286,0.39301356692661,0
"<anonymized_userid>",3,67881,3680,"Thierry Baudet (FvD)",0.898205732130098,0.393120393120393,0
"<anonymized_userid>",3,67884,3681,"Thierry Baudet (FvD)",0.89824542832191,0.393227219314176,0
"<anonymized_userid>",3,67887,3682,"Thierry Baudet (FvD)",0.898285124513722,0.393334045507959,0
"<anonymized_userid>",3,67890,3683,"Thierry Baudet (FvD)",0.898324820705534,0.393440871701741,0
"<anonymized_userid>",3,67893,3684,"Thierry Baudet (FvD)",0.898364516897346,0.393547697895524,0
"<anonymized_userid>",3,67896,3685,"Thierry Baudet (FvD)",0.898404213089158,0.393654524089307,0
"<anonymized_userid>",3,67899,3686,"Thierry Baudet (FvD)",0.89844390928097,0.393761350283089,0
"<anonymized_userid>",3,67902,3687,"Thierry Baudet (FvD)",0.898483605472782,0.393868176476872,0
"<anonymized_userid>",3,67905,3688,"Thierry Baudet (FvD)",0.898523301664594,0.393975002670655,0
"<anonymized_userid>",3,67908,3689,"Thierry Baudet (FvD)",0.898562997856406,0.394081828864438,0
"<anonymized_userid>",3,67911,3690,"Thierry Baudet (FvD)",0.898602694048218,0.39418865505822,0
"<anonymized_userid>",3,67914,3691,"Thierry Baudet (FvD)",0.89864239024003,0.394295481252003,0
"<anonymized_userid>",3,67917,3692,"Thierry Baudet (FvD)",0.898682086431842,0.394402307445786,0
"<anonymized_userid>",3,67920,3693,"Thierry Baudet (FvD)",0.898721782623654,0.394509133639568,0
"<anonymized_userid>",3,67923,3694,"Thierry Baudet (FvD)",0.898761478815466,0.394615959833351,0
"<anonymized_userid>",3,67926,3695,"Thierry Baudet (FvD)",0.898801175007278,0.394722786027134,0
"<anonymized_userid>",3,67929,3696,"Thierry Baudet (FvD)",0.89884087119909,0.394829612220917,0
"<anonymized_userid>",3,67932,3697,"Thierry Baudet (FvD)",0.898880567390902,0.394936438414699,0
"<anonymized_userid>",3,67935,3698,"Thierry Baudet (FvD)",0.898920263582714,0.395043264608482,0
"<anonymized_userid>",3,67938,3699,"Thierry Baudet (FvD)",0.898959959774526,0.395150090802265,0
"<anonymized_userid>",3,67941,3700,"Thierry Baudet (FvD)",0.898999655966338,0.395256916996047,0
"<anonymized_userid>",3,67944,3701,"Thierry Baudet (FvD)",0.89903935215815,0.39536374318983,0
"<anonymized_userid>",3,67947,3702,"Thierry Baudet (FvD)",0.899079048349962,0.395470569383613,0
"<anonymized_userid>",3,67950,3703,"Thierry Baudet (FvD)",0.899118744541774,0.395577395577396,0
"<anonymized_userid>",3,67953,3704,"Thierry Baudet (FvD)",0.899158440733586,0.395684221771178,0
"<anonymized_userid>",3,67956,3705,"Thierry Baudet (FvD)",0.899198136925398,0.395791047964961,0
"<anonymized_userid>",3,67959,3706,"Thierry Baudet (FvD)",0.89923783311721,0.395897874158744,0
"<anonymized_userid>",3,67962,3707,"Thierry Baudet (FvD)",0.899277529309022,0.396004700352526,0
"<anonymized_userid>",3,67965,3708,"Thierry Baudet (FvD)",0.899317225500834,0.396111526546309,0
"<anonymized_userid>",3,67968,3709,"Thierry Baudet (FvD)",0.899356921692646,0.396218352740092,0
"<anonymized_userid>",3,67971,3710,"Thierry Baudet (FvD)",0.899396617884458,0.396325178933875,0
"<anonymized_userid>",3,67974,3711,"Thierry Baudet (FvD)",0.89943631407627,0.396432005127657,0
"<anonymized_userid>",3,67977,3712,"Thierry Baudet (FvD)",0.899476010268082,0.39653883132144,0
"<anonymized_userid>",3,67980,3713,"Thierry Baudet (FvD)",0.899515706459894,0.396645657515223,0
"<anonymized_userid>",3,67983,3714,"Thierry Baudet (FvD)",0.899555402651706,0.396752483709005,0
"<anonymized_userid>",3,67986,3715,"Thierry Baudet (FvD)",0.899595098843518,0.396859309902788,0
"<anonymized_userid>",3,67989,3716,"Thierry Baudet (FvD)",0.89963479503533,0.396966136096571,0
"<anonymized_userid>",3,67992,3717,"Thierry Baudet (FvD)",0.899674491227142,0.397072962290354,0
"<anonymized_userid>",3,67995,3718,"Thierry Baudet (FvD)",0.899714187418954,0.397179788484136,0
"<anonymized_userid>",3,67998,3719,"Thierry Baudet (FvD)",0.899753883610766,0.397286614677919,0
"<anonymized_userid>",3,68001,3720,"Thierry Baudet (FvD)",0.899793579802578,0.397393440871702,0
"<anonymized_userid>",3,68004,3721,"Thierry Baudet (FvD)",0.89983327599439,0.397500267065484,0
"<anonymized_userid>",3,68007,3722,"Thierry Baudet (FvD)",0.899872972186202,0.397607093259267,0
"<anonymized_userid>",3,68010,3723,"Thierry Baudet (FvD)",0.899912668378014,0.39771391945305,0
"<anonymized_userid>",3,68013,3724,"Thierry Baudet (FvD)",0.899952364569826,0.397820745646833,0
"<anonymized_userid>",3,68016,3725,"Thierry Baudet (FvD)",0.899992060761638,0.397927571840615,0
"<anonymized_userid>",3,68019,3726,"Thierry Baudet (FvD)",0.90003175695345,0.398034398034398,0
"<anonymized_userid>",3,68022,3727,"Thierry Baudet (FvD)",0.900071453145262,0.398141224228181,0
"<anonymized_userid>",3,68025,3728,"Thierry Baudet (FvD)",0.900111149337074,0.398248050421963,0
"<anonymized_userid>",3,68028,3729,"Thierry Baudet (FvD)",0.900150845528886,0.398354876615746,0
"<anonymized_userid>",3,68031,3730,"Thierry Baudet (FvD)",0.900190541720698,0.398461702809529,0
"<anonymized_userid>",3,68034,3731,"Thierry Baudet (FvD)",0.90023023791251,0.398568529003312,0
"<anonymized_userid>",3,68037,3732,"Thierry Baudet (FvD)",0.900269934104322,0.398675355197094,0
"<anonymized_userid>",3,68040,3733,"Thierry Baudet (FvD)",0.900309630296134,0.398782181390877,0
"<anonymized_userid>",3,68043,3734,"Thierry Baudet (FvD)",0.900349326487946,0.39888900758466,0
"<anonymized_userid>",3,68046,3735,"Thierry Baudet (FvD)",0.900389022679758,0.398995833778442,0
"<anonymized_userid>",3,68049,3736,"Thierry Baudet (FvD)",0.90042871887157,0.399102659972225,0
"<anonymized_userid>",3,68052,3737,"Thierry Baudet (FvD)",0.900468415063382,0.399209486166008,0
"<anonymized_userid>",3,68055,3738,"Thierry Baudet (FvD)",0.900508111255194,0.399316312359791,0
"<anonymized_userid>",3,68058,3739,"Thierry Baudet (FvD)",0.900547807447006,0.399423138553573,0
"<anonymized_userid>",3,68061,3740,"Thierry Baudet (FvD)",0.900587503638818,0.399529964747356,0
"<anonymized_userid>",3,68064,3741,"Thierry Baudet (FvD)",0.90062719983063,0.399636790941139,0
"<anonymized_userid>",3,68067,3742,"Thierry Baudet (FvD)",0.900666896022442,0.399743617134921,0
"<anonymized_userid>",3,68070,3743,"Thierry Baudet (FvD)",0.900706592214254,0.399850443328704,0
"<anonymized_userid>",3,68073,3744,"Thierry Baudet (FvD)",0.900746288406066,0.399957269522487,0
"<anonymized_userid>",3,68076,3745,"Thierry Baudet (FvD)",0.900785984597878,0.40006409571627,0
"<anonymized_userid>",3,68079,3746,"Thierry Baudet (FvD)",0.90082568078969,0.400170921910052,0
"<anonymized_userid>",3,68082,3747,"Thierry Baudet (FvD)",0.900865376981502,0.400277748103835,0
"<anonymized_userid>",3,68085,3748,"Thierry Baudet (FvD)",0.900905073173314,0.400384574297618,0
"<anonymized_userid>",3,68088,3749,"Thierry Baudet (FvD)",0.900944769365126,0.4004914004914,0
"<anonymized_userid>",3,68091,3750,"Thierry Baudet (FvD)",0.900984465556938,0.400598226685183,0
"<anonymized_userid>",3,68094,3751,"Thierry Baudet (FvD)",0.90102416174875,0.400705052878966,0
"<anonymized_userid>",3,68097,3752,"Thierry Baudet (FvD)",0.901063857940562,0.400811879072749,0
"<anonymized_userid>",3,68100,3753,"Thierry Baudet (FvD)",0.901103554132374,0.400918705266531,0
"<anonymized_userid>",3,68103,3754,"Thierry Baudet (FvD)",0.901143250324186,0.401025531460314,0
"<anonymized_userid>",3,68106,3755,"Thierry Baudet (FvD)",0.901182946515998,0.401132357654097,0
"<anonymized_userid>",3,68109,3756,"Thierry Baudet (FvD)",0.90122264270781,0.401239183847879,0
"<anonymized_userid>",3,68112,3757,"Thierry Baudet (FvD)",0.901262338899622,0.401346010041662,0
"<anonymized_userid>",3,68115,3758,"Thierry Baudet (FvD)",0.901302035091434,0.401452836235445,0
"<anonymized_userid>",3,68118,3759,"Thierry Baudet (FvD)",0.901341731283246,0.401559662429228,0
"<anonymized_userid>",3,68121,3760,"Thierry Baudet (FvD)",0.901381427475058,0.40166648862301,0
"<anonymized_userid>",3,68124,3761,"Thierry Baudet (FvD)",0.90142112366687,0.401773314816793,0
"<anonymized_userid>",3,68127,3762,"Thierry Baudet (FvD)",0.901460819858682,0.401880141010576,0
"<anonymized_userid>",3,68130,3763,"Thierry Baudet (FvD)",0.901500516050494,0.401986967204359,0
"<anonymized_userid>",3,68133,3764,"Thierry Baudet (FvD)",0.901540212242306,0.402093793398141,0
"<anonymized_userid>",3,68136,3765,"Thierry Baudet (FvD)",0.901579908434118,0.402200619591924,0
"<anonymized_userid>",3,68139,3766,"Thierry Baudet (FvD)",0.90161960462593,0.402307445785707,0
"<anonymized_userid>",3,68142,3767,"Thierry Baudet (FvD)",0.901659300817742,0.402414271979489,0
"<anonymized_userid>",3,68145,3768,"Thierry Baudet (FvD)",0.901698997009554,0.402521098173272,0
"<anonymized_userid>",3,68148,3769,"Thierry Baudet (FvD)",0.901738693201366,0.402627924367055,0
"<anonymized_userid>",3,68151,3770,"Thierry Baudet (FvD)",0.901778389393178,0.402734750560838,0
"<anonymized_userid>",3,68154,3771,"Thierry Baudet (FvD)",0.90181808558499,0.40284157675462,0
"<anonymized_userid>",3,68157,3772,"Thierry Baudet (FvD)",0.901857781776802,0.402948402948403,0
"<anonymized_userid>",3,68160,3773,"Thierry Baudet (FvD)",0.901897477968614,0.403055229142186,0
"<anonymized_userid>",3,68163,3774,"Thierry Baudet (FvD)",0.901937174160426,0.403162055335968,0
"<anonymized_userid>",3,68166,3775,"Thierry Baudet (FvD)",0.901976870352238,0.403268881529751,0
"<anonymized_userid>",3,68169,3776,"Thierry Baudet (FvD)",0.902016566544049,0.403375707723534,0
"<anonymized_userid>",3,68172,3777,"Thierry Baudet (FvD)",0.902056262735862,0.403482533917317,0
"<anonymized_userid>",3,68175,3778,"Thierry Baudet (FvD)",0.902095958927674,0.403589360111099,0
"<anonymized_userid>",3,68178,3779,"Thierry Baudet (FvD)",0.902135655119486,0.403696186304882,0
"<anonymized_userid>",3,68181,3780,"Thierry Baudet (FvD)",0.902175351311298,0.403803012498665,0
"<anonymized_userid>",3,68184,3781,"Thierry Baudet (FvD)",0.90221504750311,0.403909838692447,0
"<anonymized_userid>",3,68187,3782,"Thierry Baudet (FvD)",0.902254743694922,0.40401666488623,0
"<anonymized_userid>",3,68190,3783,"Thierry Baudet (FvD)",0.902294439886734,0.404123491080013,0
"<anonymized_userid>",3,68193,3784,"Thierry Baudet (FvD)",0.902334136078546,0.404230317273796,0
"<anonymized_userid>",3,68196,3785,"Thierry Baudet (FvD)",0.902373832270358,0.404337143467578,0
"<anonymized_userid>",3,68199,3786,"Thierry Baudet (FvD)",0.902413528462169,0.404443969661361,0
"<anonymized_userid>",3,68202,3787,"Thierry Baudet (FvD)",0.902453224653981,0.404550795855144,0
"<anonymized_userid>",3,68205,3788,"Thierry Baudet (FvD)",0.902492920845794,0.404657622048926,0
"<anonymized_userid>",3,68208,3789,"Thierry Baudet (FvD)",0.902532617037606,0.404764448242709,0
"<anonymized_userid>",3,68211,3790,"Thierry Baudet (FvD)",0.902572313229418,0.404871274436492,0
"<anonymized_userid>",3,68214,3791,"Thierry Baudet (FvD)",0.90261200942123,0.404978100630275,0
"<anonymized_userid>",3,68217,3792,"Thierry Baudet (FvD)",0.902651705613042,0.405084926824057,0
"<anonymized_userid>",3,68220,3793,"Thierry Baudet (FvD)",0.902691401804854,0.40519175301784,0
"<anonymized_userid>",3,68223,3794,"Thierry Baudet (FvD)",0.902731097996666,0.405298579211623,0
"<anonymized_userid>",3,68226,3795,"Thierry Baudet (FvD)",0.902770794188477,0.405405405405405,0
"<anonymized_userid>",3,68229,3796,"Thierry Baudet (FvD)",0.902810490380289,0.405512231599188,0
"<anonymized_userid>",3,68232,3797,"Thierry Baudet (FvD)",0.902850186572101,0.405619057792971,0
"<anonymized_userid>",3,68235,3798,"Thierry Baudet (FvD)",0.902889882763913,0.405725883986754,0
"<anonymized_userid>",3,68238,3799,"Thierry Baudet (FvD)",0.902929578955726,0.405832710180536,0
"<anonymized_userid>",3,68241,3800,"Thierry Baudet (FvD)",0.902969275147538,0.405939536374319,0
"<anonymized_userid>",3,68244,3801,"Thierry Baudet (FvD)",0.90300897133935,0.406046362568102,0
"<anonymized_userid>",3,68247,3802,"Thierry Baudet (FvD)",0.903048667531162,0.406153188761884,0
"<anonymized_userid>",3,68250,3803,"Thierry Baudet (FvD)",0.903088363722974,0.406260014955667,0
"<anonymized_userid>",3,68253,3804,"Thierry Baudet (FvD)",0.903128059914786,0.40636684114945,0
"<anonymized_userid>",3,68256,3805,"Thierry Baudet (FvD)",0.903167756106597,0.406473667343233,0
"<anonymized_userid>",3,68259,3806,"Thierry Baudet (FvD)",0.903207452298409,0.406580493537015,0
"<anonymized_userid>",3,68262,3807,"Thierry Baudet (FvD)",0.903247148490221,0.406687319730798,0
"<anonymized_userid>",3,68265,3808,"Thierry Baudet (FvD)",0.903286844682033,0.406794145924581,0
"<anonymized_userid>",3,68268,3809,"Thierry Baudet (FvD)",0.903326540873845,0.406900972118363,0
"<anonymized_userid>",3,68271,3810,"Thierry Baudet (FvD)",0.903366237065658,0.407007798312146,0
"<anonymized_userid>",3,68274,3811,"Thierry Baudet (FvD)",0.90340593325747,0.407114624505929,0
"<anonymized_userid>",3,68277,3812,"Thierry Baudet (FvD)",0.903445629449282,0.407221450699712,0
"<anonymized_userid>",3,68280,3813,"Thierry Baudet (FvD)",0.903485325641094,0.407328276893494,0
"<anonymized_userid>",3,68283,3814,"Thierry Baudet (FvD)",0.903525021832906,0.407435103087277,0
"<anonymized_userid>",3,68286,3815,"Thierry Baudet (FvD)",0.903564718024717,0.40754192928106,0
"<anonymized_userid>",3,68289,3816,"Thierry Baudet (FvD)",0.903604414216529,0.407648755474842,0
"<anonymized_userid>",3,68292,3817,"Thierry Baudet (FvD)",0.903644110408341,0.407755581668625,0
"<anonymized_userid>",3,68295,3818,"Thierry Baudet (FvD)",0.903683806600153,0.407862407862408,0
"<anonymized_userid>",3,68298,3819,"Thierry Baudet (FvD)",0.903723502791965,0.407969234056191,0
"<anonymized_userid>",3,68301,3820,"Thierry Baudet (FvD)",0.903763198983777,0.408076060249973,0
"<anonymized_userid>",3,68304,3821,"Thierry Baudet (FvD)",0.90380289517559,0.408182886443756,0
"<anonymized_userid>",3,68307,3822,"Thierry Baudet (FvD)",0.903842591367402,0.408289712637539,0
"<anonymized_userid>",3,68310,3823,"Thierry Baudet (FvD)",0.903882287559214,0.408396538831321,0
"<anonymized_userid>",3,68313,3824,"Thierry Baudet (FvD)",0.903921983751026,0.408503365025104,0
"<anonymized_userid>",3,68316,3825,"Thierry Baudet (FvD)",0.903961679942837,0.408610191218887,0
"<anonymized_userid>",3,68319,3826,"Thierry Baudet (FvD)",0.904001376134649,0.40871701741267,0
"<anonymized_userid>",3,68322,3827,"Thierry Baudet (FvD)",0.904041072326461,0.408823843606452,0
"<anonymized_userid>",3,68325,3828,"Thierry Baudet (FvD)",0.904080768518273,0.408930669800235,0
"<anonymized_userid>",3,68328,3829,"Thierry Baudet (FvD)",0.904120464710085,0.409037495994018,0
"<anonymized_userid>",3,68331,3830,"Thierry Baudet (FvD)",0.904160160901897,0.4091443221878,0
"<anonymized_userid>",3,68334,3831,"Thierry Baudet (FvD)",0.904199857093709,0.409251148381583,0
"<anonymized_userid>",3,68337,3832,"Thierry Baudet (FvD)",0.904239553285522,0.409357974575366,0
"<anonymized_userid>",3,68340,3833,"Thierry Baudet (FvD)",0.904279249477334,0.409464800769149,0
"<anonymized_userid>",3,68343,3834,"Thierry Baudet (FvD)",0.904318945669146,0.409571626962931,0
"<anonymized_userid>",3,68346,3835,"Thierry Baudet (FvD)",0.904358641860957,0.409678453156714,0
"<anonymized_userid>",3,68349,3836,"Thierry Baudet (FvD)",0.904398338052769,0.409785279350497,0
"<anonymized_userid>",3,68352,3837,"Thierry Baudet (FvD)",0.904438034244581,0.409892105544279,0
"<anonymized_userid>",3,68355,3838,"Thierry Baudet (FvD)",0.904477730436393,0.409998931738062,0
"<anonymized_userid>",3,68358,3839,"Thierry Baudet (FvD)",0.904517426628205,0.410105757931845,0
"<anonymized_userid>",3,68361,3840,"Thierry Baudet (FvD)",0.904557122820017,0.410212584125628,0
"<anonymized_userid>",3,68364,3841,"Thierry Baudet (FvD)",0.904596819011829,0.41031941031941,0
"<anonymized_userid>",3,68367,3842,"Thierry Baudet (FvD)",0.904636515203641,0.410426236513193,0
"<anonymized_userid>",3,68370,3843,"Thierry Baudet (FvD)",0.904676211395454,0.410533062706976,0
"<anonymized_userid>",3,68373,3844,"Thierry Baudet (FvD)",0.904715907587265,0.410639888900758,0
"<anonymized_userid>",3,68376,3845,"Thierry Baudet (FvD)",0.904755603779077,0.410746715094541,0
"<anonymized_userid>",3,68379,3846,"Thierry Baudet (FvD)",0.904795299970889,0.410853541288324,0
"<anonymized_userid>",3,68382,3847,"Thierry Baudet (FvD)",0.904834996162701,0.410960367482107,0
"<anonymized_userid>",3,68385,3848,"Thierry Baudet (FvD)",0.904874692354513,0.411067193675889,0
"<anonymized_userid>",3,68388,3849,"Thierry Baudet (FvD)",0.904914388546325,0.411174019869672,0
"<anonymized_userid>",3,68391,3850,"Thierry Baudet (FvD)",0.904954084738137,0.411280846063455,0
"<anonymized_userid>",3,68394,3851,"Thierry Baudet (FvD)",0.904993780929949,0.411387672257237,0
"<anonymized_userid>",3,68397,3852,"Thierry Baudet (FvD)",0.905033477121761,0.41149449845102,0
"<anonymized_userid>",3,68400,3853,"Thierry Baudet (FvD)",0.905073173313573,0.411601324644803,0
"<anonymized_userid>",3,68403,3854,"Thierry Baudet (FvD)",0.905112869505385,0.411708150838586,0
"<anonymized_userid>",3,68406,3855,"Thierry Baudet (FvD)",0.905152565697197,0.411814977032368,0
"<anonymized_userid>",3,68409,3856,"Thierry Baudet (FvD)",0.905192261889009,0.411921803226151,0
"<anonymized_userid>",3,68412,3857,"Thierry Baudet (FvD)",0.905231958080821,0.412028629419934,0
"<anonymized_userid>",3,68415,3858,"Thierry Baudet (FvD)",0.905271654272633,0.412135455613717,0
"<anonymized_userid>",3,68418,3859,"Thierry Baudet (FvD)",0.905311350464445,0.412242281807499,0
"<anonymized_userid>",3,68421,3860,"Thierry Baudet (FvD)",0.905351046656257,0.412349108001282,0
"<anonymized_userid>",3,68424,3861,"Thierry Baudet (FvD)",0.905390742848069,0.412455934195065,0
"<anonymized_userid>",3,68427,3862,"Thierry Baudet (FvD)",0.905430439039881,0.412562760388847,0
"<anonymized_userid>",3,68430,3863,"Thierry Baudet (FvD)",0.905470135231693,0.41266958658263,0
"<anonymized_userid>",3,68433,3864,"Thierry Baudet (FvD)",0.905509831423505,0.412776412776413,0
"<anonymized_userid>",3,68436,3865,"Thierry Baudet (FvD)",0.905549527615317,0.412883238970195,0
"<anonymized_userid>",3,68439,3866,"Thierry Baudet (FvD)",0.905589223807129,0.412990065163978,0
"<anonymized_userid>",3,68442,3867,"Thierry Baudet (FvD)",0.905628919998941,0.413096891357761,0
"<anonymized_userid>",3,68445,3868,"Thierry Baudet (FvD)",0.905668616190753,0.413203717551544,0
"<anonymized_userid>",3,68448,3869,"Thierry Baudet (FvD)",0.905708312382565,0.413310543745326,0
"<anonymized_userid>",3,68451,3870,"Thierry Baudet (FvD)",0.905748008574377,0.413417369939109,0
"<anonymized_userid>",3,68454,3871,"Thierry Baudet (FvD)",0.905787704766189,0.413524196132892,0
"<anonymized_userid>",3,68457,3872,"Thierry Baudet (FvD)",0.905827400958001,0.413631022326674,0
"<anonymized_userid>",3,68460,3873,"Thierry Baudet (FvD)",0.905867097149813,0.413737848520457,0
"<anonymized_userid>",3,68463,3874,"Thierry Baudet (FvD)",0.905906793341625,0.41384467471424,0
"<anonymized_userid>",3,68466,3875,"Thierry Baudet (FvD)",0.905946489533437,0.413951500908023,0
"<anonymized_userid>",3,68469,3876,"Thierry Baudet (FvD)",0.905986185725249,0.414058327101805,0
"<anonymized_userid>",3,68472,3877,"Thierry Baudet (FvD)",0.906025881917061,0.414165153295588,0
"<anonymized_userid>",3,68475,3878,"Thierry Baudet (FvD)",0.906065578108873,0.414271979489371,0
"<anonymized_userid>",3,68478,3879,"Thierry Baudet (FvD)",0.906105274300685,0.414378805683153,0
"<anonymized_userid>",3,68481,3880,"Thierry Baudet (FvD)",0.906144970492497,0.414485631876936,0
"<anonymized_userid>",3,68484,3881,"Thierry Baudet (FvD)",0.906184666684309,0.414592458070719,0
"<anonymized_userid>",3,68487,3882,"Thierry Baudet (FvD)",0.906224362876121,0.414699284264502,0
"<anonymized_userid>",3,68490,3883,"Thierry Baudet (FvD)",0.906264059067933,0.414806110458284,0
"<anonymized_userid>",3,68493,3884,"Thierry Baudet (FvD)",0.906303755259745,0.414912936652067,0
"<anonymized_userid>",3,68496,3885,"Thierry Baudet (FvD)",0.906343451451557,0.41501976284585,0
"<anonymized_userid>",3,68499,3886,"Thierry Baudet (FvD)",0.906383147643369,0.415126589039633,0
"<anonymized_userid>",3,68502,3887,"Thierry Baudet (FvD)",0.906422843835181,0.415233415233415,0
"<anonymized_userid>",3,68505,3888,"Thierry Baudet (FvD)",0.906462540026993,0.415340241427198,0
"<anonymized_userid>",3,68508,3889,"Thierry Baudet (FvD)",0.906502236218805,0.415447067620981,0
"<anonymized_userid>",3,68511,3890,"Thierry Baudet (FvD)",0.906541932410617,0.415553893814763,0
"<anonymized_userid>",3,68514,3891,"Thierry Baudet (FvD)",0.906581628602429,0.415660720008546,0
"<anonymized_userid>",3,68517,3892,"Thierry Baudet (FvD)",0.906621324794241,0.415767546202329,0
"<anonymized_userid>",3,68520,3893,"Thierry Baudet (FvD)",0.906661020986053,0.415874372396112,0
"<anonymized_userid>",3,68523,3894,"Thierry Baudet (FvD)",0.906700717177865,0.415981198589894,0
"<anonymized_userid>",3,68526,3895,"Thierry Baudet (FvD)",0.906740413369677,0.416088024783677,0
"<anonymized_userid>",3,68529,3896,"Thierry Baudet (FvD)",0.906780109561489,0.41619485097746,0
"<anonymized_userid>",3,68532,3897,"Thierry Baudet (FvD)",0.906819805753301,0.416301677171242,0
"<anonymized_userid>",3,68535,3898,"Thierry Baudet (FvD)",0.906859501945113,0.416408503365025,0
"<anonymized_userid>",3,68538,3899,"Thierry Baudet (FvD)",0.906899198136925,0.416515329558808,0
"<anonymized_userid>",3,68541,3900,"Thierry Baudet (FvD)",0.906938894328737,0.416622155752591,0
"<anonymized_userid>",3,68544,3901,"Thierry Baudet (FvD)",0.906978590520549,0.416728981946373,0
"<anonymized_userid>",3,68547,3902,"Thierry Baudet (FvD)",0.907018286712361,0.416835808140156,0
"<anonymized_userid>",3,68550,3903,"Thierry Baudet (FvD)",0.907057982904173,0.416942634333939,0
"<anonymized_userid>",3,68553,3904,"Thierry Baudet (FvD)",0.907097679095985,0.417049460527721,0
"<anonymized_userid>",3,68556,3905,"Thierry Baudet (FvD)",0.907137375287797,0.417156286721504,0
"<anonymized_userid>",3,68559,3906,"Thierry Baudet (FvD)",0.907177071479609,0.417263112915287,0
"<anonymized_userid>",3,68562,3907,"Thierry Baudet (FvD)",0.907216767671421,0.41736993910907,0
"<anonymized_userid>",3,68565,3908,"Thierry Baudet (FvD)",0.907256463863233,0.417476765302852,0
"<anonymized_userid>",3,68568,3909,"Thierry Baudet (FvD)",0.907296160055045,0.417583591496635,0
"<anonymized_userid>",3,68571,3910,"Thierry Baudet (FvD)",0.907335856246857,0.417690417690418,0
"<anonymized_userid>",3,68574,3911,"Thierry Baudet (FvD)",0.907375552438669,0.4177972438842,0
"<anonymized_userid>",3,68577,3912,"Thierry Baudet (FvD)",0.907415248630481,0.417904070077983,0
"<anonymized_userid>",3,68580,3913,"Thierry Baudet (FvD)",0.907454944822293,0.418010896271766,0
"<anonymized_userid>",3,68583,3914,"Thierry Baudet (FvD)",0.907494641014105,0.418117722465549,0
"<anonymized_userid>",3,68586,3915,"Thierry Baudet (FvD)",0.907534337205917,0.418224548659331,0
"<anonymized_userid>",3,68589,3916,"Thierry Baudet (FvD)",0.907574033397729,0.418331374853114,0
"<anonymized_userid>",3,68592,3917,"Thierry Baudet (FvD)",0.907613729589541,0.418438201046897,0
"<anonymized_userid>",3,68595,3918,"Thierry Baudet (FvD)",0.907653425781353,0.418545027240679,0
"<anonymized_userid>",3,68598,3919,"Thierry Baudet (FvD)",0.907693121973165,0.418651853434462,0
"<anonymized_userid>",3,68601,3920,"Thierry Baudet (FvD)",0.907732818164977,0.418758679628245,0
"<anonymized_userid>",3,68604,3921,"Thierry Baudet (FvD)",0.907772514356789,0.418865505822028,0
"<anonymized_userid>",3,68607,3922,"Thierry Baudet (FvD)",0.907812210548601,0.41897233201581,0
"<anonymized_userid>",3,68610,3923,"Thierry Baudet (FvD)",0.907851906740413,0.419079158209593,0
"<anonymized_userid>",3,68613,3924,"Thierry Baudet (FvD)",0.907891602932225,0.419185984403376,0
"<anonymized_userid>",3,68616,3925,"Thierry Baudet (FvD)",0.907931299124037,0.419292810597158,0
"<anonymized_userid>",3,68619,3926,"Thierry Baudet (FvD)",0.907970995315849,0.419399636790941,0
"<anonymized_userid>",3,68622,3927,"Thierry Baudet (FvD)",0.908010691507661,0.419506462984724,0
"<anonymized_userid>",3,68625,3928,"Thierry Baudet (FvD)",0.908050387699473,0.419613289178507,0
"<anonymized_userid>",3,68628,3929,"Thierry Baudet (FvD)",0.908090083891285,0.419720115372289,0
"<anonymized_userid>",3,68631,3930,"Thierry Baudet (FvD)",0.908129780083097,0.419826941566072,0
"<anonymized_userid>",3,68634,3931,"Thierry Baudet (FvD)",0.908169476274909,0.419933767759855,0
"<anonymized_userid>",3,68637,3932,"Thierry Baudet (FvD)",0.908209172466721,0.420040593953637,0
"<anonymized_userid>",3,68640,3933,"Thierry Baudet (FvD)",0.908248868658533,0.42014742014742,0
"<anonymized_userid>",3,68643,3934,"Thierry Baudet (FvD)",0.908288564850345,0.420254246341203,0
"<anonymized_userid>",3,68646,3935,"Thierry Baudet (FvD)",0.908328261042157,0.420361072534986,0
"<anonymized_userid>",3,68649,3936,"Thierry Baudet (FvD)",0.908367957233969,0.420467898728768,0
"<anonymized_userid>",3,68652,3937,"Thierry Baudet (FvD)",0.908407653425781,0.420574724922551,0
"<anonymized_userid>",3,68655,3938,"Thierry Baudet (FvD)",0.908447349617593,0.420681551116334,0
"<anonymized_userid>",3,68658,3939,"Thierry Baudet (FvD)",0.908487045809405,0.420788377310116,0
"<anonymized_userid>",3,68661,3940,"Thierry Baudet (FvD)",0.908526742001217,0.420895203503899,0
"<anonymized_userid>",3,68664,3941,"Thierry Baudet (FvD)",0.908566438193029,0.421002029697682,0
"<anonymized_userid>",3,68667,3942,"Thierry Baudet (FvD)",0.908606134384841,0.421108855891465,0
"<anonymized_userid>",3,68670,3943,"Thierry Baudet (FvD)",0.908645830576653,0.421215682085247,0
"<anonymized_userid>",3,68673,3944,"Thierry Baudet (FvD)",0.908685526768465,0.42132250827903,0
"<anonymized_userid>",3,68676,3945,"Thierry Baudet (FvD)",0.908725222960277,0.421429334472813,0
"<anonymized_userid>",3,68679,3946,"Thierry Baudet (FvD)",0.908764919152089,0.421536160666595,0
"<anonymized_userid>",3,68682,3947,"Thierry Baudet (FvD)",0.908804615343901,0.421642986860378,0
"<anonymized_userid>",3,68685,3948,"Thierry Baudet (FvD)",0.908844311535713,0.421749813054161,0
"<anonymized_userid>",3,68688,3949,"Thierry Baudet (FvD)",0.908884007727525,0.421856639247944,0
"<anonymized_userid>",3,68691,3950,"Thierry Baudet (FvD)",0.908923703919337,0.421963465441726,0
"<anonymized_userid>",3,68694,3951,"Thierry Baudet (FvD)",0.908963400111149,0.422070291635509,0
"<anonymized_userid>",3,68697,3952,"Thierry Baudet (FvD)",0.909003096302961,0.422177117829292,0
"<anonymized_userid>",3,68700,3953,"Thierry Baudet (FvD)",0.909042792494773,0.422283944023074,0
"<anonymized_userid>",3,68703,3954,"Thierry Baudet (FvD)",0.909082488686585,0.422390770216857,0
"<anonymized_userid>",3,68706,3955,"Thierry Baudet (FvD)",0.909122184878397,0.42249759641064,0
"<anonymized_userid>",3,68709,3956,"Thierry Baudet (FvD)",0.909161881070209,0.422604422604423,0
"<anonymized_userid>",3,68712,3957,"Thierry Baudet (FvD)",0.909201577262021,0.422711248798205,0
"<anonymized_userid>",3,68715,3958,"Thierry Baudet (FvD)",0.909241273453833,0.422818074991988,0
"<anonymized_userid>",3,68718,3959,"Thierry Baudet (FvD)",0.909280969645645,0.422924901185771,0
"<anonymized_userid>",3,68721,3960,"Thierry Baudet (FvD)",0.909320665837457,0.423031727379553,0
"<anonymized_userid>",3,68724,3961,"Thierry Baudet (FvD)",0.909360362029269,0.423138553573336,0
"<anonymized_userid>",3,68727,3962,"Thierry Baudet (FvD)",0.909400058221081,0.423245379767119,0
"<anonymized_userid>",3,68730,3963,"Thierry Baudet (FvD)",0.909439754412893,0.423352205960902,0
"<anonymized_userid>",3,68733,3964,"Thierry Baudet (FvD)",0.909479450604705,0.423459032154684,0
"<anonymized_userid>",3,68736,3965,"Thierry Baudet (FvD)",0.909519146796517,0.423565858348467,0
"<anonymized_userid>",3,68739,3966,"Thierry Baudet (FvD)",0.909558842988329,0.42367268454225,0
"<anonymized_userid>",3,68742,3967,"Thierry Baudet (FvD)",0.909598539180141,0.423779510736032,0
"<anonymized_userid>",3,68745,3968,"Thierry Baudet (FvD)",0.909638235371953,0.423886336929815,0
"<anonymized_userid>",3,68748,3969,"Thierry Baudet (FvD)",0.909677931563765,0.423993163123598,0
"<anonymized_userid>",3,68751,3970,"Thierry Baudet (FvD)",0.909717627755577,0.424099989317381,0
"<anonymized_userid>",3,68754,3971,"Thierry Baudet (FvD)",0.909757323947389,0.424206815511163,0
"<anonymized_userid>",3,68757,3972,"Thierry Baudet (FvD)",0.909797020139201,0.424313641704946,0
"<anonymized_userid>",3,68760,3973,"Thierry Baudet (FvD)",0.909836716331013,0.424420467898729,0
"<anonymized_userid>",3,68763,3974,"Thierry Baudet (FvD)",0.909876412522825,0.424527294092511,0
"<anonymized_userid>",3,68766,3975,"Thierry Baudet (FvD)",0.909916108714637,0.424634120286294,0
"<anonymized_userid>",3,68769,3976,"Thierry Baudet (FvD)",0.909955804906449,0.424740946480077,0
"<anonymized_userid>",3,68772,3977,"Thierry Baudet (FvD)",0.909995501098261,0.42484777267386,0
"<anonymized_userid>",3,68775,3978,"Thierry Baudet (FvD)",0.910035197290073,0.424954598867642,0
"<anonymized_userid>",3,68778,3979,"Thierry Baudet (FvD)",0.910074893481885,0.425061425061425,0
"<anonymized_userid>",3,68781,3980,"Thierry Baudet (FvD)",0.910114589673697,0.425168251255208,0
"<anonymized_userid>",3,68784,3981,"Thierry Baudet (FvD)",0.910154285865509,0.425275077448991,0
"<anonymized_userid>",3,68787,3982,"Thierry Baudet (FvD)",0.910193982057321,0.425381903642773,0
"<anonymized_userid>",3,68790,3983,"Thierry Baudet (FvD)",0.910233678249133,0.425488729836556,0
"<anonymized_userid>",3,68793,3984,"Thierry Baudet (FvD)",0.910273374440945,0.425595556030339,0
"<anonymized_userid>",3,68796,3985,"Thierry Baudet (FvD)",0.910313070632757,0.425702382224121,0
"<anonymized_userid>",3,68799,3986,"Thierry Baudet (FvD)",0.910352766824569,0.425809208417904,0
"<anonymized_userid>",3,68802,3987,"Thierry Baudet (FvD)",0.910392463016381,0.425916034611687,0
"<anonymized_userid>",3,68805,3988,"Thierry Baudet (FvD)",0.910432159208193,0.42602286080547,0
"<anonymized_userid>",3,68808,3989,"Thierry Baudet (FvD)",0.910471855400005,0.426129686999252,0
"<anonymized_userid>",3,68811,3990,"Thierry Baudet (FvD)",0.910511551591817,0.426236513193035,0
"<anonymized_userid>",3,68814,3991,"Thierry Baudet (FvD)",0.910551247783629,0.426343339386818,0
"<anonymized_userid>",3,68817,3992,"Thierry Baudet (FvD)",0.910590943975441,0.4264501655806,0
"<anonymized_userid>",3,68820,3993,"Thierry Baudet (FvD)",0.910630640167253,0.426556991774383,0
"<anonymized_userid>",3,68823,3994,"Thierry Baudet (FvD)",0.910670336359065,0.426663817968166,0
"<anonymized_userid>",3,68826,3995,"Thierry Baudet (FvD)",0.910710032550877,0.426770644161948,0
"<anonymized_userid>",3,68829,3996,"Thierry Baudet (FvD)",0.910749728742689,0.426877470355731,0
"<anonymized_userid>",3,68832,3997,"Thierry Baudet (FvD)",0.910789424934501,0.426984296549514,0
"<anonymized_userid>",3,68835,3998,"Thierry Baudet (FvD)",0.910829121126313,0.427091122743297,0
"<anonymized_userid>",3,68838,3999,"Thierry Baudet (FvD)",0.910868817318125,0.427197948937079,0
"<anonymized_userid>",3,68841,4000,"Thierry Baudet (FvD)",0.910908513509937,0.427304775130862,0
"<anonymized_userid>",3,68844,4001,"Thierry Baudet (FvD)",0.910948209701749,0.427411601324645,0
"<anonymized_userid>",3,68847,4002,"Thierry Baudet (FvD)",0.910987905893561,0.427518427518428,0
"<anonymized_userid>",3,68850,4003,"Thierry Baudet (FvD)",0.911027602085373,0.42762525371221,0
"<anonymized_userid>",3,68853,4004,"Thierry Baudet (FvD)",0.911067298277185,0.427732079905993,0
"<anonymized_userid>",3,68856,4005,"Thierry Baudet (FvD)",0.911106994468997,0.427838906099776,0
"<anonymized_userid>",3,68859,4006,"Thierry Baudet (FvD)",0.911146690660809,0.427945732293558,0
"<anonymized_userid>",3,68862,4007,"Thierry Baudet (FvD)",0.911186386852621,0.428052558487341,0
"<anonymized_userid>",3,68865,4008,"Thierry Baudet (FvD)",0.911226083044433,0.428159384681124,0
"<anonymized_userid>",3,68868,4009,"Thierry Baudet (FvD)",0.911265779236245,0.428266210874907,0
"<anonymized_userid>",3,68871,4010,"Thierry Baudet (FvD)",0.911305475428057,0.428373037068689,0
"<anonymized_userid>",3,68874,4011,"Thierry Baudet (FvD)",0.911345171619869,0.428479863262472,0
"<anonymized_userid>",3,68877,4012,"Thierry Baudet (FvD)",0.911384867811681,0.428586689456255,0
"<anonymized_userid>",3,68880,4013,"Thierry Baudet (FvD)",0.911424564003493,0.428693515650037,0
"<anonymized_userid>",3,68883,4014,"Thierry Baudet (FvD)",0.911464260195305,0.42880034184382,0
"<anonymized_userid>",3,68886,4015,"Thierry Baudet (FvD)",0.911503956387117,0.428907168037603,0
"<anonymized_userid>",3,68889,4016,"Thierry Baudet (FvD)",0.911543652578929,0.429013994231386,0
"<anonymized_userid>",3,68892,4017,"Thierry Baudet (FvD)",0.911583348770741,0.429120820425168,0
"<anonymized_userid>",3,68895,4018,"Thierry Baudet (FvD)",0.911623044962553,0.429227646618951,0
"<anonymized_userid>",3,68898,4019,"Thierry Baudet (FvD)",0.911662741154365,0.429334472812734,0
"<anonymized_userid>",3,68901,4020,"Thierry Baudet (FvD)",0.911702437346177,0.429441299006516,0
"<anonymized_userid>",3,68904,4021,"Thierry Baudet (FvD)",0.911742133537989,0.429548125200299,0
"<anonymized_userid>",3,68907,4022,"Thierry Baudet (FvD)",0.911781829729801,0.429654951394082,0
"<anonymized_userid>",3,68910,4023,"Thierry Baudet (FvD)",0.911821525921613,0.429761777587865,0
"<anonymized_userid>",3,68913,4024,"Thierry Baudet (FvD)",0.911861222113425,0.429868603781647,0
"<anonymized_userid>",3,68916,4025,"Thierry Baudet (FvD)",0.911900918305237,0.42997542997543,0
"<anonymized_userid>",3,68919,4026,"Thierry Baudet (FvD)",0.911940614497049,0.430082256169213,0
"<anonymized_userid>",3,68922,4027,"Thierry Baudet (FvD)",0.911980310688861,0.430189082362995,0
"<anonymized_userid>",3,68925,4028,"Thierry Baudet (FvD)",0.912020006880673,0.430295908556778,0
"<anonymized_userid>",3,68928,4029,"Thierry Baudet (FvD)",0.912059703072485,0.430402734750561,0
"<anonymized_userid>",3,68931,4030,"Thierry Baudet (FvD)",0.912099399264297,0.430509560944344,0
"<anonymized_userid>",3,68934,4031,"Thierry Baudet (FvD)",0.912139095456109,0.430616387138126,0
"<anonymized_userid>",3,68937,4032,"Thierry Baudet (FvD)",0.912178791647921,0.430723213331909,0
"<anonymized_userid>",3,68940,4033,"Thierry Baudet (FvD)",0.912218487839733,0.430830039525692,0
"<anonymized_userid>",3,68943,4034,"Thierry Baudet (FvD)",0.912258184031545,0.430936865719474,0
"<anonymized_userid>",3,68946,4035,"Thierry Baudet (FvD)",0.912297880223357,0.431043691913257,0
"<anonymized_userid>",3,68949,4036,"Thierry Baudet (FvD)",0.912337576415169,0.43115051810704,0
"<anonymized_userid>",3,68952,4037,"Thierry Baudet (FvD)",0.912377272606981,0.431257344300823,0
"<anonymized_userid>",3,68955,4038,"Thierry Baudet (FvD)",0.912416968798793,0.431364170494605,0
"<anonymized_userid>",3,68958,4039,"Thierry Baudet (FvD)",0.912456664990605,0.431470996688388,0
"<anonymized_userid>",3,68961,4040,"Thierry Baudet (FvD)",0.912496361182417,0.431577822882171,0
"<anonymized_userid>",3,68964,4041,"Thierry Baudet (FvD)",0.912536057374229,0.431684649075953,0
"<anonymized_userid>",3,68967,4042,"Thierry Baudet (FvD)",0.912575753566041,0.431791475269736,0
"<anonymized_userid>",3,68970,4043,"Thierry Baudet (FvD)",0.912615449757853,0.431898301463519,0
"<anonymized_userid>",3,68973,4044,"Thierry Baudet (FvD)",0.912655145949665,0.432005127657302,0
"<anonymized_userid>",3,68976,4045,"Thierry Baudet (FvD)",0.912694842141477,0.432111953851084,0
"<anonymized_userid>",3,68979,4046,"Thierry Baudet (FvD)",0.912734538333289,0.432218780044867,0
"<anonymized_userid>",3,68982,4047,"Thierry Baudet (FvD)",0.912774234525101,0.43232560623865,0
"<anonymized_userid>",3,68985,4048,"Thierry Baudet (FvD)",0.912813930716913,0.432432432432432,0
"<anonymized_userid>",2,68987,4049,"Thierry Baudet (FvD)",0.912840394844788,0.432539258626215,0
"<anonymized_userid>",2,68989,4050,"Thierry Baudet (FvD)",0.912866858972663,0.432646084819998,0
"<anonymized_userid>",2,68991,4051,"Thierry Baudet (FvD)",0.912893323100537,0.432752911013781,0
"<anonymized_userid>",2,68993,4052,"Thierry Baudet (FvD)",0.912919787228412,0.432859737207563,0
"<anonymized_userid>",2,68995,4053,"Thierry Baudet (FvD)",0.912946251356287,0.432966563401346,0
"<anonymized_userid>",2,68997,4054,"Thierry Baudet (FvD)",0.912972715484161,0.433073389595129,0
"<anonymized_userid>",2,68999,4055,"Thierry Baudet (FvD)",0.912999179612036,0.433180215788911,0
"<anonymized_userid>",2,69001,4056,"Thierry Baudet (FvD)",0.913025643739911,0.433287041982694,0
"<anonymized_userid>",2,69003,4057,"Thierry Baudet (FvD)",0.913052107867785,0.433393868176477,0
"<anonymized_userid>",2,69005,4058,"Thierry Baudet (FvD)",0.91307857199566,0.43350069437026,0
"<anonymized_userid>",2,69007,4059,"Thierry Baudet (FvD)",0.913105036123535,0.433607520564042,0
"<anonymized_userid>",2,69009,4060,"Thierry Baudet (FvD)",0.913131500251409,0.433714346757825,0
"<anonymized_userid>",2,69011,4061,"Thierry Baudet (FvD)",0.913157964379284,0.433821172951608,0
"<anonymized_userid>",2,69013,4062,"Thierry Baudet (FvD)",0.913184428507159,0.43392799914539,0
"<anonymized_userid>",2,69015,4063,"Thierry Baudet (FvD)",0.913210892635033,0.434034825339173,0
"<anonymized_userid>",2,69017,4064,"Thierry Baudet (FvD)",0.913237356762908,0.434141651532956,0
"<anonymized_userid>",2,69019,4065,"Thierry Baudet (FvD)",0.913263820890783,0.434248477726739,0
"<anonymized_userid>",2,69021,4066,"Thierry Baudet (FvD)",0.913290285018657,0.434355303920521,0
"<anonymized_userid>",2,69023,4067,"Thierry Baudet (FvD)",0.913316749146532,0.434462130114304,0
"<anonymized_userid>",2,69025,4068,"Thierry Baudet (FvD)",0.913343213274407,0.434568956308087,0
"<anonymized_userid>",2,69027,4069,"Thierry Baudet (FvD)",0.913369677402281,0.434675782501869,0
"<anonymized_userid>",2,69029,4070,"Thierry Baudet (FvD)",0.913396141530156,0.434782608695652,0
"<anonymized_userid>",2,69031,4071,"Thierry Baudet (FvD)",0.913422605658031,0.434889434889435,0
"<anonymized_userid>",2,69033,4072,"Thierry Baudet (FvD)",0.913449069785905,0.434996261083218,0
"<anonymized_userid>",2,69035,4073,"Thierry Baudet (FvD)",0.91347553391378,0.435103087277,0
"<anonymized_userid>",2,69037,4074,"Thierry Baudet (FvD)",0.913501998041655,0.435209913470783,0
"<anonymized_userid>",2,69039,4075,"Thierry Baudet (FvD)",0.913528462169529,0.435316739664566,0
"<anonymized_userid>",2,69041,4076,"Thierry Baudet (FvD)",0.913554926297404,0.435423565858348,0
"<anonymized_userid>",2,69043,4077,"Thierry Baudet (FvD)",0.913581390425279,0.435530392052131,0
"<anonymized_userid>",2,69045,4078,"Thierry Baudet (FvD)",0.913607854553153,0.435637218245914,0
"<anonymized_userid>",2,69047,4079,"Thierry Baudet (FvD)",0.913634318681028,0.435744044439697,0
"<anonymized_userid>",2,69049,4080,"Thierry Baudet (FvD)",0.913660782808903,0.435850870633479,0
"<anonymized_userid>",2,69051,4081,"Thierry Baudet (FvD)",0.913687246936777,0.435957696827262,0
"<anonymized_userid>",2,69053,4082,"Thierry Baudet (FvD)",0.913713711064652,0.436064523021045,0
"<anonymized_userid>",2,69055,4083,"Thierry Baudet (FvD)",0.913740175192526,0.436171349214827,0
"<anonymized_userid>",2,69057,4084,"Thierry Baudet (FvD)",0.913766639320401,0.43627817540861,0
"<anonymized_userid>",2,69059,4085,"Thierry Baudet (FvD)",0.913793103448276,0.436385001602393,0
"<anonymized_userid>",2,69061,4086,"Thierry Baudet (FvD)",0.913819567576151,0.436491827796176,0
"<anonymized_userid>",2,69063,4087,"Thierry Baudet (FvD)",0.913846031704025,0.436598653989958,0
"<anonymized_userid>",2,69065,4088,"Thierry Baudet (FvD)",0.9138724958319,0.436705480183741,0
"<anonymized_userid>",2,69067,4089,"Thierry Baudet (FvD)",0.913898959959775,0.436812306377524,0
"<anonymized_userid>",2,69069,4090,"Thierry Baudet (FvD)",0.913925424087649,0.436919132571306,0
"<anonymized_userid>",2,69071,4091,"Thierry Baudet (FvD)",0.913951888215524,0.437025958765089,0
"<anonymized_userid>",2,69073,4092,"Thierry Baudet (FvD)",0.913978352343399,0.437132784958872,0
"<anonymized_userid>",2,69075,4093,"Thierry Baudet (FvD)",0.914004816471273,0.437239611152655,0
"<anonymized_userid>",2,69077,4094,"Thierry Baudet (FvD)",0.914031280599148,0.437346437346437,0
"<anonymized_userid>",2,69079,4095,"Thierry Baudet (FvD)",0.914057744727023,0.43745326354022,0
"<anonymized_userid>",2,69081,4096,"Thierry Baudet (FvD)",0.914084208854897,0.437560089734003,0
"<anonymized_userid>",2,69083,4097,"Thierry Baudet (FvD)",0.914110672982772,0.437666915927786,0
"<anonymized_userid>",2,69085,4098,"Thierry Baudet (FvD)",0.914137137110646,0.437773742121568,0
"<anonymized_userid>",2,69087,4099,"Thierry Baudet (FvD)",0.914163601238521,0.437880568315351,0
"<anonymized_userid>",2,69089,4100,"Thierry Baudet (FvD)",0.914190065366396,0.437987394509134,0
"<anonymized_userid>",2,69091,4101,"Thierry Baudet (FvD)",0.914216529494271,0.438094220702916,0
"<anonymized_userid>",2,69093,4102,"Thierry Baudet (FvD)",0.914242993622145,0.438201046896699,0
"<anonymized_userid>",2,69095,4103,"Thierry Baudet (FvD)",0.91426945775002,0.438307873090482,0
"<anonymized_userid>",2,69097,4104,"Thierry Baudet (FvD)",0.914295921877895,0.438414699284265,0
"<anonymized_userid>",2,69099,4105,"Thierry Baudet (FvD)",0.914322386005769,0.438521525478047,0
"<anonymized_userid>",2,69101,4106,"Thierry Baudet (FvD)",0.914348850133644,0.43862835167183,0
"<anonymized_userid>",2,69103,4107,"Thierry Baudet (FvD)",0.914375314261519,0.438735177865613,0
"<anonymized_userid>",2,69105,4108,"Thierry Baudet (FvD)",0.914401778389393,0.438842004059395,0
"<anonymized_userid>",2,69107,4109,"Thierry Baudet (FvD)",0.914428242517268,0.438948830253178,0
"<anonymized_userid>",2,69109,4110,"Thierry Baudet (FvD)",0.914454706645143,0.439055656446961,0
"<anonymized_userid>",2,69111,4111,"Thierry Baudet (FvD)",0.914481170773017,0.439162482640744,0
"<anonymized_userid>",2,69113,4112,"Thierry Baudet (FvD)",0.914507634900892,0.439269308834526,0
"<anonymized_userid>",2,69115,4113,"Thierry Baudet (FvD)",0.914534099028766,0.439376135028309,0
"<anonymized_userid>",2,69117,4114,"Thierry Baudet (FvD)",0.914560563156641,0.439482961222092,0
"<anonymized_userid>",2,69119,4115,"Thierry Baudet (FvD)",0.914587027284516,0.439589787415874,0
"<anonymized_userid>",2,69121,4116,"Thierry Baudet (FvD)",0.91461349141239,0.439696613609657,0
"<anonymized_userid>",2,69123,4117,"Thierry Baudet (FvD)",0.914639955540265,0.43980343980344,0
"<anonymized_userid>",2,69125,4118,"Thierry Baudet (FvD)",0.91466641966814,0.439910265997222,0
"<anonymized_userid>",2,69127,4119,"Thierry Baudet (FvD)",0.914692883796015,0.440017092191005,0
"<anonymized_userid>",2,69129,4120,"Thierry Baudet (FvD)",0.914719347923889,0.440123918384788,0
"<anonymized_userid>",2,69131,4121,"Thierry Baudet (FvD)",0.914745812051764,0.440230744578571,0
"<anonymized_userid>",2,69133,4122,"Thierry Baudet (FvD)",0.914772276179639,0.440337570772353,0
"<anonymized_userid>",2,69135,4123,"Thierry Baudet (FvD)",0.914798740307513,0.440444396966136,0
"<anonymized_userid>",2,69137,4124,"Thierry Baudet (FvD)",0.914825204435388,0.440551223159919,0
"<anonymized_userid>",2,69139,4125,"Thierry Baudet (FvD)",0.914851668563262,0.440658049353702,0
"<anonymized_userid>",2,69141,4126,"Thierry Baudet (FvD)",0.914878132691137,0.440764875547484,0
"<anonymized_userid>",2,69143,4127,"Thierry Baudet (FvD)",0.914904596819012,0.440871701741267,0
"<anonymized_userid>",2,69145,4128,"Thierry Baudet (FvD)",0.914931060946886,0.44097852793505,0
"<anonymized_userid>",2,69147,4129,"Thierry Baudet (FvD)",0.914957525074761,0.441085354128832,0
"<anonymized_userid>",2,69149,4130,"Thierry Baudet (FvD)",0.914983989202636,0.441192180322615,0
"<anonymized_userid>",2,69151,4131,"Thierry Baudet (FvD)",0.91501045333051,0.441299006516398,0
"<anonymized_userid>",2,69153,4132,"Thierry Baudet (FvD)",0.915036917458385,0.441405832710181,0
"<anonymized_userid>",2,69155,4133,"Thierry Baudet (FvD)",0.91506338158626,0.441512658903963,0
"<anonymized_userid>",2,69157,4134,"Thierry Baudet (FvD)",0.915089845714135,0.441619485097746,0
"<anonymized_userid>",2,69159,4135,"Thierry Baudet (FvD)",0.915116309842009,0.441726311291529,0
"<anonymized_userid>",2,69161,4136,"Thierry Baudet (FvD)",0.915142773969884,0.441833137485311,0
"<anonymized_userid>",2,69163,4137,"Thierry Baudet (FvD)",0.915169238097759,0.441939963679094,0
"<anonymized_userid>",2,69165,4138,"Thierry Baudet (FvD)",0.915195702225633,0.442046789872877,0
"<anonymized_userid>",2,69167,4139,"Thierry Baudet (FvD)",0.915222166353508,0.44215361606666,0
"<anonymized_userid>",2,69169,4140,"Thierry Baudet (FvD)",0.915248630481382,0.442260442260442,0
"<anonymized_userid>",2,69171,4141,"Thierry Baudet (FvD)",0.915275094609257,0.442367268454225,0
"<anonymized_userid>",2,69173,4142,"Thierry Baudet (FvD)",0.915301558737132,0.442474094648008,0
"<anonymized_userid>",2,69175,4143,"Thierry Baudet (FvD)",0.915328022865006,0.44258092084179,0
"<anonymized_userid>",2,69177,4144,"Thierry Baudet (FvD)",0.915354486992881,0.442687747035573,0
"<anonymized_userid>",2,69179,4145,"Thierry Baudet (FvD)",0.915380951120756,0.442794573229356,0
"<anonymized_userid>",2,69181,4146,"Thierry Baudet (FvD)",0.91540741524863,0.442901399423139,0
"<anonymized_userid>",2,69183,4147,"Thierry Baudet (FvD)",0.915433879376505,0.443008225616921,0
"<anonymized_userid>",2,69185,4148,"Thierry Baudet (FvD)",0.91546034350438,0.443115051810704,0
"<anonymized_userid>",2,69187,4149,"Thierry Baudet (FvD)",0.915486807632254,0.443221878004487,0
"<anonymized_userid>",2,69189,4150,"Thierry Baudet (FvD)",0.915513271760129,0.443328704198269,0
"<anonymized_userid>",2,69191,4151,"Thierry Baudet (FvD)",0.915539735888004,0.443435530392052,0
"<anonymized_userid>",2,69193,4152,"Thierry Baudet (FvD)",0.915566200015879,0.443542356585835,0
"<anonymized_userid>",2,69195,4153,"Thierry Baudet (FvD)",0.915592664143753,0.443649182779618,0
"<anonymized_userid>",2,69197,4154,"Thierry Baudet (FvD)",0.915619128271628,0.4437560089734,0
"<anonymized_userid>",2,69199,4155,"Thierry Baudet (FvD)",0.915645592399502,0.443862835167183,0
"<anonymized_userid>",2,69201,4156,"Thierry Baudet (FvD)",0.915672056527377,0.443969661360966,0
"<anonymized_userid>",2,69203,4157,"Thierry Baudet (FvD)",0.915698520655252,0.444076487554748,0
"<anonymized_userid>",2,69205,4158,"Thierry Baudet (FvD)",0.915724984783126,0.444183313748531,0
"<anonymized_userid>",2,69207,4159,"Thierry Baudet (FvD)",0.915751448911001,0.444290139942314,0
"<anonymized_userid>",2,69209,4160,"Thierry Baudet (FvD)",0.915777913038876,0.444396966136097,0
"<anonymized_userid>",2,69211,4161,"Thierry Baudet (FvD)",0.91580437716675,0.444503792329879,0
"<anonymized_userid>",2,69213,4162,"Thierry Baudet (FvD)",0.915830841294625,0.444610618523662,0
"<anonymized_userid>",2,69215,4163,"Thierry Baudet (FvD)",0.9158573054225,0.444717444717445,0
"<anonymized_userid>",2,69217,4164,"Thierry Baudet (FvD)",0.915883769550374,0.444824270911227,0
"<anonymized_userid>",2,69219,4165,"Thierry Baudet (FvD)",0.915910233678249,0.44493109710501,0
"<anonymized_userid>",2,69221,4166,"Thierry Baudet (FvD)",0.915936697806124,0.445037923298793,0
"<anonymized_userid>",2,69223,4167,"Thierry Baudet (FvD)",0.915963161933999,0.445144749492576,0
"<anonymized_userid>",2,69225,4168,"Thierry Baudet (FvD)",0.915989626061873,0.445251575686358,0
"<anonymized_userid>",2,69227,4169,"Thierry Baudet (FvD)",0.916016090189748,0.445358401880141,0
"<anonymized_userid>",2,69229,4170,"Thierry Baudet (FvD)",0.916042554317622,0.445465228073924,0
"<anonymized_userid>",2,69231,4171,"Thierry Baudet (FvD)",0.916069018445497,0.445572054267706,0
"<anonymized_userid>",2,69233,4172,"Thierry Baudet (FvD)",0.916095482573372,0.445678880461489,0
"<anonymized_userid>",2,69235,4173,"Thierry Baudet (FvD)",0.916121946701246,0.445785706655272,0
"<anonymized_userid>",2,69237,4174,"Thierry Baudet (FvD)",0.916148410829121,0.445892532849055,0
"<anonymized_userid>",2,69239,4175,"Thierry Baudet (FvD)",0.916174874956996,0.445999359042837,0
"<anonymized_userid>",2,69241,4176,"Thierry Baudet (FvD)",0.91620133908487,0.44610618523662,0
"<anonymized_userid>",2,69243,4177,"Thierry Baudet (FvD)",0.916227803212745,0.446213011430403,0
"<anonymized_userid>",2,69245,4178,"Thierry Baudet (FvD)",0.91625426734062,0.446319837624185,0
"<anonymized_userid>",2,69247,4179,"Thierry Baudet (FvD)",0.916280731468494,0.446426663817968,0
"<anonymized_userid>",2,69249,4180,"Thierry Baudet (FvD)",0.916307195596369,0.446533490011751,0
"<anonymized_userid>",2,69251,4181,"Thierry Baudet (FvD)",0.916333659724244,0.446640316205534,0
"<anonymized_userid>",2,69253,4182,"Thierry Baudet (FvD)",0.916360123852118,0.446747142399316,0
"<anonymized_userid>",2,69255,4183,"Thierry Baudet (FvD)",0.916386587979993,0.446853968593099,0
"<anonymized_userid>",2,69257,4184,"Thierry Baudet (FvD)",0.916413052107868,0.446960794786882,0
"<anonymized_userid>",2,69259,4185,"Thierry Baudet (FvD)",0.916439516235742,0.447067620980664,0
"<anonymized_userid>",2,69261,4186,"Thierry Baudet (FvD)",0.916465980363617,0.447174447174447,0
"<anonymized_userid>",2,69263,4187,"Thierry Baudet (FvD)",0.916492444491492,0.44728127336823,0
"<anonymized_userid>",2,69265,4188,"Thierry Baudet (FvD)",0.916518908619366,0.447388099562013,0
"<anonymized_userid>",2,69267,4189,"Thierry Baudet (FvD)",0.916545372747241,0.447494925755795,0
"<anonymized_userid>",2,69269,4190,"Thierry Baudet (FvD)",0.916571836875116,0.447601751949578,0
"<anonymized_userid>",2,69271,4191,"Thierry Baudet (FvD)",0.91659830100299,0.447708578143361,0
"<anonymized_userid>",2,69273,4192,"Thierry Baudet (FvD)",0.916624765130865,0.447815404337143,0
"<anonymized_userid>",2,69275,4193,"Thierry Baudet (FvD)",0.91665122925874,0.447922230530926,0
"<anonymized_userid>",2,69277,4194,"Thierry Baudet (FvD)",0.916677693386614,0.448029056724709,0
"<anonymized_userid>",2,69279,4195,"Thierry Baudet (FvD)",0.916704157514489,0.448135882918492,0
"<anonymized_userid>",2,69281,4196,"Thierry Baudet (FvD)",0.916730621642364,0.448242709112274,0
"<anonymized_userid>",2,69283,4197,"Thierry Baudet (FvD)",0.916757085770238,0.448349535306057,0
"<anonymized_userid>",2,69285,4198,"Thierry Baudet (FvD)",0.916783549898113,0.44845636149984,0
"<anonymized_userid>",2,69287,4199,"Thierry Baudet (FvD)",0.916810014025988,0.448563187693622,0
"<anonymized_userid>",2,69289,4200,"Thierry Baudet (FvD)",0.916836478153862,0.448670013887405,0
"<anonymized_userid>",2,69291,4201,"Thierry Baudet (FvD)",0.916862942281737,0.448776840081188,0
"<anonymized_userid>",2,69293,4202,"Thierry Baudet (FvD)",0.916889406409612,0.448883666274971,0
"<anonymized_userid>",2,69295,4203,"Thierry Baudet (FvD)",0.916915870537486,0.448990492468753,0
"<anonymized_userid>",2,69297,4204,"Thierry Baudet (FvD)",0.916942334665361,0.449097318662536,0
"<anonymized_userid>",2,69299,4205,"Thierry Baudet (FvD)",0.916968798793236,0.449204144856319,0
"<anonymized_userid>",2,69301,4206,"Thierry Baudet (FvD)",0.91699526292111,0.449310971050101,0
"<anonymized_userid>",2,69303,4207,"Thierry Baudet (FvD)",0.917021727048985,0.449417797243884,0
"<anonymized_userid>",2,69305,4208,"Thierry Baudet (FvD)",0.91704819117686,0.449524623437667,0
"<anonymized_userid>",2,69307,4209,"Thierry Baudet (FvD)",0.917074655304734,0.44963144963145,0
"<anonymized_userid>",2,69309,4210,"Thierry Baudet (FvD)",0.917101119432609,0.449738275825232,0
"<anonymized_userid>",2,69311,4211,"Thierry Baudet (FvD)",0.917127583560484,0.449845102019015,0
"<anonymized_userid>",2,69313,4212,"Thierry Baudet (FvD)",0.917154047688358,0.449951928212798,0
"<anonymized_userid>",2,69315,4213,"Thierry Baudet (FvD)",0.917180511816233,0.45005875440658,0
"<anonymized_userid>",2,69317,4214,"Thierry Baudet (FvD)",0.917206975944108,0.450165580600363,0
"<anonymized_userid>",2,69319,4215,"Thierry Baudet (FvD)",0.917233440071982,0.450272406794146,0
"<anonymized_userid>",2,69321,4216,"Thierry Baudet (FvD)",0.917259904199857,0.450379232987929,0
"<anonymized_userid>",2,69323,4217,"Thierry Baudet (FvD)",0.917286368327732,0.450486059181711,0
"<anonymized_userid>",2,69325,4218,"Thierry Baudet (FvD)",0.917312832455606,0.450592885375494,0
"<anonymized_userid>",2,69327,4219,"Thierry Baudet (FvD)",0.917339296583481,0.450699711569277,0
"<anonymized_userid>",2,69329,4220,"Thierry Baudet (FvD)",0.917365760711356,0.45080653776306,0
"<anonymized_userid>",2,69331,4221,"Thierry Baudet (FvD)",0.91739222483923,0.450913363956842,0
"<anonymized_userid>",2,69333,4222,"Thierry Baudet (FvD)",0.917418688967105,0.451020190150625,0
"<anonymized_userid>",2,69335,4223,"Thierry Baudet (FvD)",0.91744515309498,0.451127016344408,0
"<anonymized_userid>",2,69337,4224,"Thierry Baudet (FvD)",0.917471617222854,0.45123384253819,0
"<anonymized_userid>",2,69339,4225,"Thierry Baudet (FvD)",0.917498081350729,0.451340668731973,0
"<anonymized_userid>",2,69341,4226,"Thierry Baudet (FvD)",0.917524545478604,0.451447494925756,0
"<anonymized_userid>",2,69343,4227,"Thierry Baudet (FvD)",0.917551009606478,0.451554321119539,0
"<anonymized_userid>",2,69345,4228,"Thierry Baudet (FvD)",0.917577473734353,0.451661147313321,0
"<anonymized_userid>",2,69347,4229,"Thierry Baudet (FvD)",0.917603937862228,0.451767973507104,0
"<anonymized_userid>",2,69349,4230,"Thierry Baudet (FvD)",0.917630401990102,0.451874799700887,0
"<anonymized_userid>",2,69351,4231,"Thierry Baudet (FvD)",0.917656866117977,0.451981625894669,0
"<anonymized_userid>",2,69353,4232,"Thierry Baudet (FvD)",0.917683330245852,0.452088452088452,0
"<anonymized_userid>",2,69355,4233,"Thierry Baudet (FvD)",0.917709794373726,0.452195278282235,0
"<anonymized_userid>",2,69357,4234,"Thierry Baudet (FvD)",0.917736258501601,0.452302104476018,0
"<anonymized_userid>",2,69359,4235,"Thierry Baudet (FvD)",0.917762722629476,0.4524089306698,0
"<anonymized_userid>",2,69361,4236,"Thierry Baudet (FvD)",0.91778918675735,0.452515756863583,0
"<anonymized_userid>",2,69363,4237,"Thierry Baudet (FvD)",0.917815650885225,0.452622583057366,0
"<anonymized_userid>",2,69365,4238,"Thierry Baudet (FvD)",0.9178421150131,0.452729409251148,0
"<anonymized_userid>",2,69367,4239,"Thierry Baudet (FvD)",0.917868579140974,0.452836235444931,0
"<anonymized_userid>",2,69369,4240,"Thierry Baudet (FvD)",0.917895043268849,0.452943061638714,0
"<anonymized_userid>",2,69371,4241,"Thierry Baudet (FvD)",0.917921507396724,0.453049887832497,0
"<anonymized_userid>",2,69373,4242,"Thierry Baudet (FvD)",0.917947971524598,0.453156714026279,0
"<anonymized_userid>",2,69375,4243,"Thierry Baudet (FvD)",0.917974435652473,0.453263540220062,0
"<anonymized_userid>",2,69377,4244,"Thierry Baudet (FvD)",0.918000899780348,0.453370366413845,0
"<anonymized_userid>",2,69379,4245,"Thierry Baudet (FvD)",0.918027363908222,0.453477192607627,0
"<anonymized_userid>",2,69381,4246,"Thierry Baudet (FvD)",0.918053828036097,0.45358401880141,0
"<anonymized_userid>",2,69383,4247,"Thierry Baudet (FvD)",0.918080292163972,0.453690844995193,0
"<anonymized_userid>",2,69385,4248,"Thierry Baudet (FvD)",0.918106756291846,0.453797671188976,0
"<anonymized_userid>",2,69387,4249,"Thierry Baudet (FvD)",0.918133220419721,0.453904497382758,0
"<anonymized_userid>",2,69389,4250,"Thierry Baudet (FvD)",0.918159684547596,0.454011323576541,0
"<anonymized_userid>",2,69391,4251,"Thierry Baudet (FvD)",0.91818614867547,0.454118149770324,0
"<anonymized_userid>",2,69393,4252,"Thierry Baudet (FvD)",0.918212612803345,0.454224975964106,0
"<anonymized_userid>",2,69395,4253,"Thierry Baudet (FvD)",0.91823907693122,0.454331802157889,0
"<anonymized_userid>",2,69397,4254,"Thierry Baudet (FvD)",0.918265541059094,0.454438628351672,0
"<anonymized_userid>",2,69399,4255,"Thierry Baudet (FvD)",0.918292005186969,0.454545454545455,0
"<anonymized_userid>",2,69401,4256,"Thierry Baudet (FvD)",0.918318469314844,0.454652280739237,0
"<anonymized_userid>",2,69403,4257,"Thierry Baudet (FvD)",0.918344933442718,0.45475910693302,0
"<anonymized_userid>",2,69405,4258,"Thierry Baudet (FvD)",0.918371397570593,0.454865933126803,0
"<anonymized_userid>",2,69407,4259,"Thierry Baudet (FvD)",0.918397861698468,0.454972759320585,0
"<anonymized_userid>",2,69409,4260,"Thierry Baudet (FvD)",0.918424325826342,0.455079585514368,0
"<anonymized_userid>",2,69411,4261,"Thierry Baudet (FvD)",0.918450789954217,0.455186411708151,0
"<anonymized_userid>",2,69413,4262,"Thierry Baudet (FvD)",0.918477254082092,0.455293237901934,0
"<anonymized_userid>",2,69415,4263,"Thierry Baudet (FvD)",0.918503718209966,0.455400064095716,0
"<anonymized_userid>",2,69417,4264,"Thierry Baudet (FvD)",0.918530182337841,0.455506890289499,0
"<anonymized_userid>",2,69419,4265,"Thierry Baudet (FvD)",0.918556646465716,0.455613716483282,0
"<anonymized_userid>",2,69421,4266,"Thierry Baudet (FvD)",0.91858311059359,0.455720542677064,0
"<anonymized_userid>",2,69423,4267,"Thierry Baudet (FvD)",0.918609574721465,0.455827368870847,0
"<anonymized_userid>",2,69425,4268,"Thierry Baudet (FvD)",0.91863603884934,0.45593419506463,0
"<anonymized_userid>",2,69427,4269,"Thierry Baudet (FvD)",0.918662502977214,0.456041021258413,0
"<anonymized_userid>",2,69429,4270,"Thierry Baudet (FvD)",0.918688967105089,0.456147847452195,0
"<anonymized_userid>",2,69431,4271,"Thierry Baudet (FvD)",0.918715431232964,0.456254673645978,0
"<anonymized_userid>",2,69433,4272,"Thierry Baudet (FvD)",0.918741895360838,0.456361499839761,0
"<anonymized_userid>",2,69435,4273,"Thierry Baudet (FvD)",0.918768359488713,0.456468326033543,0
"<anonymized_userid>",2,69437,4274,"Thierry Baudet (FvD)",0.918794823616588,0.456575152227326,0
"<anonymized_userid>",2,69439,4275,"Thierry Baudet (FvD)",0.918821287744462,0.456681978421109,0
"<anonymized_userid>",2,69441,4276,"Thierry Baudet (FvD)",0.918847751872337,0.456788804614892,0
"<anonymized_userid>",2,69443,4277,"Thierry Baudet (FvD)",0.918874216000212,0.456895630808674,0
"<anonymized_userid>",2,69445,4278,"Thierry Baudet (FvD)",0.918900680128086,0.457002457002457,0
"<anonymized_userid>",2,69447,4279,"Thierry Baudet (FvD)",0.918927144255961,0.45710928319624,0
"<anonymized_userid>",2,69449,4280,"Thierry Baudet (FvD)",0.918953608383836,0.457216109390022,0
"<anonymized_userid>",2,69451,4281,"Thierry Baudet (FvD)",0.91898007251171,0.457322935583805,0
"<anonymized_userid>",2,69453,4282,"Thierry Baudet (FvD)",0.919006536639585,0.457429761777588,0
"<anonymized_userid>",2,69455,4283,"Thierry Baudet (FvD)",0.91903300076746,0.457536587971371,0
"<anonymized_userid>",2,69457,4284,"Thierry Baudet (FvD)",0.919059464895334,0.457643414165153,0
"<anonymized_userid>",2,69459,4285,"Thierry Baudet (FvD)",0.919085929023209,0.457750240358936,0
"<anonymized_userid>",2,69461,4286,"Thierry Baudet (FvD)",0.919112393151084,0.457857066552719,0
"<anonymized_userid>",2,69463,4287,"Thierry Baudet (FvD)",0.919138857278958,0.457963892746501,0
"<anonymized_userid>",2,69465,4288,"Thierry Baudet (FvD)",0.919165321406833,0.458070718940284,0
"<anonymized_userid>",2,69467,4289,"Thierry Baudet (FvD)",0.919191785534708,0.458177545134067,0
"<anonymized_userid>",2,69469,4290,"Thierry Baudet (FvD)",0.919218249662582,0.45828437132785,0
"<anonymized_userid>",2,69471,4291,"Thierry Baudet (FvD)",0.919244713790457,0.458391197521632,0
"<anonymized_userid>",2,69473,4292,"Thierry Baudet (FvD)",0.919271177918332,0.458498023715415,0
"<anonymized_userid>",2,69475,4293,"Thierry Baudet (FvD)",0.919297642046206,0.458604849909198,0
"<anonymized_userid>",2,69477,4294,"Thierry Baudet (FvD)",0.919324106174081,0.45871167610298,0
"<anonymized_userid>",2,69479,4295,"Thierry Baudet (FvD)",0.919350570301956,0.458818502296763,0
"<anonymized_userid>",2,69481,4296,"Thierry Baudet (FvD)",0.91937703442983,0.458925328490546,0
"<anonymized_userid>",2,69483,4297,"Thierry Baudet (FvD)",0.919403498557705,0.459032154684329,0
"<anonymized_userid>",2,69485,4298,"Thierry Baudet (FvD)",0.91942996268558,0.459138980878111,0
"<anonymized_userid>",2,69487,4299,"Thierry Baudet (FvD)",0.919456426813454,0.459245807071894,0
"<anonymized_userid>",2,69489,4300,"Thierry Baudet (FvD)",0.919482890941329,0.459352633265677,0
"<anonymized_userid>",2,69491,4301,"Thierry Baudet (FvD)",0.919509355069204,0.459459459459459,0
"<anonymized_userid>",2,69493,4302,"Thierry Baudet (FvD)",0.919535819197078,0.459566285653242,0
"<anonymized_userid>",2,69495,4303,"Thierry Baudet (FvD)",0.919562283324953,0.459673111847025,0
"<anonymized_userid>",2,69497,4304,"Thierry Baudet (FvD)",0.919588747452828,0.459779938040808,0
"<anonymized_userid>",2,69499,4305,"Thierry Baudet (FvD)",0.919615211580702,0.45988676423459,0
"<anonymized_userid>",2,69501,4306,"Thierry Baudet (FvD)",0.919641675708577,0.459993590428373,0
"<anonymized_userid>",2,69503,4307,"Thierry Baudet (FvD)",0.919668139836452,0.460100416622156,0
"<anonymized_userid>",2,69505,4308,"Thierry Baudet (FvD)",0.919694603964326,0.460207242815938,0
"<anonymized_userid>",2,69507,4309,"Thierry Baudet (FvD)",0.919721068092201,0.460314069009721,0
"<anonymized_userid>",2,69509,4310,"Thierry Baudet (FvD)",0.919747532220076,0.460420895203504,0
"<anonymized_userid>",2,69511,4311,"Thierry Baudet (FvD)",0.91977399634795,0.460527721397287,0
"<anonymized_userid>",2,69513,4312,"Thierry Baudet (FvD)",0.919800460475825,0.460634547591069,0
"<anonymized_userid>",2,69515,4313,"Thierry Baudet (FvD)",0.9198269246037,0.460741373784852,0
"<anonymized_userid>",2,69517,4314,"Thierry Baudet (FvD)",0.919853388731574,0.460848199978635,0
"<anonymized_userid>",2,69519,4315,"Thierry Baudet (FvD)",0.919879852859449,0.460955026172417,0
"<anonymized_userid>",2,69521,4316,"Thierry Baudet (FvD)",0.919906316987324,0.4610618523662,0
"<anonymized_userid>",2,69523,4317,"Thierry Baudet (FvD)",0.919932781115198,0.461168678559983,0
"<anonymized_userid>",2,69525,4318,"Thierry Baudet (FvD)",0.919959245243073,0.461275504753766,0
"<anonymized_userid>",2,69527,4319,"Thierry Baudet (FvD)",0.919985709370948,0.461382330947548,0
"<anonymized_userid>",2,69529,4320,"Thierry Baudet (FvD)",0.920012173498822,0.461489157141331,0
"<anonymized_userid>",2,69531,4321,"Thierry Baudet (FvD)",0.920038637626697,0.461595983335114,0
"<anonymized_userid>",2,69533,4322,"Thierry Baudet (FvD)",0.920065101754572,0.461702809528896,0
"<anonymized_userid>",2,69535,4323,"Thierry Baudet (FvD)",0.920091565882446,0.461809635722679,0
"<anonymized_userid>",2,69537,4324,"Thierry Baudet (FvD)",0.920118030010321,0.461916461916462,0
"<anonymized_userid>",2,69539,4325,"Thierry Baudet (FvD)",0.920144494138196,0.462023288110245,0
"<anonymized_userid>",2,69541,4326,"Thierry Baudet (FvD)",0.92017095826607,0.462130114304027,0
"<anonymized_userid>",2,69543,4327,"Thierry Baudet (FvD)",0.920197422393945,0.46223694049781,0
"<anonymized_userid>",2,69545,4328,"Thierry Baudet (FvD)",0.92022388652182,0.462343766691593,0
"<anonymized_userid>",2,69547,4329,"Thierry Baudet (FvD)",0.920250350649694,0.462450592885375,0
"<anonymized_userid>",2,69549,4330,"Thierry Baudet (FvD)",0.920276814777569,0.462557419079158,0
"<anonymized_userid>",2,69551,4331,"Thierry Baudet (FvD)",0.920303278905444,0.462664245272941,0
"<anonymized_userid>",2,69553,4332,"Thierry Baudet (FvD)",0.920329743033318,0.462771071466724,0
"<anonymized_userid>",2,69555,4333,"Thierry Baudet (FvD)",0.920356207161193,0.462877897660506,0
"<anonymized_userid>",2,69557,4334,"Thierry Baudet (FvD)",0.920382671289068,0.462984723854289,0
"<anonymized_userid>",2,69559,4335,"Thierry Baudet (FvD)",0.920409135416942,0.463091550048072,0
"<anonymized_userid>",2,69561,4336,"Thierry Baudet (FvD)",0.920435599544817,0.463198376241855,0
"<anonymized_userid>",2,69563,4337,"Thierry Baudet (FvD)",0.920462063672692,0.463305202435637,0
"<anonymized_userid>",2,69565,4338,"Thierry Baudet (FvD)",0.920488527800566,0.46341202862942,0
"<anonymized_userid>",2,69567,4339,"Thierry Baudet (FvD)",0.920514991928441,0.463518854823203,0
"<anonymized_userid>",2,69569,4340,"Thierry Baudet (FvD)",0.920541456056316,0.463625681016985,0
"<anonymized_userid>",2,69571,4341,"Thierry Baudet (FvD)",0.92056792018419,0.463732507210768,0
"<anonymized_userid>",2,69573,4342,"Thierry Baudet (FvD)",0.920594384312065,0.463839333404551,0
"<anonymized_userid>",2,69575,4343,"Thierry Baudet (FvD)",0.92062084843994,0.463946159598334,0
"<anonymized_userid>",2,69577,4344,"Thierry Baudet (FvD)",0.920647312567814,0.464052985792116,0
"<anonymized_userid>",2,69579,4345,"Thierry Baudet (FvD)",0.920673776695689,0.464159811985899,0
"<anonymized_userid>",2,69581,4346,"Thierry Baudet (FvD)",0.920700240823564,0.464266638179682,0
"<anonymized_userid>",2,69583,4347,"Thierry Baudet (FvD)",0.920726704951438,0.464373464373464,0
"<anonymized_userid>",2,69585,4348,"Thierry Baudet (FvD)",0.920753169079313,0.464480290567247,0
"<anonymized_userid>",2,69587,4349,"Thierry Baudet (FvD)",0.920779633207188,0.46458711676103,0
"<anonymized_userid>",2,69589,4350,"Thierry Baudet (FvD)",0.920806097335062,0.464693942954813,0
"<anonymized_userid>",2,69591,4351,"Thierry Baudet (FvD)",0.920832561462937,0.464800769148595,0
"<anonymized_userid>",2,69593,4352,"Thierry Baudet (FvD)",0.920859025590812,0.464907595342378,0
"<anonymized_userid>",2,69595,4353,"Thierry Baudet (FvD)",0.920885489718686,0.465014421536161,0
"<anonymized_userid>",2,69597,4354,"Thierry Baudet (FvD)",0.920911953846561,0.465121247729943,0
"<anonymized_userid>",2,69599,4355,"Thierry Baudet (FvD)",0.920938417974436,0.465228073923726,0
"<anonymized_userid>",2,69601,4356,"Thierry Baudet (FvD)",0.92096488210231,0.465334900117509,0
"<anonymized_userid>",2,69603,4357,"Thierry Baudet (FvD)",0.920991346230185,0.465441726311292,0
"<anonymized_userid>",2,69605,4358,"Thierry Baudet (FvD)",0.92101781035806,0.465548552505074,0
"<anonymized_userid>",2,69607,4359,"Thierry Baudet (FvD)",0.921044274485934,0.465655378698857,0
"<anonymized_userid>",2,69609,4360,"Thierry Baudet (FvD)",0.921070738613809,0.46576220489264,0
"<anonymized_userid>",2,69611,4361,"Thierry Baudet (FvD)",0.921097202741684,0.465869031086422,0
"<anonymized_userid>",2,69613,4362,"Thierry Baudet (FvD)",0.921123666869558,0.465975857280205,0
"<anonymized_userid>",2,69615,4363,"Thierry Baudet (FvD)",0.921150130997433,0.466082683473988,0
"<anonymized_userid>",2,69617,4364,"Thierry Baudet (FvD)",0.921176595125308,0.466189509667771,0
"<anonymized_userid>",2,69619,4365,"Thierry Baudet (FvD)",0.921203059253182,0.466296335861553,0
"<anonymized_userid>",2,69621,4366,"Thierry Baudet (FvD)",0.921229523381057,0.466403162055336,0
"<anonymized_userid>",2,69623,4367,"Thierry Baudet (FvD)",0.921255987508932,0.466509988249119,0
"<anonymized_userid>",2,69625,4368,"Thierry Baudet (FvD)",0.921282451636806,0.466616814442901,0
"<anonymized_userid>",2,69627,4369,"Thierry Baudet (FvD)",0.921308915764681,0.466723640636684,0
"<anonymized_userid>",2,69629,4370,"Thierry Baudet (FvD)",0.921335379892556,0.466830466830467,0
"<anonymized_userid>",2,69631,4371,"Thierry Baudet (FvD)",0.92136184402043,0.46693729302425,0
"<anonymized_userid>",2,69633,4372,"Thierry Baudet (FvD)",0.921388308148305,0.467044119218032,0
"<anonymized_userid>",2,69635,4373,"Thierry Baudet (FvD)",0.92141477227618,0.467150945411815,0
"<anonymized_userid>",2,69637,4374,"Thierry Baudet (FvD)",0.921441236404054,0.467257771605598,0
"<anonymized_userid>",2,69639,4375,"Thierry Baudet (FvD)",0.921467700531929,0.46736459779938,0
"<anonymized_userid>",2,69641,4376,"Thierry Baudet (FvD)",0.921494164659804,0.467471423993163,0
"<anonymized_userid>",2,69643,4377,"Thierry Baudet (FvD)",0.921520628787678,0.467578250186946,0
"<anonymized_userid>",2,69645,4378,"Thierry Baudet (FvD)",0.921547092915553,0.467685076380729,0
"<anonymized_userid>",2,69647,4379,"Thierry Baudet (FvD)",0.921573557043428,0.467791902574511,0
"<anonymized_userid>",2,69649,4380,"Thierry Baudet (FvD)",0.921600021171302,0.467898728768294,0
"<anonymized_userid>",2,69651,4381,"Thierry Baudet (FvD)",0.921626485299177,0.468005554962077,0
"<anonymized_userid>",2,69653,4382,"Thierry Baudet (FvD)",0.921652949427052,0.468112381155859,0
"<anonymized_userid>",2,69655,4383,"Thierry Baudet (FvD)",0.921679413554926,0.468219207349642,0
"<anonymized_userid>",2,69657,4384,"Thierry Baudet (FvD)",0.921705877682801,0.468326033543425,0
"<anonymized_userid>",2,69659,4385,"Thierry Baudet (FvD)",0.921732341810676,0.468432859737208,0
"<anonymized_userid>",2,69661,4386,"Thierry Baudet (FvD)",0.92175880593855,0.46853968593099,0
"<anonymized_userid>",2,69663,4387,"Thierry Baudet (FvD)",0.921785270066425,0.468646512124773,0
"<anonymized_userid>",2,69665,4388,"Thierry Baudet (FvD)",0.9218117341943,0.468753338318556,0
"<anonymized_userid>",2,69667,4389,"Thierry Baudet (FvD)",0.921838198322174,0.468860164512338,0
"<anonymized_userid>",2,69669,4390,"Thierry Baudet (FvD)",0.921864662450049,0.468966990706121,0
"<anonymized_userid>",2,69671,4391,"Thierry Baudet (FvD)",0.921891126577924,0.469073816899904,0
"<anonymized_userid>",2,69673,4392,"Thierry Baudet (FvD)",0.921917590705798,0.469180643093687,0
"<anonymized_userid>",2,69675,4393,"Thierry Baudet (FvD)",0.921944054833673,0.469287469287469,0
"<anonymized_userid>",2,69677,4394,"Thierry Baudet (FvD)",0.921970518961548,0.469394295481252,0
"<anonymized_userid>",2,69679,4395,"Thierry Baudet (FvD)",0.921996983089422,0.469501121675035,0
"<anonymized_userid>",2,69681,4396,"Thierry Baudet (FvD)",0.922023447217297,0.469607947868817,0
"<anonymized_userid>",2,69683,4397,"Thierry Baudet (FvD)",0.922049911345172,0.4697147740626,0
"<anonymized_userid>",2,69685,4398,"Thierry Baudet (FvD)",0.922076375473046,0.469821600256383,0
"<anonymized_userid>",2,69687,4399,"Thierry Baudet (FvD)",0.922102839600921,0.469928426450166,0
"<anonymized_userid>",2,69689,4400,"Thierry Baudet (FvD)",0.922129303728796,0.470035252643948,0
"<anonymized_userid>",2,69691,4401,"Thierry Baudet (FvD)",0.92215576785667,0.470142078837731,0
"<anonymized_userid>",2,69693,4402,"Thierry Baudet (FvD)",0.922182231984545,0.470248905031514,0
"<anonymized_userid>",2,69695,4403,"Thierry Baudet (FvD)",0.92220869611242,0.470355731225296,0
"<anonymized_userid>",2,69697,4404,"Thierry Baudet (FvD)",0.922235160240294,0.470462557419079,0
"<anonymized_userid>",2,69699,4405,"Thierry Baudet (FvD)",0.922261624368169,0.470569383612862,0
"<anonymized_userid>",2,69701,4406,"Thierry Baudet (FvD)",0.922288088496044,0.470676209806645,0
"<anonymized_userid>",2,69703,4407,"Thierry Baudet (FvD)",0.922314552623918,0.470783036000427,0
"<anonymized_userid>",2,69705,4408,"Thierry Baudet (FvD)",0.922341016751793,0.47088986219421,0
"<anonymized_userid>",2,69707,4409,"Thierry Baudet (FvD)",0.922367480879668,0.470996688387993,0
"<anonymized_userid>",2,69709,4410,"Thierry Baudet (FvD)",0.922393945007542,0.471103514581775,0
"<anonymized_userid>",2,69711,4411,"Thierry Baudet (FvD)",0.922420409135417,0.471210340775558,0
"<anonymized_userid>",2,69713,4412,"Thierry Baudet (FvD)",0.922446873263292,0.471317166969341,0
"<anonymized_userid>",2,69715,4413,"Thierry Baudet (FvD)",0.922473337391166,0.471423993163124,0
"<anonymized_userid>",2,69717,4414,"Thierry Baudet (FvD)",0.922499801519041,0.471530819356906,0
"<anonymized_userid>",2,69719,4415,"Thierry Baudet (FvD)",0.922526265646916,0.471637645550689,0
"<anonymized_userid>",2,69721,4416,"Thierry Baudet (FvD)",0.92255272977479,0.471744471744472,0
"<anonymized_userid>",2,69723,4417,"Thierry Baudet (FvD)",0.922579193902665,0.471851297938254,0
"<anonymized_userid>",2,69725,4418,"Thierry Baudet (FvD)",0.92260565803054,0.471958124132037,0
"<anonymized_userid>",2,69727,4419,"Thierry Baudet (FvD)",0.922632122158414,0.47206495032582,0
"<anonymized_userid>",2,69729,4420,"Thierry Baudet (FvD)",0.922658586286289,0.472171776519603,0
"<anonymized_userid>",2,69731,4421,"Thierry Baudet (FvD)",0.922685050414164,0.472278602713385,0
"<anonymized_userid>",2,69733,4422,"Thierry Baudet (FvD)",0.922711514542038,0.472385428907168,0
"<anonymized_userid>",2,69735,4423,"Thierry Baudet (FvD)",0.922737978669913,0.472492255100951,0
"<anonymized_userid>",2,69737,4424,"Thierry Baudet (FvD)",0.922764442797788,0.472599081294733,0
"<anonymized_userid>",2,69739,4425,"Thierry Baudet (FvD)",0.922790906925662,0.472705907488516,0
"<anonymized_userid>",2,69741,4426,"Thierry Baudet (FvD)",0.922817371053537,0.472812733682299,0
"<anonymized_userid>",2,69743,4427,"Thierry Baudet (FvD)",0.922843835181412,0.472919559876082,0
"<anonymized_userid>",2,69745,4428,"Thierry Baudet (FvD)",0.922870299309286,0.473026386069864,0
"<anonymized_userid>",2,69747,4429,"Thierry Baudet (FvD)",0.922896763437161,0.473133212263647,0
"<anonymized_userid>",2,69749,4430,"Thierry Baudet (FvD)",0.922923227565036,0.47324003845743,0
"<anonymized_userid>",2,69751,4431,"Thierry Baudet (FvD)",0.92294969169291,0.473346864651212,0
"<anonymized_userid>",2,69753,4432,"Thierry Baudet (FvD)",0.922976155820785,0.473453690844995,0
"<anonymized_userid>",2,69755,4433,"Thierry Baudet (FvD)",0.92300261994866,0.473560517038778,0
"<anonymized_userid>",2,69757,4434,"Thierry Baudet (FvD)",0.923029084076534,0.473667343232561,0
"<anonymized_userid>",2,69759,4435,"Thierry Baudet (FvD)",0.923055548204409,0.473774169426343,0
"<anonymized_userid>",2,69761,4436,"Thierry Baudet (FvD)",0.923082012332284,0.473880995620126,0
"<anonymized_userid>",2,69763,4437,"Thierry Baudet (FvD)",0.923108476460158,0.473987821813909,0
"<anonymized_userid>",2,69765,4438,"Thierry Baudet (FvD)",0.923134940588033,0.474094648007691,0
"<anonymized_userid>",2,69767,4439,"Thierry Baudet (FvD)",0.923161404715908,0.474201474201474,0
"<anonymized_userid>",2,69769,4440,"Thierry Baudet (FvD)",0.923187868843782,0.474308300395257,0
"<anonymized_userid>",2,69771,4441,"Thierry Baudet (FvD)",0.923214332971657,0.47441512658904,0
"<anonymized_userid>",2,69773,4442,"Thierry Baudet (FvD)",0.923240797099532,0.474521952782822,0
"<anonymized_userid>",2,69775,4443,"Thierry Baudet (FvD)",0.923267261227406,0.474628778976605,0
"<anonymized_userid>",2,69777,4444,"Thierry Baudet (FvD)",0.923293725355281,0.474735605170388,0
"<anonymized_userid>",2,69779,4445,"Thierry Baudet (FvD)",0.923320189483156,0.47484243136417,0
"<anonymized_userid>",2,69781,4446,"Thierry Baudet (FvD)",0.92334665361103,0.474949257557953,0
"<anonymized_userid>",2,69783,4447,"Thierry Baudet (FvD)",0.923373117738905,0.475056083751736,0
"<anonymized_userid>",2,69785,4448,"Thierry Baudet (FvD)",0.92339958186678,0.475162909945519,0
"<anonymized_userid>",2,69787,4449,"Thierry Baudet (FvD)",0.923426045994654,0.475269736139301,0
"<anonymized_userid>",2,69789,4450,"Thierry Baudet (FvD)",0.923452510122529,0.475376562333084,0
"<anonymized_userid>",2,69791,4451,"Thierry Baudet (FvD)",0.923478974250404,0.475483388526867,0
"<anonymized_userid>",2,69793,4452,"Thierry Baudet (FvD)",0.923505438378278,0.475590214720649,0
"<anonymized_userid>",2,69795,4453,"Thierry Baudet (FvD)",0.923531902506153,0.475697040914432,0
"<anonymized_userid>",2,69797,4454,"Thierry Baudet (FvD)",0.923558366634028,0.475803867108215,0
"<anonymized_userid>",2,69799,4455,"Thierry Baudet (FvD)",0.923584830761902,0.475910693301998,0
"<anonymized_userid>",2,69801,4456,"Thierry Baudet (FvD)",0.923611294889777,0.47601751949578,0
"<anonymized_userid>",2,69803,4457,"Thierry Baudet (FvD)",0.923637759017652,0.476124345689563,0
"<anonymized_userid>",2,69805,4458,"Thierry Baudet (FvD)",0.923664223145526,0.476231171883346,0
"<anonymized_userid>",2,69807,4459,"Thierry Baudet (FvD)",0.923690687273401,0.476337998077129,0
"<anonymized_userid>",2,69809,4460,"Thierry Baudet (FvD)",0.923717151401276,0.476444824270911,0
"<anonymized_userid>",2,69811,4461,"Thierry Baudet (FvD)",0.92374361552915,0.476551650464694,0
"<anonymized_userid>",2,69813,4462,"Thierry Baudet (FvD)",0.923770079657025,0.476658476658477,0
"<anonymized_userid>",2,69815,4463,"Thierry Baudet (FvD)",0.9237965437849,0.476765302852259,0
"<anonymized_userid>",2,69817,4464,"Thierry Baudet (FvD)",0.923823007912774,0.476872129046042,0
"<anonymized_userid>",2,69819,4465,"Thierry Baudet (FvD)",0.923849472040649,0.476978955239825,0
"<anonymized_userid>",2,69821,4466,"Thierry Baudet (FvD)",0.923875936168524,0.477085781433608,0
"<anonymized_userid>",2,69823,4467,"Thierry Baudet (FvD)",0.923902400296398,0.47719260762739,0
"<anonymized_userid>",2,69825,4468,"Thierry Baudet (FvD)",0.923928864424273,0.477299433821173,0
"<anonymized_userid>",2,69827,4469,"Thierry Baudet (FvD)",0.923955328552148,0.477406260014956,0
"<anonymized_userid>",2,69829,4470,"Thierry Baudet (FvD)",0.923981792680022,0.477513086208738,0
"<anonymized_userid>",2,69831,4471,"Thierry Baudet (FvD)",0.924008256807897,0.477619912402521,0
"<anonymized_userid>",2,69833,4472,"Thierry Baudet (FvD)",0.924034720935772,0.477726738596304,0
"<anonymized_userid>",2,69835,4473,"Thierry Baudet (FvD)",0.924061185063646,0.477833564790087,0
"<anonymized_userid>",2,69837,4474,"Thierry Baudet (FvD)",0.924087649191521,0.477940390983869,0
"<anonymized_userid>",2,69839,4475,"Thierry Baudet (FvD)",0.924114113319396,0.478047217177652,0
"<anonymized_userid>",2,69841,4476,"Thierry Baudet (FvD)",0.92414057744727,0.478154043371435,0
"<anonymized_userid>",2,69843,4477,"Thierry Baudet (FvD)",0.924167041575145,0.478260869565217,0
"<anonymized_userid>",2,69845,4478,"Thierry Baudet (FvD)",0.92419350570302,0.478367695759,0
"<anonymized_userid>",2,69847,4479,"Thierry Baudet (FvD)",0.924219969830894,0.478474521952783,0
"<anonymized_userid>",2,69849,4480,"Thierry Baudet (FvD)",0.924246433958769,0.478581348146566,0
"<anonymized_userid>",2,69851,4481,"Thierry Baudet (FvD)",0.924272898086644,0.478688174340348,0
"<anonymized_userid>",2,69853,4482,"Thierry Baudet (FvD)",0.924299362214518,0.478795000534131,0
"<anonymized_userid>",2,69855,4483,"Thierry Baudet (FvD)",0.924325826342393,0.478901826727914,0
"<anonymized_userid>",2,69857,4484,"Thierry Baudet (FvD)",0.924352290470268,0.479008652921696,0
"<anonymized_userid>",2,69859,4485,"Thierry Baudet (FvD)",0.924378754598142,0.479115479115479,0
"<anonymized_userid>",2,69861,4486,"Thierry Baudet (FvD)",0.924405218726017,0.479222305309262,0
"<anonymized_userid>",2,69863,4487,"Thierry Baudet (FvD)",0.924431682853892,0.479329131503045,0
"<anonymized_userid>",2,69865,4488,"Thierry Baudet (FvD)",0.924458146981766,0.479435957696827,0
"<anonymized_userid>",2,69867,4489,"Thierry Baudet (FvD)",0.924484611109641,0.47954278389061,0
"<anonymized_userid>",2,69869,4490,"Thierry Baudet (FvD)",0.924511075237516,0.479649610084393,0
"<anonymized_userid>",2,69871,4491,"Thierry Baudet (FvD)",0.92453753936539,0.479756436278175,0
"<anonymized_userid>",2,69873,4492,"Thierry Baudet (FvD)",0.924564003493265,0.479863262471958,0
"<anonymized_userid>",2,69875,4493,"Thierry Baudet (FvD)",0.92459046762114,0.479970088665741,0
"<anonymized_userid>",2,69877,4494,"Thierry Baudet (FvD)",0.924616931749014,0.480076914859524,0
"<anonymized_userid>",2,69879,4495,"Thierry Baudet (FvD)",0.924643395876889,0.480183741053306,0
"<anonymized_userid>",2,69881,4496,"Thierry Baudet (FvD)",0.924669860004764,0.480290567247089,0
"<anonymized_userid>",2,69883,4497,"Thierry Baudet (FvD)",0.924696324132638,0.480397393440872,0
"<anonymized_userid>",2,69885,4498,"Thierry Baudet (FvD)",0.924722788260513,0.480504219634654,0
"<anonymized_userid>",2,69887,4499,"Thierry Baudet (FvD)",0.924749252388388,0.480611045828437,0
"<anonymized_userid>",2,69889,4500,"Thierry Baudet (FvD)",0.924775716516262,0.48071787202222,0
"<anonymized_userid>",2,69891,4501,"Thierry Baudet (FvD)",0.924802180644137,0.480824698216003,0
"<anonymized_userid>",2,69893,4502,"Thierry Baudet (FvD)",0.924828644772012,0.480931524409785,0
"<anonymized_userid>",2,69895,4503,"Thierry Baudet (FvD)",0.924855108899886,0.481038350603568,0
"<anonymized_userid>",2,69897,4504,"Thierry Baudet (FvD)",0.924881573027761,0.481145176797351,0
"<anonymized_userid>",2,69899,4505,"Thierry Baudet (FvD)",0.924908037155636,0.481252002991133,0
"<anonymized_userid>",2,69901,4506,"Thierry Baudet (FvD)",0.92493450128351,0.481358829184916,0
"<anonymized_userid>",2,69903,4507,"Thierry Baudet (FvD)",0.924960965411385,0.481465655378699,0
"<anonymized_userid>",2,69905,4508,"Thierry Baudet (FvD)",0.924987429539259,0.481572481572482,0
"<anonymized_userid>",2,69907,4509,"Thierry Baudet (FvD)",0.925013893667134,0.481679307766264,0
"<anonymized_userid>",2,69909,4510,"Thierry Baudet (FvD)",0.925040357795009,0.481786133960047,0
"<anonymized_userid>",2,69911,4511,"Thierry Baudet (FvD)",0.925066821922884,0.48189296015383,0
"<anonymized_userid>",2,69913,4512,"Thierry Baudet (FvD)",0.925093286050758,0.481999786347612,0
"<anonymized_userid>",2,69915,4513,"Thierry Baudet (FvD)",0.925119750178633,0.482106612541395,0
"<anonymized_userid>",2,69917,4514,"Thierry Baudet (FvD)",0.925146214306508,0.482213438735178,0
"<anonymized_userid>",2,69919,4515,"Thierry Baudet (FvD)",0.925172678434382,0.482320264928961,0
"<anonymized_userid>",2,69921,4516,"Thierry Baudet (FvD)",0.925199142562257,0.482427091122743,0
"<anonymized_userid>",2,69923,4517,"Thierry Baudet (FvD)",0.925225606690132,0.482533917316526,0
"<anonymized_userid>",2,69925,4518,"Thierry Baudet (FvD)",0.925252070818006,0.482640743510309,0
"<anonymized_userid>",2,69927,4519,"Thierry Baudet (FvD)",0.925278534945881,0.482747569704091,0
"<anonymized_userid>",2,69929,4520,"Thierry Baudet (FvD)",0.925304999073756,0.482854395897874,0
"<anonymized_userid>",2,69931,4521,"Thierry Baudet (FvD)",0.92533146320163,0.482961222091657,0
"<anonymized_userid>",2,69933,4522,"Thierry Baudet (FvD)",0.925357927329505,0.48306804828544,0
"<anonymized_userid>",2,69935,4523,"Thierry Baudet (FvD)",0.925384391457379,0.483174874479222,0
"<anonymized_userid>",2,69937,4524,"Thierry Baudet (FvD)",0.925410855585254,0.483281700673005,0
"<anonymized_userid>",2,69939,4525,"Thierry Baudet (FvD)",0.925437319713129,0.483388526866788,0
"<anonymized_userid>",2,69941,4526,"Thierry Baudet (FvD)",0.925463783841003,0.48349535306057,0
"<anonymized_userid>",2,69943,4527,"Thierry Baudet (FvD)",0.925490247968878,0.483602179254353,0
"<anonymized_userid>",2,69945,4528,"Thierry Baudet (FvD)",0.925516712096753,0.483709005448136,0
"<anonymized_userid>",2,69947,4529,"Thierry Baudet (FvD)",0.925543176224628,0.483815831641919,0
"<anonymized_userid>",2,69949,4530,"Thierry Baudet (FvD)",0.925569640352502,0.483922657835701,0
"<anonymized_userid>",2,69951,4531,"Thierry Baudet (FvD)",0.925596104480377,0.484029484029484,0
"<anonymized_userid>",2,69953,4532,"Thierry Baudet (FvD)",0.925622568608252,0.484136310223267,0
"<anonymized_userid>",2,69955,4533,"Thierry Baudet (FvD)",0.925649032736126,0.484243136417049,0
"<anonymized_userid>",2,69957,4534,"Thierry Baudet (FvD)",0.925675496864001,0.484349962610832,0
"<anonymized_userid>",2,69959,4535,"Thierry Baudet (FvD)",0.925701960991876,0.484456788804615,0
"<anonymized_userid>",2,69961,4536,"Thierry Baudet (FvD)",0.92572842511975,0.484563614998398,0
"<anonymized_userid>",2,69963,4537,"Thierry Baudet (FvD)",0.925754889247625,0.48467044119218,0
"<anonymized_userid>",2,69965,4538,"Thierry Baudet (FvD)",0.925781353375499,0.484777267385963,0
"<anonymized_userid>",2,69967,4539,"Thierry Baudet (FvD)",0.925807817503374,0.484884093579746,0
"<anonymized_userid>",2,69969,4540,"Thierry Baudet (FvD)",0.925834281631249,0.484990919773528,0
"<anonymized_userid>",2,69971,4541,"Thierry Baudet (FvD)",0.925860745759123,0.485097745967311,0
"<anonymized_userid>",2,69973,4542,"Thierry Baudet (FvD)",0.925887209886998,0.485204572161094,0
"<anonymized_userid>",2,69975,4543,"Thierry Baudet (FvD)",0.925913674014873,0.485311398354877,0
"<anonymized_userid>",2,69977,4544,"Thierry Baudet (FvD)",0.925940138142748,0.485418224548659,0
"<anonymized_userid>",2,69979,4545,"Thierry Baudet (FvD)",0.925966602270622,0.485525050742442,0
"<anonymized_userid>",2,69981,4546,"Thierry Baudet (FvD)",0.925993066398497,0.485631876936225,0
"<anonymized_userid>",2,69983,4547,"Thierry Baudet (FvD)",0.926019530526372,0.485738703130007,0
"<anonymized_userid>",2,69985,4548,"Thierry Baudet (FvD)",0.926045994654246,0.48584552932379,0
"<anonymized_userid>",2,69987,4549,"Thierry Baudet (FvD)",0.926072458782121,0.485952355517573,0
"<anonymized_userid>",2,69989,4550,"Thierry Baudet (FvD)",0.926098922909996,0.486059181711356,0
"<anonymized_userid>",2,69991,4551,"Thierry Baudet (FvD)",0.92612538703787,0.486166007905138,0
"<anonymized_userid>",2,69993,4552,"Thierry Baudet (FvD)",0.926151851165745,0.486272834098921,0
"<anonymized_userid>",2,69995,4553,"Thierry Baudet (FvD)",0.926178315293619,0.486379660292704,0
"<anonymized_userid>",2,69997,4554,"Thierry Baudet (FvD)",0.926204779421494,0.486486486486487,0
"<anonymized_userid>",2,69999,4555,"Thierry Baudet (FvD)",0.926231243549369,0.486593312680269,0
"<anonymized_userid>",2,70001,4556,"Thierry Baudet (FvD)",0.926257707677243,0.486700138874052,0
"<anonymized_userid>",2,70003,4557,"Thierry Baudet (FvD)",0.926284171805118,0.486806965067835,0
"<anonymized_userid>",2,70005,4558,"Thierry Baudet (FvD)",0.926310635932993,0.486913791261617,0
"<anonymized_userid>",2,70007,4559,"Thierry Baudet (FvD)",0.926337100060867,0.4870206174554,0
"<anonymized_userid>",2,70009,4560,"Thierry Baudet (FvD)",0.926363564188742,0.487127443649183,0
"<anonymized_userid>",2,70011,4561,"Thierry Baudet (FvD)",0.926390028316617,0.487234269842965,0
"<anonymized_userid>",2,70013,4562,"Thierry Baudet (FvD)",0.926416492444492,0.487341096036748,0
"<anonymized_userid>",2,70015,4563,"Thierry Baudet (FvD)",0.926442956572366,0.487447922230531,0
"<anonymized_userid>",2,70017,4564,"Thierry Baudet (FvD)",0.926469420700241,0.487554748424314,0
"<anonymized_userid>",2,70019,4565,"Thierry Baudet (FvD)",0.926495884828116,0.487661574618096,0
"<anonymized_userid>",2,70021,4566,"Thierry Baudet (FvD)",0.92652234895599,0.487768400811879,0
"<anonymized_userid>",2,70023,4567,"Thierry Baudet (FvD)",0.926548813083865,0.487875227005662,0
"<anonymized_userid>",2,70025,4568,"Thierry Baudet (FvD)",0.926575277211739,0.487982053199444,0
"<anonymized_userid>",2,70027,4569,"Thierry Baudet (FvD)",0.926601741339614,0.488088879393227,0
"<anonymized_userid>",2,70029,4570,"Thierry Baudet (FvD)",0.926628205467489,0.48819570558701,0
"<anonymized_userid>",2,70031,4571,"Thierry Baudet (FvD)",0.926654669595363,0.488302531780793,0
"<anonymized_userid>",2,70033,4572,"Thierry Baudet (FvD)",0.926681133723238,0.488409357974575,0
"<anonymized_userid>",2,70035,4573,"Thierry Baudet (FvD)",0.926707597851113,0.488516184168358,0
"<anonymized_userid>",2,70037,4574,"Thierry Baudet (FvD)",0.926734061978987,0.488623010362141,0
"<anonymized_userid>",2,70039,4575,"Thierry Baudet (FvD)",0.926760526106862,0.488729836555924,0
"<anonymized_userid>",2,70041,4576,"Thierry Baudet (FvD)",0.926786990234737,0.488836662749706,0
"<anonymized_userid>",2,70043,4577,"Thierry Baudet (FvD)",0.926813454362612,0.488943488943489,0
"<anonymized_userid>",2,70045,4578,"Thierry Baudet (FvD)",0.926839918490486,0.489050315137272,0
"<anonymized_userid>",2,70047,4579,"Thierry Baudet (FvD)",0.926866382618361,0.489157141331054,0
"<anonymized_userid>",2,70049,4580,"Thierry Baudet (FvD)",0.926892846746236,0.489263967524837,0
"<anonymized_userid>",2,70051,4581,"Thierry Baudet (FvD)",0.92691931087411,0.48937079371862,0
"<anonymized_userid>",2,70053,4582,"Thierry Baudet (FvD)",0.926945775001985,0.489477619912403,0
"<anonymized_userid>",2,70055,4583,"Thierry Baudet (FvD)",0.926972239129859,0.489584446106185,0
"<anonymized_userid>",2,70057,4584,"Thierry Baudet (FvD)",0.926998703257734,0.489691272299968,0
"<anonymized_userid>",2,70059,4585,"Thierry Baudet (FvD)",0.927025167385609,0.489798098493751,0
"<anonymized_userid>",2,70061,4586,"Thierry Baudet (FvD)",0.927051631513483,0.489904924687533,0
"<anonymized_userid>",2,70063,4587,"Thierry Baudet (FvD)",0.927078095641358,0.490011750881316,0
"<anonymized_userid>",2,70065,4588,"Thierry Baudet (FvD)",0.927104559769233,0.490118577075099,0
"<anonymized_userid>",2,70067,4589,"Thierry Baudet (FvD)",0.927131023897107,0.490225403268882,0
"<anonymized_userid>",2,70069,4590,"Thierry Baudet (FvD)",0.927157488024982,0.490332229462664,0
"<anonymized_userid>",2,70071,4591,"Thierry Baudet (FvD)",0.927183952152857,0.490439055656447,0
"<anonymized_userid>",2,70073,4592,"Thierry Baudet (FvD)",0.927210416280731,0.49054588185023,0
"<anonymized_userid>",2,70075,4593,"Thierry Baudet (FvD)",0.927236880408606,0.490652708044012,0
"<anonymized_userid>",2,70077,4594,"Thierry Baudet (FvD)",0.927263344536481,0.490759534237795,0
"<anonymized_userid>",2,70079,4595,"Thierry Baudet (FvD)",0.927289808664356,0.490866360431578,0
"<anonymized_userid>",2,70081,4596,"Thierry Baudet (FvD)",0.92731627279223,0.490973186625361,0
"<anonymized_userid>",2,70083,4597,"Thierry Baudet (FvD)",0.927342736920105,0.491080012819143,0
"<anonymized_userid>",2,70085,4598,"Thierry Baudet (FvD)",0.927369201047979,0.491186839012926,0
"<anonymized_userid>",2,70087,4599,"Thierry Baudet (FvD)",0.927395665175854,0.491293665206709,0
"<anonymized_userid>",2,70089,4600,"Thierry Baudet (FvD)",0.927422129303729,0.491400491400491,0
"<anonymized_userid>",2,70091,4601,"Thierry Baudet (FvD)",0.927448593431603,0.491507317594274,0
"<anonymized_userid>",2,70093,4602,"Thierry Baudet (FvD)",0.927475057559478,0.491614143788057,0
"<anonymized_userid>",2,70095,4603,"Thierry Baudet (FvD)",0.927501521687353,0.49172096998184,0
"<anonymized_userid>",2,70097,4604,"Thierry Baudet (FvD)",0.927527985815227,0.491827796175622,0
"<anonymized_userid>",2,70099,4605,"Thierry Baudet (FvD)",0.927554449943102,0.491934622369405,0
"<anonymized_userid>",2,70101,4606,"Thierry Baudet (FvD)",0.927580914070977,0.492041448563188,0
"<anonymized_userid>",2,70103,4607,"Thierry Baudet (FvD)",0.927607378198851,0.49214827475697,0
"<anonymized_userid>",2,70105,4608,"Thierry Baudet (FvD)",0.927633842326726,0.492255100950753,0
"<anonymized_userid>",2,70107,4609,"Thierry Baudet (FvD)",0.927660306454601,0.492361927144536,0
"<anonymized_userid>",2,70109,4610,"Thierry Baudet (FvD)",0.927686770582476,0.492468753338319,0
"<anonymized_userid>",2,70111,4611,"Thierry Baudet (FvD)",0.92771323471035,0.492575579532101,0
"<anonymized_userid>",2,70113,4612,"Thierry Baudet (FvD)",0.927739698838225,0.492682405725884,0
"<anonymized_userid>",2,70115,4613,"Thierry Baudet (FvD)",0.927766162966099,0.492789231919667,0
"<anonymized_userid>",2,70117,4614,"Thierry Baudet (FvD)",0.927792627093974,0.492896058113449,0
"<anonymized_userid>",2,70119,4615,"Thierry Baudet (FvD)",0.927819091221849,0.493002884307232,0
"<anonymized_userid>",2,70121,4616,"Thierry Baudet (FvD)",0.927845555349723,0.493109710501015,0
"<anonymized_userid>",2,70123,4617,"Thierry Baudet (FvD)",0.927872019477598,0.493216536694798,0
"<anonymized_userid>",2,70125,4618,"Thierry Baudet (FvD)",0.927898483605473,0.49332336288858,0
"<anonymized_userid>",2,70127,4619,"Thierry Baudet (FvD)",0.927924947733347,0.493430189082363,0
"<anonymized_userid>",2,70129,4620,"Thierry Baudet (FvD)",0.927951411861222,0.493537015276146,0
"<anonymized_userid>",2,70131,4621,"Thierry Baudet (FvD)",0.927977875989097,0.493643841469928,0
"<anonymized_userid>",2,70133,4622,"Thierry Baudet (FvD)",0.928004340116971,0.493750667663711,0
"<anonymized_userid>",2,70135,4623,"Thierry Baudet (FvD)",0.928030804244846,0.493857493857494,0
"<anonymized_userid>",2,70137,4624,"Thierry Baudet (FvD)",0.928057268372721,0.493964320051277,0
"<anonymized_userid>",2,70139,4625,"Thierry Baudet (FvD)",0.928083732500595,0.494071146245059,0
"<anonymized_userid>",2,70141,4626,"Thierry Baudet (FvD)",0.92811019662847,0.494177972438842,0
"<anonymized_userid>",2,70143,4627,"Thierry Baudet (FvD)",0.928136660756345,0.494284798632625,0
"<anonymized_userid>",2,70145,4628,"Thierry Baudet (FvD)",0.928163124884219,0.494391624826407,0
"<anonymized_userid>",2,70147,4629,"Thierry Baudet (FvD)",0.928189589012094,0.49449845102019,0
"<anonymized_userid>",2,70149,4630,"Thierry Baudet (FvD)",0.928216053139969,0.494605277213973,0
"<anonymized_userid>",2,70151,4631,"Thierry Baudet (FvD)",0.928242517267843,0.494712103407756,0
"<anonymized_userid>",2,70153,4632,"Thierry Baudet (FvD)",0.928268981395718,0.494818929601538,0
"<anonymized_userid>",2,70155,4633,"Thierry Baudet (FvD)",0.928295445523593,0.494925755795321,0
"<anonymized_userid>",2,70157,4634,"Thierry Baudet (FvD)",0.928321909651467,0.495032581989104,0
"<anonymized_userid>",2,70159,4635,"Thierry Baudet (FvD)",0.928348373779342,0.495139408182886,0
"<anonymized_userid>",2,70161,4636,"Thierry Baudet (FvD)",0.928374837907217,0.495246234376669,0
"<anonymized_userid>",2,70163,4637,"Thierry Baudet (FvD)",0.928401302035091,0.495353060570452,0
"<anonymized_userid>",2,70165,4638,"Thierry Baudet (FvD)",0.928427766162966,0.495459886764235,0
"<anonymized_userid>",2,70167,4639,"Thierry Baudet (FvD)",0.928454230290841,0.495566712958017,0
"<anonymized_userid>",2,70169,4640,"Thierry Baudet (FvD)",0.928480694418715,0.4956735391518,0
"<anonymized_userid>",2,70171,4641,"Thierry Baudet (FvD)",0.92850715854659,0.495780365345583,0
"<anonymized_userid>",2,70173,4642,"Thierry Baudet (FvD)",0.928533622674465,0.495887191539365,0
"<anonymized_userid>",2,70175,4643,"Thierry Baudet (FvD)",0.928560086802339,0.495994017733148,0
"<anonymized_userid>",2,70177,4644,"Thierry Baudet (FvD)",0.928586550930214,0.496100843926931,0
"<anonymized_userid>",2,70179,4645,"Thierry Baudet (FvD)",0.928613015058089,0.496207670120714,0
"<anonymized_userid>",2,70181,4646,"Thierry Baudet (FvD)",0.928639479185963,0.496314496314496,0
"<anonymized_userid>",2,70183,4647,"Thierry Baudet (FvD)",0.928665943313838,0.496421322508279,0
"<anonymized_userid>",2,70185,4648,"Thierry Baudet (FvD)",0.928692407441713,0.496528148702062,0
"<anonymized_userid>",2,70187,4649,"Thierry Baudet (FvD)",0.928718871569587,0.496634974895844,0
"<anonymized_userid>",2,70189,4650,"Thierry Baudet (FvD)",0.928745335697462,0.496741801089627,0
"<anonymized_userid>",2,70191,4651,"Thierry Baudet (FvD)",0.928771799825337,0.49684862728341,0
"<anonymized_userid>",2,70193,4652,"Thierry Baudet (FvD)",0.928798263953211,0.496955453477193,0
"<anonymized_userid>",2,70195,4653,"Thierry Baudet (FvD)",0.928824728081086,0.497062279670975,0
"<anonymized_userid>",2,70197,4654,"Thierry Baudet (FvD)",0.928851192208961,0.497169105864758,0
"<anonymized_userid>",2,70199,4655,"Thierry Baudet (FvD)",0.928877656336835,0.497275932058541,0
"<anonymized_userid>",2,70201,4656,"Thierry Baudet (FvD)",0.92890412046471,0.497382758252323,0
"<anonymized_userid>",2,70203,4657,"Thierry Baudet (FvD)",0.928930584592585,0.497489584446106,0
"<anonymized_userid>",2,70205,4658,"Thierry Baudet (FvD)",0.928957048720459,0.497596410639889,0
"<anonymized_userid>",2,70207,4659,"Thierry Baudet (FvD)",0.928983512848334,0.497703236833672,0
"<anonymized_userid>",2,70209,4660,"Thierry Baudet (FvD)",0.929009976976209,0.497810063027454,0
"<anonymized_userid>",2,70211,4661,"Thierry Baudet (FvD)",0.929036441104083,0.497916889221237,0
"<anonymized_userid>",2,70213,4662,"Thierry Baudet (FvD)",0.929062905231958,0.49802371541502,0
"<anonymized_userid>",2,70215,4663,"Thierry Baudet (FvD)",0.929089369359833,0.498130541608802,0
"<anonymized_userid>",2,70217,4664,"Thierry Baudet (FvD)",0.929115833487707,0.498237367802585,0
"<anonymized_userid>",2,70219,4665,"Thierry Baudet (FvD)",0.929142297615582,0.498344193996368,0
"<anonymized_userid>",2,70221,4666,"Thierry Baudet (FvD)",0.929168761743457,0.498451020190151,0
"<anonymized_userid>",2,70223,4667,"Thierry Baudet (FvD)",0.929195225871331,0.498557846383933,0
"<anonymized_userid>",2,70225,4668,"Thierry Baudet (FvD)",0.929221689999206,0.498664672577716,0
"<anonymized_userid>",2,70227,4669,"Thierry Baudet (FvD)",0.929248154127081,0.498771498771499,0
"<anonymized_userid>",2,70229,4670,"Thierry Baudet (FvD)",0.929274618254955,0.498878324965282,0
"<anonymized_userid>",2,70231,4671,"Thierry Baudet (FvD)",0.92930108238283,0.498985151159064,0
"<anonymized_userid>",2,70233,4672,"Thierry Baudet (FvD)",0.929327546510705,0.499091977352847,0
"<anonymized_userid>",2,70235,4673,"Thierry Baudet (FvD)",0.929354010638579,0.49919880354663,0
"<anonymized_userid>",2,70237,4674,"Thierry Baudet (FvD)",0.929380474766454,0.499305629740412,0
"<anonymized_userid>",2,70239,4675,"Thierry Baudet (FvD)",0.929406938894329,0.499412455934195,0
"<anonymized_userid>",2,70241,4676,"Thierry Baudet (FvD)",0.929433403022203,0.499519282127978,0
"<anonymized_userid>",2,70243,4677,"Thierry Baudet (FvD)",0.929459867150078,0.499626108321761,0
"<anonymized_userid>",2,70245,4678,"Thierry Baudet (FvD)",0.929486331277953,0.499732934515543,0
"<anonymized_userid>",2,70247,4679,"Thierry Baudet (FvD)",0.929512795405827,0.499839760709326,0
"<anonymized_userid>",2,70249,4680,"Thierry Baudet (FvD)",0.929539259533702,0.499946586903109,0
"<anonymized_userid>",2,70251,4681,"Thierry Baudet (FvD)",0.929565723661577,0.500053413096891,1
"<anonymized_userid>",2,70253,4682,"Thierry Baudet (FvD)",0.929592187789451,0.500160239290674,1
"<anonymized_userid>",2,70255,4683,"Thierry Baudet (FvD)",0.929618651917326,0.500267065484457,0
"<anonymized_userid>",2,70257,4684,"Thierry Baudet (FvD)",0.929645116045201,0.50037389167824,0
"<anonymized_userid>",2,70259,4685,"Thierry Baudet (FvD)",0.929671580173075,0.500480717872022,0
"<anonymized_userid>",2,70261,4686,"Thierry Baudet (FvD)",0.92969804430095,0.500587544065805,0
"<anonymized_userid>",2,70263,4687,"Thierry Baudet (FvD)",0.929724508428825,0.500694370259588,0
"<anonymized_userid>",2,70265,4688,"Thierry Baudet (FvD)",0.929750972556699,0.50080119645337,0
"<anonymized_userid>",2,70267,4689,"Thierry Baudet (FvD)",0.929777436684574,0.500908022647153,0
"<anonymized_userid>",2,70269,4690,"Thierry Baudet (FvD)",0.929803900812449,0.501014848840936,0
"<anonymized_userid>",2,70271,4691,"Thierry Baudet (FvD)",0.929830364940323,0.501121675034718,0
"<anonymized_userid>",2,70273,4692,"Thierry Baudet (FvD)",0.929856829068198,0.501228501228501,0
"<anonymized_userid>",2,70275,4693,"Thierry Baudet (FvD)",0.929883293196073,0.501335327422284,0
"<anonymized_userid>",2,70277,4694,"Thierry Baudet (FvD)",0.929909757323947,0.501442153616067,0
"<anonymized_userid>",2,70279,4695,"Thierry Baudet (FvD)",0.929936221451822,0.501548979809849,0
"<anonymized_userid>",2,70281,4696,"Thierry Baudet (FvD)",0.929962685579697,0.501655806003632,0
"<anonymized_userid>",2,70283,4697,"Thierry Baudet (FvD)",0.929989149707571,0.501762632197415,0
"<anonymized_userid>",2,70285,4698,"Thierry Baudet (FvD)",0.930015613835446,0.501869458391198,0
"<anonymized_userid>",2,70287,4699,"Thierry Baudet (FvD)",0.930042077963321,0.50197628458498,0
"<anonymized_userid>",2,70289,4700,"Thierry Baudet (FvD)",0.930068542091195,0.502083110778763,0
"<anonymized_userid>",2,70291,4701,"Thierry Baudet (FvD)",0.93009500621907,0.502189936972546,0
"<anonymized_userid>",2,70293,4702,"Thierry Baudet (FvD)",0.930121470346945,0.502296763166328,0
"<anonymized_userid>",2,70295,4703,"Thierry Baudet (FvD)",0.930147934474819,0.502403589360111,0
"<anonymized_userid>",2,70297,4704,"Thierry Baudet (FvD)",0.930174398602694,0.502510415553894,0
"<anonymized_userid>",2,70299,4705,"Thierry Baudet (FvD)",0.930200862730569,0.502617241747677,0
"<anonymized_userid>",2,70301,4706,"Thierry Baudet (FvD)",0.930227326858443,0.502724067941459,0
"<anonymized_userid>",2,70303,4707,"Thierry Baudet (FvD)",0.930253790986318,0.502830894135242,0
"<anonymized_userid>",2,70305,4708,"Thierry Baudet (FvD)",0.930280255114193,0.502937720329025,0
"<anonymized_userid>",2,70307,4709,"Thierry Baudet (FvD)",0.930306719242067,0.503044546522807,0
"<anonymized_userid>",2,70309,4710,"Thierry Baudet (FvD)",0.930333183369942,0.50315137271659,0
"<anonymized_userid>",2,70311,4711,"Thierry Baudet (FvD)",0.930359647497817,0.503258198910373,0
"<anonymized_userid>",2,70313,4712,"Thierry Baudet (FvD)",0.930386111625691,0.503365025104155,0
"<anonymized_userid>",2,70315,4713,"Thierry Baudet (FvD)",0.930412575753566,0.503471851297938,0
"<anonymized_userid>",2,70317,4714,"Thierry Baudet (FvD)",0.930439039881441,0.503578677491721,0
"<anonymized_userid>",2,70319,4715,"Thierry Baudet (FvD)",0.930465504009315,0.503685503685504,0
"<anonymized_userid>",2,70321,4716,"Thierry Baudet (FvD)",0.93049196813719,0.503792329879286,0
"<anonymized_userid>",2,70323,4717,"Thierry Baudet (FvD)",0.930518432265065,0.503899156073069,0
"<anonymized_userid>",2,70325,4718,"Thierry Baudet (FvD)",0.930544896392939,0.504005982266852,0
"<anonymized_userid>",2,70327,4719,"Thierry Baudet (FvD)",0.930571360520814,0.504112808460635,0
"<anonymized_userid>",2,70329,4720,"Thierry Baudet (FvD)",0.930597824648689,0.504219634654417,0
"<anonymized_userid>",2,70331,4721,"Thierry Baudet (FvD)",0.930624288776563,0.5043264608482,0
"<anonymized_userid>",2,70333,4722,"Thierry Baudet (FvD)",0.930650752904438,0.504433287041983,0
"<anonymized_userid>",2,70335,4723,"Thierry Baudet (FvD)",0.930677217032313,0.504540113235765,0
"<anonymized_userid>",2,70337,4724,"Thierry Baudet (FvD)",0.930703681160187,0.504646939429548,0
"<anonymized_userid>",2,70339,4725,"Thierry Baudet (FvD)",0.930730145288062,0.504753765623331,0
"<anonymized_userid>",2,70341,4726,"Thierry Baudet (FvD)",0.930756609415937,0.504860591817114,0
"<anonymized_userid>",2,70343,4727,"Thierry Baudet (FvD)",0.930783073543811,0.504967418010896,0
"<anonymized_userid>",2,70345,4728,"Thierry Baudet (FvD)",0.930809537671686,0.505074244204679,0
"<anonymized_userid>",2,70347,4729,"Thierry Baudet (FvD)",0.930836001799561,0.505181070398462,0
"<anonymized_userid>",2,70349,4730,"Thierry Baudet (FvD)",0.930862465927435,0.505287896592244,0
"<anonymized_userid>",2,70351,4731,"Thierry Baudet (FvD)",0.93088893005531,0.505394722786027,0
"<anonymized_userid>",2,70353,4732,"Thierry Baudet (FvD)",0.930915394183185,0.50550154897981,0
"<anonymized_userid>",2,70355,4733,"Thierry Baudet (FvD)",0.930941858311059,0.505608375173593,0
"<anonymized_userid>",2,70357,4734,"Thierry Baudet (FvD)",0.930968322438934,0.505715201367375,0
"<anonymized_userid>",2,70359,4735,"Thierry Baudet (FvD)",0.930994786566809,0.505822027561158,0
"<anonymized_userid>",2,70361,4736,"Thierry Baudet (FvD)",0.931021250694683,0.505928853754941,0
"<anonymized_userid>",2,70363,4737,"Thierry Baudet (FvD)",0.931047714822558,0.506035679948723,0
"<anonymized_userid>",2,70365,4738,"Thierry Baudet (FvD)",0.931074178950433,0.506142506142506,0
"<anonymized_userid>",2,70367,4739,"Thierry Baudet (FvD)",0.931100643078307,0.506249332336289,0
"<anonymized_userid>",2,70369,4740,"Thierry Baudet (FvD)",0.931127107206182,0.506356158530072,0
"<anonymized_userid>",2,70371,4741,"Thierry Baudet (FvD)",0.931153571334057,0.506462984723854,0
"<anonymized_userid>",2,70373,4742,"Thierry Baudet (FvD)",0.931180035461931,0.506569810917637,0
"<anonymized_userid>",2,70375,4743,"Thierry Baudet (FvD)",0.931206499589806,0.50667663711142,0
"<anonymized_userid>",2,70377,4744,"Thierry Baudet (FvD)",0.931232963717681,0.506783463305202,0
"<anonymized_userid>",2,70379,4745,"Thierry Baudet (FvD)",0.931259427845555,0.506890289498985,0
"<anonymized_userid>",2,70381,4746,"Thierry Baudet (FvD)",0.93128589197343,0.506997115692768,0
"<anonymized_userid>",2,70383,4747,"Thierry Baudet (FvD)",0.931312356101305,0.507103941886551,0
"<anonymized_userid>",2,70385,4748,"Thierry Baudet (FvD)",0.931338820229179,0.507210768080333,0
"<anonymized_userid>",2,70387,4749,"Thierry Baudet (FvD)",0.931365284357054,0.507317594274116,0
"<anonymized_userid>",2,70389,4750,"Thierry Baudet (FvD)",0.931391748484929,0.507424420467899,0
"<anonymized_userid>",2,70391,4751,"Thierry Baudet (FvD)",0.931418212612803,0.507531246661681,0
"<anonymized_userid>",2,70393,4752,"Thierry Baudet (FvD)",0.931444676740678,0.507638072855464,0
"<anonymized_userid>",2,70395,4753,"Thierry Baudet (FvD)",0.931471140868553,0.507744899049247,0
"<anonymized_userid>",2,70397,4754,"Thierry Baudet (FvD)",0.931497604996427,0.50785172524303,0
"<anonymized_userid>",2,70399,4755,"Thierry Baudet (FvD)",0.931524069124302,0.507958551436812,0
"<anonymized_userid>",2,70401,4756,"Thierry Baudet (FvD)",0.931550533252177,0.508065377630595,0
"<anonymized_userid>",2,70403,4757,"Thierry Baudet (FvD)",0.931576997380051,0.508172203824378,0
"<anonymized_userid>",2,70405,4758,"Thierry Baudet (FvD)",0.931603461507926,0.50827903001816,0
"<anonymized_userid>",2,70407,4759,"Thierry Baudet (FvD)",0.931629925635801,0.508385856211943,0
"<anonymized_userid>",2,70409,4760,"Thierry Baudet (FvD)",0.931656389763675,0.508492682405726,0
"<anonymized_userid>",2,70411,4761,"Thierry Baudet (FvD)",0.93168285389155,0.508599508599509,0
"<anonymized_userid>",2,70413,4762,"Thierry Baudet (FvD)",0.931709318019425,0.508706334793291,0
"<anonymized_userid>",2,70415,4763,"Thierry Baudet (FvD)",0.931735782147299,0.508813160987074,0
"<anonymized_userid>",2,70417,4764,"Thierry Baudet (FvD)",0.931762246275174,0.508919987180857,0
"<anonymized_userid>",2,70419,4765,"Thierry Baudet (FvD)",0.931788710403049,0.50902681337464,0
"<anonymized_userid>",2,70421,4766,"Thierry Baudet (FvD)",0.931815174530923,0.509133639568422,0
"<anonymized_userid>",2,70423,4767,"Thierry Baudet (FvD)",0.931841638658798,0.509240465762205,0
"<anonymized_userid>",2,70425,4768,"Thierry Baudet (FvD)",0.931868102786673,0.509347291955988,0
"<anonymized_userid>",2,70427,4769,"Thierry Baudet (FvD)",0.931894566914547,0.50945411814977,0
"<anonymized_userid>",2,70429,4770,"Thierry Baudet (FvD)",0.931921031042422,0.509560944343553,0
"<anonymized_userid>",2,70431,4771,"Thierry Baudet (FvD)",0.931947495170297,0.509667770537336,0
"<anonymized_userid>",2,70433,4772,"Thierry Baudet (FvD)",0.931973959298171,0.509774596731118,0
"<anonymized_userid>",2,70435,4773,"Thierry Baudet (FvD)",0.932000423426046,0.509881422924901,0
"<anonymized_userid>",2,70437,4774,"Thierry Baudet (FvD)",0.932026887553921,0.509988249118684,0
"<anonymized_userid>",2,70439,4775,"Thierry Baudet (FvD)",0.932053351681795,0.510095075312467,0
"<anonymized_userid>",2,70441,4776,"Thierry Baudet (FvD)",0.93207981580967,0.510201901506249,0
"<anonymized_userid>",2,70443,4777,"Thierry Baudet (FvD)",0.932106279937545,0.510308727700032,0
"<anonymized_userid>",2,70445,4778,"Thierry Baudet (FvD)",0.932132744065419,0.510415553893815,0
"<anonymized_userid>",2,70447,4779,"Thierry Baudet (FvD)",0.932159208193294,0.510522380087597,0
"<anonymized_userid>",2,70449,4780,"Thierry Baudet (FvD)",0.932185672321169,0.51062920628138,0
"<anonymized_userid>",2,70451,4781,"Thierry Baudet (FvD)",0.932212136449043,0.510736032475163,0
"<anonymized_userid>",2,70453,4782,"Thierry Baudet (FvD)",0.932238600576918,0.510842858668946,0
"<anonymized_userid>",2,70455,4783,"Thierry Baudet (FvD)",0.932265064704793,0.510949684862728,0
"<anonymized_userid>",2,70457,4784,"Thierry Baudet (FvD)",0.932291528832667,0.511056511056511,0
"<anonymized_userid>",2,70459,4785,"Thierry Baudet (FvD)",0.932317992960542,0.511163337250294,0
"<anonymized_userid>",2,70461,4786,"Thierry Baudet (FvD)",0.932344457088417,0.511270163444076,0
"<anonymized_userid>",2,70463,4787,"Thierry Baudet (FvD)",0.932370921216291,0.511376989637859,0
"<anonymized_userid>",2,70465,4788,"Thierry Baudet (FvD)",0.932397385344166,0.511483815831642,0
"<anonymized_userid>",2,70467,4789,"Thierry Baudet (FvD)",0.932423849472041,0.511590642025425,0
"<anonymized_userid>",2,70469,4790,"Thierry Baudet (FvD)",0.932450313599915,0.511697468219207,0
"<anonymized_userid>",2,70471,4791,"Thierry Baudet (FvD)",0.93247677772779,0.51180429441299,0
"<anonymized_userid>",2,70473,4792,"Thierry Baudet (FvD)",0.932503241855665,0.511911120606773,0
"<anonymized_userid>",2,70475,4793,"Thierry Baudet (FvD)",0.932529705983539,0.512017946800555,0
"<anonymized_userid>",2,70477,4794,"Thierry Baudet (FvD)",0.932556170111414,0.512124772994338,0
"<anonymized_userid>",2,70479,4795,"Thierry Baudet (FvD)",0.932582634239289,0.512231599188121,0
"<anonymized_userid>",2,70481,4796,"Thierry Baudet (FvD)",0.932609098367163,0.512338425381904,0
"<anonymized_userid>",2,70483,4797,"Thierry Baudet (FvD)",0.932635562495038,0.512445251575686,0
"<anonymized_userid>",2,70485,4798,"Thierry Baudet (FvD)",0.932662026622913,0.512552077769469,0
"<anonymized_userid>",2,70487,4799,"Thierry Baudet (FvD)",0.932688490750787,0.512658903963252,0
"<anonymized_userid>",2,70489,4800,"Thierry Baudet (FvD)",0.932714954878662,0.512765730157035,0
"<anonymized_userid>",2,70491,4801,"Thierry Baudet (FvD)",0.932741419006537,0.512872556350817,0
"<anonymized_userid>",2,70493,4802,"Thierry Baudet (FvD)",0.932767883134411,0.5129793825446,0
"<anonymized_userid>",2,70495,4803,"Thierry Baudet (FvD)",0.932794347262286,0.513086208738383,0
"<anonymized_userid>",2,70497,4804,"Thierry Baudet (FvD)",0.932820811390161,0.513193034932165,0
"<anonymized_userid>",2,70499,4805,"Thierry Baudet (FvD)",0.932847275518035,0.513299861125948,0
"<anonymized_userid>",2,70501,4806,"Thierry Baudet (FvD)",0.93287373964591,0.513406687319731,0
"<anonymized_userid>",2,70503,4807,"Thierry Baudet (FvD)",0.932900203773785,0.513513513513513,0
"<anonymized_userid>",2,70505,4808,"Thierry Baudet (FvD)",0.932926667901659,0.513620339707296,0
"<anonymized_userid>",2,70507,4809,"Thierry Baudet (FvD)",0.932953132029534,0.513727165901079,0
"<anonymized_userid>",2,70509,4810,"Thierry Baudet (FvD)",0.932979596157409,0.513833992094862,0
"<anonymized_userid>",2,70511,4811,"Thierry Baudet (FvD)",0.933006060285283,0.513940818288644,0
"<anonymized_userid>",2,70513,4812,"Thierry Baudet (FvD)",0.933032524413158,0.514047644482427,0
"<anonymized_userid>",2,70515,4813,"Thierry Baudet (FvD)",0.933058988541033,0.51415447067621,0
"<anonymized_userid>",2,70517,4814,"Thierry Baudet (FvD)",0.933085452668907,0.514261296869993,0
"<anonymized_userid>",2,70519,4815,"Thierry Baudet (FvD)",0.933111916796782,0.514368123063775,0
"<anonymized_userid>",2,70521,4816,"Thierry Baudet (FvD)",0.933138380924657,0.514474949257558,0
"<anonymized_userid>",2,70523,4817,"Thierry Baudet (FvD)",0.933164845052531,0.514581775451341,0
"<anonymized_userid>",2,70525,4818,"Thierry Baudet (FvD)",0.933191309180406,0.514688601645123,0
"<anonymized_userid>",2,70527,4819,"Thierry Baudet (FvD)",0.933217773308281,0.514795427838906,0
"<anonymized_userid>",2,70529,4820,"Thierry Baudet (FvD)",0.933244237436155,0.514902254032689,0
"<anonymized_userid>",2,70531,4821,"Thierry Baudet (FvD)",0.93327070156403,0.515009080226472,0
"<anonymized_userid>",2,70533,4822,"Thierry Baudet (FvD)",0.933297165691905,0.515115906420254,0
"<anonymized_userid>",2,70535,4823,"Thierry Baudet (FvD)",0.933323629819779,0.515222732614037,0
"<anonymized_userid>",2,70537,4824,"Thierry Baudet (FvD)",0.933350093947654,0.51532955880782,0
"<anonymized_userid>",2,70539,4825,"Thierry Baudet (FvD)",0.933376558075529,0.515436385001602,0
"<anonymized_userid>",2,70541,4826,"Thierry Baudet (FvD)",0.933403022203403,0.515543211195385,0
"<anonymized_userid>",2,70543,4827,"Thierry Baudet (FvD)",0.933429486331278,0.515650037389168,0
"<anonymized_userid>",2,70545,4828,"Thierry Baudet (FvD)",0.933455950459153,0.515756863582951,0
"<anonymized_userid>",2,70547,4829,"Thierry Baudet (FvD)",0.933482414587027,0.515863689776733,0
"<anonymized_userid>",2,70549,4830,"Thierry Baudet (FvD)",0.933508878714902,0.515970515970516,0
"<anonymized_userid>",2,70551,4831,"Thierry Baudet (FvD)",0.933535342842777,0.516077342164299,0
"<anonymized_userid>",2,70553,4832,"Thierry Baudet (FvD)",0.933561806970651,0.516184168358081,0
"<anonymized_userid>",2,70555,4833,"Thierry Baudet (FvD)",0.933588271098526,0.516290994551864,0
"<anonymized_userid>",2,70557,4834,"Thierry Baudet (FvD)",0.933614735226401,0.516397820745647,0
"<anonymized_userid>",2,70559,4835,"Thierry Baudet (FvD)",0.933641199354275,0.51650464693943,0
"<anonymized_userid>",2,70561,4836,"Thierry Baudet (FvD)",0.93366766348215,0.516611473133212,0
"<anonymized_userid>",2,70563,4837,"Thierry Baudet (FvD)",0.933694127610025,0.516718299326995,0
"<anonymized_userid>",2,70565,4838,"Thierry Baudet (FvD)",0.933720591737899,0.516825125520778,0
"<anonymized_userid>",2,70567,4839,"Thierry Baudet (FvD)",0.933747055865774,0.51693195171456,0
"<anonymized_userid>",2,70569,4840,"Thierry Baudet (FvD)",0.933773519993649,0.517038777908343,0
"<anonymized_userid>",2,70571,4841,"Thierry Baudet (FvD)",0.933799984121523,0.517145604102126,0
"<anonymized_userid>",2,70573,4842,"Thierry Baudet (FvD)",0.933826448249398,0.517252430295909,0
"<anonymized_userid>",2,70575,4843,"Thierry Baudet (FvD)",0.933852912377273,0.517359256489691,0
"<anonymized_userid>",2,70577,4844,"Thierry Baudet (FvD)",0.933879376505147,0.517466082683474,0
"<anonymized_userid>",2,70579,4845,"Thierry Baudet (FvD)",0.933905840633022,0.517572908877257,0
"<anonymized_userid>",2,70581,4846,"Thierry Baudet (FvD)",0.933932304760897,0.517679735071039,0
"<anonymized_userid>",2,70583,4847,"Thierry Baudet (FvD)",0.933958768888771,0.517786561264822,0
"<anonymized_userid>",2,70585,4848,"Thierry Baudet (FvD)",0.933985233016646,0.517893387458605,0
"<anonymized_userid>",2,70587,4849,"Thierry Baudet (FvD)",0.934011697144521,0.518000213652388,0
"<anonymized_userid>",2,70589,4850,"Thierry Baudet (FvD)",0.934038161272395,0.51810703984617,0
"<anonymized_userid>",2,70591,4851,"Thierry Baudet (FvD)",0.93406462540027,0.518213866039953,0
"<anonymized_userid>",2,70593,4852,"Thierry Baudet (FvD)",0.934091089528145,0.518320692233736,0
"<anonymized_userid>",2,70595,4853,"Thierry Baudet (FvD)",0.934117553656019,0.518427518427518,0
"<anonymized_userid>",2,70597,4854,"Thierry Baudet (FvD)",0.934144017783894,0.518534344621301,0
"<anonymized_userid>",2,70599,4855,"Thierry Baudet (FvD)",0.934170481911769,0.518641170815084,0
"<anonymized_userid>",2,70601,4856,"Thierry Baudet (FvD)",0.934196946039643,0.518747997008867,0
"<anonymized_userid>",2,70603,4857,"Thierry Baudet (FvD)",0.934223410167518,0.518854823202649,0
"<anonymized_userid>",2,70605,4858,"Thierry Baudet (FvD)",0.934249874295393,0.518961649396432,0
"<anonymized_userid>",2,70607,4859,"Thierry Baudet (FvD)",0.934276338423267,0.519068475590215,0
"<anonymized_userid>",2,70609,4860,"Thierry Baudet (FvD)",0.934302802551142,0.519175301783997,0
"<anonymized_userid>",2,70611,4861,"Thierry Baudet (FvD)",0.934329266679017,0.51928212797778,0
"<anonymized_userid>",2,70613,4862,"Thierry Baudet (FvD)",0.934355730806891,0.519388954171563,0
"<anonymized_userid>",2,70615,4863,"Thierry Baudet (FvD)",0.934382194934766,0.519495780365346,0
"<anonymized_userid>",2,70617,4864,"Thierry Baudet (FvD)",0.934408659062641,0.519602606559128,0
"<anonymized_userid>",2,70619,4865,"Thierry Baudet (FvD)",0.934435123190515,0.519709432752911,0
"<anonymized_userid>",2,70621,4866,"Thierry Baudet (FvD)",0.93446158731839,0.519816258946694,0
"<anonymized_userid>",2,70623,4867,"Thierry Baudet (FvD)",0.934488051446265,0.519923085140476,0
"<anonymized_userid>",2,70625,4868,"Thierry Baudet (FvD)",0.934514515574139,0.520029911334259,0
"<anonymized_userid>",2,70627,4869,"Thierry Baudet (FvD)",0.934540979702014,0.520136737528042,0
"<anonymized_userid>",2,70629,4870,"Thierry Baudet (FvD)",0.934567443829889,0.520243563721825,0
"<anonymized_userid>",2,70631,4871,"Thierry Baudet (FvD)",0.934593907957763,0.520350389915607,0
"<anonymized_userid>",2,70633,4872,"Thierry Baudet (FvD)",0.934620372085638,0.52045721610939,0
"<anonymized_userid>",2,70635,4873,"Thierry Baudet (FvD)",0.934646836213513,0.520564042303173,0
"<anonymized_userid>",2,70637,4874,"Thierry Baudet (FvD)",0.934673300341387,0.520670868496955,0
"<anonymized_userid>",2,70639,4875,"Thierry Baudet (FvD)",0.934699764469262,0.520777694690738,0
"<anonymized_userid>",2,70641,4876,"Thierry Baudet (FvD)",0.934726228597137,0.520884520884521,0
"<anonymized_userid>",2,70643,4877,"Thierry Baudet (FvD)",0.934752692725011,0.520991347078304,0
"<anonymized_userid>",2,70645,4878,"Thierry Baudet (FvD)",0.934779156852886,0.521098173272086,0
"<anonymized_userid>",2,70647,4879,"Thierry Baudet (FvD)",0.934805620980761,0.521204999465869,0
"<anonymized_userid>",2,70649,4880,"Thierry Baudet (FvD)",0.934832085108635,0.521311825659652,0
"<anonymized_userid>",2,70651,4881,"Thierry Baudet (FvD)",0.93485854923651,0.521418651853435,0
"<anonymized_userid>",2,70653,4882,"Thierry Baudet (FvD)",0.934885013364385,0.521525478047217,0
"<anonymized_userid>",2,70655,4883,"Thierry Baudet (FvD)",0.934911477492259,0.521632304241,0
"<anonymized_userid>",2,70657,4884,"Thierry Baudet (FvD)",0.934937941620134,0.521739130434783,0
"<anonymized_userid>",2,70659,4885,"Thierry Baudet (FvD)",0.934964405748009,0.521845956628565,0
"<anonymized_userid>",2,70661,4886,"Thierry Baudet (FvD)",0.934990869875883,0.521952782822348,0
"<anonymized_userid>",2,70663,4887,"Thierry Baudet (FvD)",0.935017334003758,0.522059609016131,0
"<anonymized_userid>",2,70665,4888,"Thierry Baudet (FvD)",0.935043798131633,0.522166435209913,0
"<anonymized_userid>",2,70667,4889,"Thierry Baudet (FvD)",0.935070262259507,0.522273261403696,0
"<anonymized_userid>",2,70669,4890,"Thierry Baudet (FvD)",0.935096726387382,0.522380087597479,0
"<anonymized_userid>",2,70671,4891,"Thierry Baudet (FvD)",0.935123190515257,0.522486913791262,0
"<anonymized_userid>",2,70673,4892,"Thierry Baudet (FvD)",0.935149654643131,0.522593739985044,0
"<anonymized_userid>",2,70675,4893,"Thierry Baudet (FvD)",0.935176118771006,0.522700566178827,0
"<anonymized_userid>",2,70677,4894,"Thierry Baudet (FvD)",0.935202582898881,0.52280739237261,0
"<anonymized_userid>",2,70679,4895,"Thierry Baudet (FvD)",0.935229047026755,0.522914218566393,0
"<anonymized_userid>",2,70681,4896,"Thierry Baudet (FvD)",0.93525551115463,0.523021044760175,0
"<anonymized_userid>",2,70683,4897,"Thierry Baudet (FvD)",0.935281975282505,0.523127870953958,0
"<anonymized_userid>",2,70685,4898,"Thierry Baudet (FvD)",0.935308439410379,0.523234697147741,0
"<anonymized_userid>",2,70687,4899,"Thierry Baudet (FvD)",0.935334903538254,0.523341523341523,0
"<anonymized_userid>",2,70689,4900,"Thierry Baudet (FvD)",0.935361367666129,0.523448349535306,0
"<anonymized_userid>",2,70691,4901,"Thierry Baudet (FvD)",0.935387831794003,0.523555175729089,0
"<anonymized_userid>",2,70693,4902,"Thierry Baudet (FvD)",0.935414295921878,0.523662001922871,0
"<anonymized_userid>",2,70695,4903,"Thierry Baudet (FvD)",0.935440760049753,0.523768828116654,0
"<anonymized_userid>",2,70697,4904,"Thierry Baudet (FvD)",0.935467224177627,0.523875654310437,0
"<anonymized_userid>",2,70699,4905,"Thierry Baudet (FvD)",0.935493688305502,0.52398248050422,0
"<anonymized_userid>",2,70701,4906,"Thierry Baudet (FvD)",0.935520152433377,0.524089306698002,0
"<anonymized_userid>",2,70703,4907,"Thierry Baudet (FvD)",0.935546616561251,0.524196132891785,0
"<anonymized_userid>",2,70705,4908,"Thierry Baudet (FvD)",0.935573080689126,0.524302959085568,0
"<anonymized_userid>",2,70707,4909,"Thierry Baudet (FvD)",0.935599544817001,0.52440978527935,0
"<anonymized_userid>",2,70709,4910,"Thierry Baudet (FvD)",0.935626008944875,0.524516611473133,0
"<anonymized_userid>",2,70711,4911,"Thierry Baudet (FvD)",0.93565247307275,0.524623437666916,0
"<anonymized_userid>",2,70713,4912,"Thierry Baudet (FvD)",0.935678937200625,0.524730263860699,0
"<anonymized_userid>",2,70715,4913,"Thierry Baudet (FvD)",0.935705401328499,0.524837090054481,0
"<anonymized_userid>",2,70717,4914,"Thierry Baudet (FvD)",0.935731865456374,0.524943916248264,0
"<anonymized_userid>",2,70719,4915,"Thierry Baudet (FvD)",0.935758329584249,0.525050742442047,0
"<anonymized_userid>",2,70721,4916,"Thierry Baudet (FvD)",0.935784793712123,0.52515756863583,0
"<anonymized_userid>",2,70723,4917,"Thierry Baudet (FvD)",0.935811257839998,0.525264394829612,0
"<anonymized_userid>",2,70725,4918,"Thierry Baudet (FvD)",0.935837721967873,0.525371221023395,0
"<anonymized_userid>",2,70727,4919,"Thierry Baudet (FvD)",0.935864186095747,0.525478047217178,0
"<anonymized_userid>",2,70729,4920,"Thierry Baudet (FvD)",0.935890650223622,0.52558487341096,0
"<anonymized_userid>",2,70731,4921,"Thierry Baudet (FvD)",0.935917114351496,0.525691699604743,0
"<anonymized_userid>",2,70733,4922,"Thierry Baudet (FvD)",0.935943578479371,0.525798525798526,0
"<anonymized_userid>",2,70735,4923,"Thierry Baudet (FvD)",0.935970042607246,0.525905351992308,0
"<anonymized_userid>",2,70737,4924,"Thierry Baudet (FvD)",0.935996506735121,0.526012178186091,0
"<anonymized_userid>",2,70739,4925,"Thierry Baudet (FvD)",0.936022970862995,0.526119004379874,0
"<anonymized_userid>",2,70741,4926,"Thierry Baudet (FvD)",0.93604943499087,0.526225830573657,0
"<anonymized_userid>",2,70743,4927,"Thierry Baudet (FvD)",0.936075899118745,0.526332656767439,0
"<anonymized_userid>",2,70745,4928,"Thierry Baudet (FvD)",0.936102363246619,0.526439482961222,0
"<anonymized_userid>",2,70747,4929,"Thierry Baudet (FvD)",0.936128827374494,0.526546309155005,0
"<anonymized_userid>",2,70749,4930,"Thierry Baudet (FvD)",0.936155291502369,0.526653135348788,0
"<anonymized_userid>",2,70751,4931,"Thierry Baudet (FvD)",0.936181755630243,0.52675996154257,0
"<anonymized_userid>",2,70753,4932,"Thierry Baudet (FvD)",0.936208219758118,0.526866787736353,0
"<anonymized_userid>",2,70755,4933,"Thierry Baudet (FvD)",0.936234683885993,0.526973613930136,0
"<anonymized_userid>",2,70757,4934,"Thierry Baudet (FvD)",0.936261148013867,0.527080440123918,0
"<anonymized_userid>",2,70759,4935,"Thierry Baudet (FvD)",0.936287612141742,0.527187266317701,0
"<anonymized_userid>",2,70761,4936,"Thierry Baudet (FvD)",0.936314076269616,0.527294092511484,0
"<anonymized_userid>",2,70763,4937,"Thierry Baudet (FvD)",0.936340540397491,0.527400918705267,0
"<anonymized_userid>",2,70765,4938,"Thierry Baudet (FvD)",0.936367004525366,0.527507744899049,0
"<anonymized_userid>",2,70767,4939,"Thierry Baudet (FvD)",0.936393468653241,0.527614571092832,0
"<anonymized_userid>",2,70769,4940,"Thierry Baudet (FvD)",0.936419932781115,0.527721397286615,0
"<anonymized_userid>",2,70771,4941,"Thierry Baudet (FvD)",0.93644639690899,0.527828223480397,0
"<anonymized_userid>",2,70773,4942,"Thierry Baudet (FvD)",0.936472861036865,0.52793504967418,0
"<anonymized_userid>",2,70775,4943,"Thierry Baudet (FvD)",0.936499325164739,0.528041875867963,0
"<anonymized_userid>",2,70777,4944,"Thierry Baudet (FvD)",0.936525789292614,0.528148702061746,0
"<anonymized_userid>",2,70779,4945,"Thierry Baudet (FvD)",0.936552253420489,0.528255528255528,0
"<anonymized_userid>",2,70781,4946,"Thierry Baudet (FvD)",0.936578717548363,0.528362354449311,0
"<anonymized_userid>",2,70783,4947,"Thierry Baudet (FvD)",0.936605181676238,0.528469180643094,0
"<anonymized_userid>",2,70785,4948,"Thierry Baudet (FvD)",0.936631645804113,0.528576006836876,0
"<anonymized_userid>",2,70787,4949,"Thierry Baudet (FvD)",0.936658109931987,0.528682833030659,0
"<anonymized_userid>",2,70789,4950,"Thierry Baudet (FvD)",0.936684574059862,0.528789659224442,0
"<anonymized_userid>",2,70791,4951,"Thierry Baudet (FvD)",0.936711038187736,0.528896485418225,0
"<anonymized_userid>",2,70793,4952,"Thierry Baudet (FvD)",0.936737502315611,0.529003311612007,0
"<anonymized_userid>",2,70795,4953,"Thierry Baudet (FvD)",0.936763966443486,0.52911013780579,0
"<anonymized_userid>",2,70797,4954,"Thierry Baudet (FvD)",0.93679043057136,0.529216963999573,0
"<anonymized_userid>",2,70799,4955,"Thierry Baudet (FvD)",0.936816894699235,0.529323790193355,0
"<anonymized_userid>",2,70801,4956,"Thierry Baudet (FvD)",0.93684335882711,0.529430616387138,0
"<anonymized_userid>",2,70803,4957,"Thierry Baudet (FvD)",0.936869822954985,0.529537442580921,0
"<anonymized_userid>",2,70805,4958,"Thierry Baudet (FvD)",0.936896287082859,0.529644268774704,0
"<anonymized_userid>",2,70807,4959,"Thierry Baudet (FvD)",0.936922751210734,0.529751094968486,0
"<anonymized_userid>",2,70809,4960,"Thierry Baudet (FvD)",0.936949215338609,0.529857921162269,0
"<anonymized_userid>",2,70811,4961,"Thierry Baudet (FvD)",0.936975679466483,0.529964747356052,0
"<anonymized_userid>",2,70813,4962,"Thierry Baudet (FvD)",0.937002143594358,0.530071573549834,0
"<anonymized_userid>",2,70815,4963,"Thierry Baudet (FvD)",0.937028607722233,0.530178399743617,0
"<anonymized_userid>",2,70817,4964,"Thierry Baudet (FvD)",0.937055071850107,0.5302852259374,0
"<anonymized_userid>",2,70819,4965,"Thierry Baudet (FvD)",0.937081535977982,0.530392052131183,0
"<anonymized_userid>",2,70821,4966,"Thierry Baudet (FvD)",0.937108000105856,0.530498878324965,0
"<anonymized_userid>",2,70823,4967,"Thierry Baudet (FvD)",0.937134464233731,0.530605704518748,0
"<anonymized_userid>",2,70825,4968,"Thierry Baudet (FvD)",0.937160928361606,0.530712530712531,0
"<anonymized_userid>",2,70827,4969,"Thierry Baudet (FvD)",0.93718739248948,0.530819356906313,0
"<anonymized_userid>",2,70829,4970,"Thierry Baudet (FvD)",0.937213856617355,0.530926183100096,0
"<anonymized_userid>",2,70831,4971,"Thierry Baudet (FvD)",0.93724032074523,0.531033009293879,0
"<anonymized_userid>",2,70833,4972,"Thierry Baudet (FvD)",0.937266784873105,0.531139835487662,0
"<anonymized_userid>",2,70835,4973,"Thierry Baudet (FvD)",0.937293249000979,0.531246661681444,0
"<anonymized_userid>",2,70837,4974,"Thierry Baudet (FvD)",0.937319713128854,0.531353487875227,0
"<anonymized_userid>",2,70839,4975,"Thierry Baudet (FvD)",0.937346177256729,0.53146031406901,0
"<anonymized_userid>",2,70841,4976,"Thierry Baudet (FvD)",0.937372641384603,0.531567140262792,0
"<anonymized_userid>",2,70843,4977,"Thierry Baudet (FvD)",0.937399105512478,0.531673966456575,0
"<anonymized_userid>",2,70845,4978,"Thierry Baudet (FvD)",0.937425569640353,0.531780792650358,0
"<anonymized_userid>",2,70847,4979,"Thierry Baudet (FvD)",0.937452033768227,0.531887618844141,0
"<anonymized_userid>",2,70849,4980,"Thierry Baudet (FvD)",0.937478497896102,0.531994445037923,0
"<anonymized_userid>",2,70851,4981,"Thierry Baudet (FvD)",0.937504962023976,0.532101271231706,0
"<anonymized_userid>",2,70853,4982,"Thierry Baudet (FvD)",0.937531426151851,0.532208097425489,0
"<anonymized_userid>",2,70855,4983,"Thierry Baudet (FvD)",0.937557890279726,0.532314923619271,0
"<anonymized_userid>",2,70857,4984,"Thierry Baudet (FvD)",0.9375843544076,0.532421749813054,0
"<anonymized_userid>",2,70859,4985,"Thierry Baudet (FvD)",0.937610818535475,0.532528576006837,0
"<anonymized_userid>",2,70861,4986,"Thierry Baudet (FvD)",0.93763728266335,0.53263540220062,0
"<anonymized_userid>",2,70863,4987,"Thierry Baudet (FvD)",0.937663746791225,0.532742228394402,0
"<anonymized_userid>",2,70865,4988,"Thierry Baudet (FvD)",0.937690210919099,0.532849054588185,0
"<anonymized_userid>",2,70867,4989,"Thierry Baudet (FvD)",0.937716675046974,0.532955880781968,0
"<anonymized_userid>",2,70869,4990,"Thierry Baudet (FvD)",0.937743139174849,0.53306270697575,0
"<anonymized_userid>",2,70871,4991,"Thierry Baudet (FvD)",0.937769603302723,0.533169533169533,0
"<anonymized_userid>",2,70873,4992,"Thierry Baudet (FvD)",0.937796067430598,0.533276359363316,0
"<anonymized_userid>",2,70875,4993,"Thierry Baudet (FvD)",0.937822531558473,0.533383185557099,0
"<anonymized_userid>",2,70877,4994,"Thierry Baudet (FvD)",0.937848995686347,0.533490011750881,0
"<anonymized_userid>",2,70879,4995,"Thierry Baudet (FvD)",0.937875459814222,0.533596837944664,0
"<anonymized_userid>",2,70881,4996,"Thierry Baudet (FvD)",0.937901923942096,0.533703664138447,0
"<anonymized_userid>",2,70883,4997,"Thierry Baudet (FvD)",0.937928388069971,0.533810490332229,0
"<anonymized_userid>",2,70885,4998,"Thierry Baudet (FvD)",0.937954852197846,0.533917316526012,0
"<anonymized_userid>",2,70887,4999,"Thierry Baudet (FvD)",0.93798131632572,0.534024142719795,0
"<anonymized_userid>",2,70889,5000,"Thierry Baudet (FvD)",0.938007780453595,0.534130968913578,0
"<anonymized_userid>",2,70891,5001,"Thierry Baudet (FvD)",0.93803424458147,0.53423779510736,0
"<anonymized_userid>",2,70893,5002,"Thierry Baudet (FvD)",0.938060708709344,0.534344621301143,0
"<anonymized_userid>",2,70895,5003,"Thierry Baudet (FvD)",0.938087172837219,0.534451447494926,0
"<anonymized_userid>",2,70897,5004,"Thierry Baudet (FvD)",0.938113636965094,0.534558273688708,0
"<anonymized_userid>",2,70899,5005,"Thierry Baudet (FvD)",0.938140101092969,0.534665099882491,0
"<anonymized_userid>",2,70901,5006,"Thierry Baudet (FvD)",0.938166565220843,0.534771926076274,0
"<anonymized_userid>",2,70903,5007,"Thierry Baudet (FvD)",0.938193029348718,0.534878752270057,0
"<anonymized_userid>",2,70905,5008,"Thierry Baudet (FvD)",0.938219493476593,0.534985578463839,0
"<anonymized_userid>",2,70907,5009,"Thierry Baudet (FvD)",0.938245957604467,0.535092404657622,0
"<anonymized_userid>",2,70909,5010,"Thierry Baudet (FvD)",0.938272421732342,0.535199230851405,0
"<anonymized_userid>",2,70911,5011,"Thierry Baudet (FvD)",0.938298885860216,0.535306057045188,0
"<anonymized_userid>",2,70913,5012,"Thierry Baudet (FvD)",0.938325349988091,0.53541288323897,0
"<anonymized_userid>",2,70915,5013,"Thierry Baudet (FvD)",0.938351814115966,0.535519709432753,0
"<anonymized_userid>",2,70917,5014,"Thierry Baudet (FvD)",0.93837827824384,0.535626535626536,0
"<anonymized_userid>",2,70919,5015,"Thierry Baudet (FvD)",0.938404742371715,0.535733361820318,0
"<anonymized_userid>",2,70921,5016,"Thierry Baudet (FvD)",0.93843120649959,0.535840188014101,0
"<anonymized_userid>",2,70923,5017,"Thierry Baudet (FvD)",0.938457670627464,0.535947014207884,0
"<anonymized_userid>",2,70925,5018,"Thierry Baudet (FvD)",0.938484134755339,0.536053840401666,0
"<anonymized_userid>",2,70927,5019,"Thierry Baudet (FvD)",0.938510598883214,0.536160666595449,0
"<anonymized_userid>",2,70929,5020,"Thierry Baudet (FvD)",0.938537063011089,0.536267492789232,0
"<anonymized_userid>",2,70931,5021,"Thierry Baudet (FvD)",0.938563527138963,0.536374318983015,0
"<anonymized_userid>",2,70933,5022,"Thierry Baudet (FvD)",0.938589991266838,0.536481145176797,0
"<anonymized_userid>",2,70935,5023,"Thierry Baudet (FvD)",0.938616455394713,0.53658797137058,0
"<anonymized_userid>",2,70937,5024,"Thierry Baudet (FvD)",0.938642919522587,0.536694797564363,0
"<anonymized_userid>",2,70939,5025,"Thierry Baudet (FvD)",0.938669383650462,0.536801623758146,0
"<anonymized_userid>",2,70941,5026,"Thierry Baudet (FvD)",0.938695847778336,0.536908449951928,0
"<anonymized_userid>",2,70943,5027,"Thierry Baudet (FvD)",0.938722311906211,0.537015276145711,0
"<anonymized_userid>",2,70945,5028,"Thierry Baudet (FvD)",0.938748776034086,0.537122102339494,0
"<anonymized_userid>",2,70947,5029,"Thierry Baudet (FvD)",0.93877524016196,0.537228928533276,0
"<anonymized_userid>",2,70949,5030,"Thierry Baudet (FvD)",0.938801704289835,0.537335754727059,0
"<anonymized_userid>",2,70951,5031,"Thierry Baudet (FvD)",0.93882816841771,0.537442580920842,0
"<anonymized_userid>",2,70953,5032,"Thierry Baudet (FvD)",0.938854632545584,0.537549407114625,0
"<anonymized_userid>",2,70955,5033,"Thierry Baudet (FvD)",0.938881096673459,0.537656233308407,0
"<anonymized_userid>",2,70957,5034,"Thierry Baudet (FvD)",0.938907560801334,0.53776305950219,0
"<anonymized_userid>",2,70959,5035,"Thierry Baudet (FvD)",0.938934024929208,0.537869885695973,0
"<anonymized_userid>",2,70961,5036,"Thierry Baudet (FvD)",0.938960489057083,0.537976711889755,0
"<anonymized_userid>",2,70963,5037,"Thierry Baudet (FvD)",0.938986953184958,0.538083538083538,0
"<anonymized_userid>",2,70965,5038,"Thierry Baudet (FvD)",0.939013417312832,0.538190364277321,0
"<anonymized_userid>",2,70967,5039,"Thierry Baudet (FvD)",0.939039881440707,0.538297190471103,0
"<anonymized_userid>",2,70969,5040,"Thierry Baudet (FvD)",0.939066345568582,0.538404016664886,0
"<anonymized_userid>",2,70971,5041,"Thierry Baudet (FvD)",0.939092809696456,0.538510842858669,0
"<anonymized_userid>",2,70973,5042,"Thierry Baudet (FvD)",0.939119273824331,0.538617669052452,0
"<anonymized_userid>",2,70975,5043,"Thierry Baudet (FvD)",0.939145737952206,0.538724495246234,0
"<anonymized_userid>",2,70977,5044,"Thierry Baudet (FvD)",0.93917220208008,0.538831321440017,0
"<anonymized_userid>",2,70979,5045,"Thierry Baudet (FvD)",0.939198666207955,0.5389381476338,0
"<anonymized_userid>",2,70981,5046,"Thierry Baudet (FvD)",0.93922513033583,0.539044973827583,0
"<anonymized_userid>",2,70983,5047,"Thierry Baudet (FvD)",0.939251594463704,0.539151800021365,0
"<anonymized_userid>",2,70985,5048,"Thierry Baudet (FvD)",0.939278058591579,0.539258626215148,0
"<anonymized_userid>",2,70987,5049,"Thierry Baudet (FvD)",0.939304522719454,0.539365452408931,0
"<anonymized_userid>",2,70989,5050,"Thierry Baudet (FvD)",0.939330986847328,0.539472278602713,0
"<anonymized_userid>",2,70991,5051,"Thierry Baudet (FvD)",0.939357450975203,0.539579104796496,0
"<anonymized_userid>",2,70993,5052,"Thierry Baudet (FvD)",0.939383915103078,0.539685930990279,0
"<anonymized_userid>",2,70995,5053,"Thierry Baudet (FvD)",0.939410379230952,0.539792757184062,0
"<anonymized_userid>",2,70997,5054,"Thierry Baudet (FvD)",0.939436843358827,0.539899583377844,0
"<anonymized_userid>",2,70999,5055,"Thierry Baudet (FvD)",0.939463307486702,0.540006409571627,0
"<anonymized_userid>",2,71001,5056,"Thierry Baudet (FvD)",0.939489771614576,0.54011323576541,0
"<anonymized_userid>",2,71003,5057,"Thierry Baudet (FvD)",0.939516235742451,0.540220061959192,0
"<anonymized_userid>",2,71005,5058,"Thierry Baudet (FvD)",0.939542699870326,0.540326888152975,0
"<anonymized_userid>",2,71007,5059,"Thierry Baudet (FvD)",0.9395691639982,0.540433714346758,0
"<anonymized_userid>",2,71009,5060,"Thierry Baudet (FvD)",0.939595628126075,0.540540540540541,0
"<anonymized_userid>",2,71011,5061,"Thierry Baudet (FvD)",0.93962209225395,0.540647366734323,0
"<anonymized_userid>",2,71013,5062,"Thierry Baudet (FvD)",0.939648556381824,0.540754192928106,0
"<anonymized_userid>",2,71015,5063,"Thierry Baudet (FvD)",0.939675020509699,0.540861019121889,0
"<anonymized_userid>",2,71017,5064,"Thierry Baudet (FvD)",0.939701484637574,0.540967845315671,0
"<anonymized_userid>",2,71019,5065,"Thierry Baudet (FvD)",0.939727948765448,0.541074671509454,0
"<anonymized_userid>",2,71021,5066,"Thierry Baudet (FvD)",0.939754412893323,0.541181497703237,0
"<anonymized_userid>",2,71023,5067,"Thierry Baudet (FvD)",0.939780877021198,0.54128832389702,0
"<anonymized_userid>",2,71025,5068,"Thierry Baudet (FvD)",0.939807341149072,0.541395150090802,0
"<anonymized_userid>",2,71027,5069,"Thierry Baudet (FvD)",0.939833805276947,0.541501976284585,0
"<anonymized_userid>",2,71029,5070,"Thierry Baudet (FvD)",0.939860269404822,0.541608802478368,0
"<anonymized_userid>",2,71031,5071,"Thierry Baudet (FvD)",0.939886733532696,0.54171562867215,0
"<anonymized_userid>",2,71033,5072,"Thierry Baudet (FvD)",0.939913197660571,0.541822454865933,0
"<anonymized_userid>",2,71035,5073,"Thierry Baudet (FvD)",0.939939661788446,0.541929281059716,0
"<anonymized_userid>",2,71037,5074,"Thierry Baudet (FvD)",0.93996612591632,0.542036107253499,0
"<anonymized_userid>",2,71039,5075,"Thierry Baudet (FvD)",0.939992590044195,0.542142933447281,0
"<anonymized_userid>",2,71041,5076,"Thierry Baudet (FvD)",0.94001905417207,0.542249759641064,0
"<anonymized_userid>",2,71043,5077,"Thierry Baudet (FvD)",0.940045518299944,0.542356585834847,0
"<anonymized_userid>",2,71045,5078,"Thierry Baudet (FvD)",0.940071982427819,0.542463412028629,0
"<anonymized_userid>",2,71047,5079,"Thierry Baudet (FvD)",0.940098446555694,0.542570238222412,0
"<anonymized_userid>",2,71049,5080,"Thierry Baudet (FvD)",0.940124910683568,0.542677064416195,0
"<anonymized_userid>",2,71051,5081,"Thierry Baudet (FvD)",0.940151374811443,0.542783890609978,0
"<anonymized_userid>",2,71053,5082,"Thierry Baudet (FvD)",0.940177838939318,0.54289071680376,0
"<anonymized_userid>",2,71055,5083,"Thierry Baudet (FvD)",0.940204303067192,0.542997542997543,0
"<anonymized_userid>",2,71057,5084,"Thierry Baudet (FvD)",0.940230767195067,0.543104369191326,0
"<anonymized_userid>",2,71059,5085,"Thierry Baudet (FvD)",0.940257231322942,0.543211195385108,0
"<anonymized_userid>",2,71061,5086,"Thierry Baudet (FvD)",0.940283695450816,0.543318021578891,0
"<anonymized_userid>",2,71063,5087,"Thierry Baudet (FvD)",0.940310159578691,0.543424847772674,0
"<anonymized_userid>",2,71065,5088,"Thierry Baudet (FvD)",0.940336623706566,0.543531673966457,0
"<anonymized_userid>",2,71067,5089,"Thierry Baudet (FvD)",0.94036308783444,0.543638500160239,0
"<anonymized_userid>",2,71069,5090,"Thierry Baudet (FvD)",0.940389551962315,0.543745326354022,0
"<anonymized_userid>",2,71071,5091,"Thierry Baudet (FvD)",0.94041601609019,0.543852152547805,0
"<anonymized_userid>",2,71073,5092,"Thierry Baudet (FvD)",0.940442480218064,0.543958978741587,0
"<anonymized_userid>",2,71075,5093,"Thierry Baudet (FvD)",0.940468944345939,0.54406580493537,0
"<anonymized_userid>",2,71077,5094,"Thierry Baudet (FvD)",0.940495408473814,0.544172631129153,0
"<anonymized_userid>",2,71079,5095,"Thierry Baudet (FvD)",0.940521872601688,0.544279457322936,0
"<anonymized_userid>",2,71081,5096,"Thierry Baudet (FvD)",0.940548336729563,0.544386283516718,0
"<anonymized_userid>",2,71083,5097,"Thierry Baudet (FvD)",0.940574800857438,0.544493109710501,0
"<anonymized_userid>",2,71085,5098,"Thierry Baudet (FvD)",0.940601264985312,0.544599935904284,0
"<anonymized_userid>",2,71087,5099,"Thierry Baudet (FvD)",0.940627729113187,0.544706762098066,0
"<anonymized_userid>",2,71089,5100,"Thierry Baudet (FvD)",0.940654193241062,0.544813588291849,0
"<anonymized_userid>",2,71091,5101,"Thierry Baudet (FvD)",0.940680657368936,0.544920414485632,0
"<anonymized_userid>",2,71093,5102,"Thierry Baudet (FvD)",0.940707121496811,0.545027240679415,0
"<anonymized_userid>",2,71095,5103,"Thierry Baudet (FvD)",0.940733585624686,0.545134066873197,0
"<anonymized_userid>",2,71097,5104,"Thierry Baudet (FvD)",0.94076004975256,0.54524089306698,0
"<anonymized_userid>",2,71099,5105,"Thierry Baudet (FvD)",0.940786513880435,0.545347719260763,0
"<anonymized_userid>",2,71101,5106,"Thierry Baudet (FvD)",0.94081297800831,0.545454545454545,0
"<anonymized_userid>",2,71103,5107,"Thierry Baudet (FvD)",0.940839442136184,0.545561371648328,0
"<anonymized_userid>",2,71105,5108,"Thierry Baudet (FvD)",0.940865906264059,0.545668197842111,0
"<anonymized_userid>",2,71107,5109,"Thierry Baudet (FvD)",0.940892370391934,0.545775024035894,0
"<anonymized_userid>",2,71109,5110,"Thierry Baudet (FvD)",0.940918834519808,0.545881850229676,0
"<anonymized_userid>",2,71111,5111,"Thierry Baudet (FvD)",0.940945298647683,0.545988676423459,0
"<anonymized_userid>",2,71113,5112,"Thierry Baudet (FvD)",0.940971762775558,0.546095502617242,0
"<anonymized_userid>",2,71115,5113,"Thierry Baudet (FvD)",0.940998226903432,0.546202328811024,0
"<anonymized_userid>",2,71117,5114,"Thierry Baudet (FvD)",0.941024691031307,0.546309155004807,0
"<anonymized_userid>",2,71119,5115,"Thierry Baudet (FvD)",0.941051155159182,0.54641598119859,0
"<anonymized_userid>",2,71121,5116,"Thierry Baudet (FvD)",0.941077619287056,0.546522807392373,0
"<anonymized_userid>",2,71123,5117,"Thierry Baudet (FvD)",0.941104083414931,0.546629633586155,0
"<anonymized_userid>",2,71125,5118,"Thierry Baudet (FvD)",0.941130547542806,0.546736459779938,0
"<anonymized_userid>",2,71127,5119,"Thierry Baudet (FvD)",0.94115701167068,0.546843285973721,0
"<anonymized_userid>",2,71129,5120,"Thierry Baudet (FvD)",0.941183475798555,0.546950112167503,0
"<anonymized_userid>",2,71131,5121,"Thierry Baudet (FvD)",0.94120993992643,0.547056938361286,0
"<anonymized_userid>",2,71133,5122,"Thierry Baudet (FvD)",0.941236404054304,0.547163764555069,0
"<anonymized_userid>",2,71135,5123,"Thierry Baudet (FvD)",0.941262868182179,0.547270590748852,0
"<anonymized_userid>",2,71137,5124,"Thierry Baudet (FvD)",0.941289332310054,0.547377416942634,0
"<anonymized_userid>",2,71139,5125,"Thierry Baudet (FvD)",0.941315796437928,0.547484243136417,0
"<anonymized_userid>",2,71141,5126,"Thierry Baudet (FvD)",0.941342260565803,0.5475910693302,0
"<anonymized_userid>",2,71143,5127,"Thierry Baudet (FvD)",0.941368724693678,0.547697895523983,0
"<anonymized_userid>",2,71145,5128,"Thierry Baudet (FvD)",0.941395188821552,0.547804721717765,0
"<anonymized_userid>",2,71147,5129,"Thierry Baudet (FvD)",0.941421652949427,0.547911547911548,0
"<anonymized_userid>",2,71149,5130,"Thierry Baudet (FvD)",0.941448117077302,0.548018374105331,0
"<anonymized_userid>",2,71151,5131,"Thierry Baudet (FvD)",0.941474581205176,0.548125200299113,0
"<anonymized_userid>",2,71153,5132,"Thierry Baudet (FvD)",0.941501045333051,0.548232026492896,0
"<anonymized_userid>",2,71155,5133,"Thierry Baudet (FvD)",0.941527509460926,0.548338852686679,0
"<anonymized_userid>",2,71157,5134,"Thierry Baudet (FvD)",0.9415539735888,0.548445678880461,0
"<anonymized_userid>",2,71159,5135,"Thierry Baudet (FvD)",0.941580437716675,0.548552505074244,0
"<anonymized_userid>",2,71161,5136,"Thierry Baudet (FvD)",0.94160690184455,0.548659331268027,0
"<anonymized_userid>",2,71163,5137,"Thierry Baudet (FvD)",0.941633365972424,0.54876615746181,0
"<anonymized_userid>",2,71165,5138,"Thierry Baudet (FvD)",0.941659830100299,0.548872983655592,0
"<anonymized_userid>",2,71167,5139,"Thierry Baudet (FvD)",0.941686294228174,0.548979809849375,0
"<anonymized_userid>",2,71169,5140,"Thierry Baudet (FvD)",0.941712758356048,0.549086636043158,0
"<anonymized_userid>",2,71171,5141,"Thierry Baudet (FvD)",0.941739222483923,0.549193462236941,0
"<anonymized_userid>",2,71173,5142,"Thierry Baudet (FvD)",0.941765686611798,0.549300288430723,0
"<anonymized_userid>",2,71175,5143,"Thierry Baudet (FvD)",0.941792150739672,0.549407114624506,0
"<anonymized_userid>",2,71177,5144,"Thierry Baudet (FvD)",0.941818614867547,0.549513940818289,0
"<anonymized_userid>",2,71179,5145,"Thierry Baudet (FvD)",0.941845078995422,0.549620767012071,0
"<anonymized_userid>",2,71181,5146,"Thierry Baudet (FvD)",0.941871543123296,0.549727593205854,0
"<anonymized_userid>",2,71183,5147,"Thierry Baudet (FvD)",0.941898007251171,0.549834419399637,0
"<anonymized_userid>",2,71185,5148,"Thierry Baudet (FvD)",0.941924471379046,0.54994124559342,0
"<anonymized_userid>",2,71187,5149,"Thierry Baudet (FvD)",0.94195093550692,0.550048071787202,0
"<anonymized_userid>",2,71189,5150,"Thierry Baudet (FvD)",0.941977399634795,0.550154897980985,0
"<anonymized_userid>",2,71191,5151,"Thierry Baudet (FvD)",0.94200386376267,0.550261724174768,0
"<anonymized_userid>",2,71193,5152,"Thierry Baudet (FvD)",0.942030327890544,0.55036855036855,0
"<anonymized_userid>",2,71195,5153,"Thierry Baudet (FvD)",0.942056792018419,0.550475376562333,0
"<anonymized_userid>",2,71197,5154,"Thierry Baudet (FvD)",0.942083256146294,0.550582202756116,0
"<anonymized_userid>",2,71199,5155,"Thierry Baudet (FvD)",0.942109720274168,0.550689028949898,0
"<anonymized_userid>",2,71201,5156,"Thierry Baudet (FvD)",0.942136184402043,0.550795855143681,0
"<anonymized_userid>",2,71203,5157,"Thierry Baudet (FvD)",0.942162648529918,0.550902681337464,0
"<anonymized_userid>",2,71205,5158,"Thierry Baudet (FvD)",0.942189112657792,0.551009507531247,0
"<anonymized_userid>",2,71207,5159,"Thierry Baudet (FvD)",0.942215576785667,0.551116333725029,0
"<anonymized_userid>",2,71209,5160,"Thierry Baudet (FvD)",0.942242040913542,0.551223159918812,0
"<anonymized_userid>",2,71211,5161,"Thierry Baudet (FvD)",0.942268505041416,0.551329986112595,0
"<anonymized_userid>",2,71213,5162,"Thierry Baudet (FvD)",0.942294969169291,0.551436812306378,0
"<anonymized_userid>",2,71215,5163,"Thierry Baudet (FvD)",0.942321433297166,0.55154363850016,0
"<anonymized_userid>",2,71217,5164,"Thierry Baudet (FvD)",0.94234789742504,0.551650464693943,0
"<anonymized_userid>",2,71219,5165,"Thierry Baudet (FvD)",0.942374361552915,0.551757290887726,0
"<anonymized_userid>",2,71221,5166,"Thierry Baudet (FvD)",0.94240082568079,0.551864117081508,0
"<anonymized_userid>",2,71223,5167,"Thierry Baudet (FvD)",0.942427289808664,0.551970943275291,0
"<anonymized_userid>",2,71225,5168,"Thierry Baudet (FvD)",0.942453753936539,0.552077769469074,0
"<anonymized_userid>",2,71227,5169,"Thierry Baudet (FvD)",0.942480218064414,0.552184595662856,0
"<anonymized_userid>",2,71229,5170,"Thierry Baudet (FvD)",0.942506682192288,0.552291421856639,0
"<anonymized_userid>",2,71231,5171,"Thierry Baudet (FvD)",0.942533146320163,0.552398248050422,0
"<anonymized_userid>",2,71233,5172,"Thierry Baudet (FvD)",0.942559610448038,0.552505074244205,0
"<anonymized_userid>",2,71235,5173,"Thierry Baudet (FvD)",0.942586074575912,0.552611900437987,0
"<anonymized_userid>",2,71237,5174,"Thierry Baudet (FvD)",0.942612538703787,0.55271872663177,0
"<anonymized_userid>",2,71239,5175,"Thierry Baudet (FvD)",0.942639002831662,0.552825552825553,0
"<anonymized_userid>",2,71241,5176,"Thierry Baudet (FvD)",0.942665466959536,0.552932379019336,0
"<anonymized_userid>",2,71243,5177,"Thierry Baudet (FvD)",0.942691931087411,0.553039205213118,0
"<anonymized_userid>",2,71245,5178,"Thierry Baudet (FvD)",0.942718395215286,0.553146031406901,0
"<anonymized_userid>",2,71247,5179,"Thierry Baudet (FvD)",0.94274485934316,0.553252857600684,0
"<anonymized_userid>",2,71249,5180,"Thierry Baudet (FvD)",0.942771323471035,0.553359683794466,0
"<anonymized_userid>",2,71251,5181,"Thierry Baudet (FvD)",0.94279778759891,0.553466509988249,0
"<anonymized_userid>",2,71253,5182,"Thierry Baudet (FvD)",0.942824251726784,0.553573336182032,0
"<anonymized_userid>",2,71255,5183,"Thierry Baudet (FvD)",0.942850715854659,0.553680162375815,0
"<anonymized_userid>",2,71257,5184,"Thierry Baudet (FvD)",0.942877179982534,0.553786988569597,0
"<anonymized_userid>",2,71259,5185,"Thierry Baudet (FvD)",0.942903644110408,0.55389381476338,0
"<anonymized_userid>",2,71261,5186,"Thierry Baudet (FvD)",0.942930108238283,0.554000640957163,0
"<anonymized_userid>",2,71263,5187,"Thierry Baudet (FvD)",0.942956572366158,0.554107467150945,0
"<anonymized_userid>",2,71265,5188,"Thierry Baudet (FvD)",0.942983036494032,0.554214293344728,0
"<anonymized_userid>",2,71267,5189,"Thierry Baudet (FvD)",0.943009500621907,0.554321119538511,0
"<anonymized_userid>",2,71269,5190,"Thierry Baudet (FvD)",0.943035964749782,0.554427945732294,0
"<anonymized_userid>",2,71271,5191,"Thierry Baudet (FvD)",0.943062428877656,0.554534771926076,0
"<anonymized_userid>",2,71273,5192,"Thierry Baudet (FvD)",0.943088893005531,0.554641598119859,0
"<anonymized_userid>",2,71275,5193,"Thierry Baudet (FvD)",0.943115357133406,0.554748424313642,0
"<anonymized_userid>",2,71277,5194,"Thierry Baudet (FvD)",0.94314182126128,0.554855250507424,0
"<anonymized_userid>",2,71279,5195,"Thierry Baudet (FvD)",0.943168285389155,0.554962076701207,0
"<anonymized_userid>",2,71281,5196,"Thierry Baudet (FvD)",0.94319474951703,0.55506890289499,0
"<anonymized_userid>",2,71283,5197,"Thierry Baudet (FvD)",0.943221213644904,0.555175729088773,0
"<anonymized_userid>",2,71285,5198,"Thierry Baudet (FvD)",0.943247677772779,0.555282555282555,0
"<anonymized_userid>",2,71287,5199,"Thierry Baudet (FvD)",0.943274141900654,0.555389381476338,0
"<anonymized_userid>",2,71289,5200,"Thierry Baudet (FvD)",0.943300606028528,0.555496207670121,0
"<anonymized_userid>",2,71291,5201,"Thierry Baudet (FvD)",0.943327070156403,0.555603033863903,0
"<anonymized_userid>",2,71293,5202,"Thierry Baudet (FvD)",0.943353534284278,0.555709860057686,0
"<anonymized_userid>",2,71295,5203,"Thierry Baudet (FvD)",0.943379998412152,0.555816686251469,0
"<anonymized_userid>",2,71297,5204,"Thierry Baudet (FvD)",0.943406462540027,0.555923512445252,0
"<anonymized_userid>",2,71299,5205,"Thierry Baudet (FvD)",0.943432926667902,0.556030338639034,0
"<anonymized_userid>",2,71301,5206,"Thierry Baudet (FvD)",0.943459390795776,0.556137164832817,0
"<anonymized_userid>",2,71303,5207,"Thierry Baudet (FvD)",0.943485854923651,0.5562439910266,0
"<anonymized_userid>",2,71305,5208,"Thierry Baudet (FvD)",0.943512319051526,0.556350817220382,0
"<anonymized_userid>",2,71307,5209,"Thierry Baudet (FvD)",0.9435387831794,0.556457643414165,0
"<anonymized_userid>",2,71309,5210,"Thierry Baudet (FvD)",0.943565247307275,0.556564469607948,0
"<anonymized_userid>",2,71311,5211,"Thierry Baudet (FvD)",0.94359171143515,0.556671295801731,0
"<anonymized_userid>",2,71313,5212,"Thierry Baudet (FvD)",0.943618175563024,0.556778121995513,0
"<anonymized_userid>",2,71315,5213,"Thierry Baudet (FvD)",0.943644639690899,0.556884948189296,0
"<anonymized_userid>",2,71317,5214,"Thierry Baudet (FvD)",0.943671103818774,0.556991774383079,0
"<anonymized_userid>",2,71319,5215,"Thierry Baudet (FvD)",0.943697567946648,0.557098600576861,0
"<anonymized_userid>",2,71321,5216,"Thierry Baudet (FvD)",0.943724032074523,0.557205426770644,0
"<anonymized_userid>",2,71323,5217,"Thierry Baudet (FvD)",0.943750496202398,0.557312252964427,0
"<anonymized_userid>",2,71325,5218,"Thierry Baudet (FvD)",0.943776960330272,0.55741907915821,0
"<anonymized_userid>",2,71327,5219,"Thierry Baudet (FvD)",0.943803424458147,0.557525905351992,0
"<anonymized_userid>",2,71329,5220,"Thierry Baudet (FvD)",0.943829888586022,0.557632731545775,0
"<anonymized_userid>",2,71331,5221,"Thierry Baudet (FvD)",0.943856352713896,0.557739557739558,0
"<anonymized_userid>",2,71333,5222,"Thierry Baudet (FvD)",0.943882816841771,0.55784638393334,0
"<anonymized_userid>",2,71335,5223,"Thierry Baudet (FvD)",0.943909280969646,0.557953210127123,0
"<anonymized_userid>",2,71337,5224,"Thierry Baudet (FvD)",0.94393574509752,0.558060036320906,0
"<anonymized_userid>",2,71339,5225,"Thierry Baudet (FvD)",0.943962209225395,0.558166862514689,0
"<anonymized_userid>",2,71341,5226,"Thierry Baudet (FvD)",0.94398867335327,0.558273688708471,0
"<anonymized_userid>",2,71343,5227,"Thierry Baudet (FvD)",0.944015137481144,0.558380514902254,0
"<anonymized_userid>",2,71345,5228,"Thierry Baudet (FvD)",0.944041601609019,0.558487341096037,0
"<anonymized_userid>",2,71347,5229,"Thierry Baudet (FvD)",0.944068065736894,0.558594167289819,0
"<anonymized_userid>",2,71349,5230,"Thierry Baudet (FvD)",0.944094529864768,0.558700993483602,0
"<anonymized_userid>",2,71351,5231,"Thierry Baudet (FvD)",0.944120993992643,0.558807819677385,0
"<anonymized_userid>",2,71353,5232,"Thierry Baudet (FvD)",0.944147458120518,0.558914645871168,0
"<anonymized_userid>",2,71355,5233,"Thierry Baudet (FvD)",0.944173922248392,0.55902147206495,0
"<anonymized_userid>",2,71357,5234,"Thierry Baudet (FvD)",0.944200386376267,0.559128298258733,0
"<anonymized_userid>",2,71359,5235,"Thierry Baudet (FvD)",0.944226850504142,0.559235124452516,0
"<anonymized_userid>",2,71361,5236,"Thierry Baudet (FvD)",0.944253314632016,0.559341950646298,0
"<anonymized_userid>",2,71363,5237,"Thierry Baudet (FvD)",0.944279778759891,0.559448776840081,0
"<anonymized_userid>",2,71365,5238,"Thierry Baudet (FvD)",0.944306242887766,0.559555603033864,0
"<anonymized_userid>",2,71367,5239,"Thierry Baudet (FvD)",0.94433270701564,0.559662429227647,0
"<anonymized_userid>",2,71369,5240,"Thierry Baudet (FvD)",0.944359171143515,0.559769255421429,0
"<anonymized_userid>",2,71371,5241,"Thierry Baudet (FvD)",0.94438563527139,0.559876081615212,0
"<anonymized_userid>",2,71373,5242,"Thierry Baudet (FvD)",0.944412099399264,0.559982907808995,0
"<anonymized_userid>",2,71375,5243,"Thierry Baudet (FvD)",0.944438563527139,0.560089734002778,0
"<anonymized_userid>",2,71377,5244,"Thierry Baudet (FvD)",0.944465027655014,0.56019656019656,0
"<anonymized_userid>",2,71379,5245,"Thierry Baudet (FvD)",0.944491491782888,0.560303386390343,0
"<anonymized_userid>",2,71381,5246,"Thierry Baudet (FvD)",0.944517955910763,0.560410212584126,0
"<anonymized_userid>",2,71383,5247,"Thierry Baudet (FvD)",0.944544420038638,0.560517038777908,0
"<anonymized_userid>",2,71385,5248,"Thierry Baudet (FvD)",0.944570884166512,0.560623864971691,0
"<anonymized_userid>",2,71387,5249,"Thierry Baudet (FvD)",0.944597348294387,0.560730691165474,0
"<anonymized_userid>",2,71389,5250,"Thierry Baudet (FvD)",0.944623812422262,0.560837517359256,0
"<anonymized_userid>",2,71391,5251,"Thierry Baudet (FvD)",0.944650276550136,0.560944343553039,0
"<anonymized_userid>",2,71393,5252,"Thierry Baudet (FvD)",0.944676740678011,0.561051169746822,0
"<anonymized_userid>",2,71395,5253,"Thierry Baudet (FvD)",0.944703204805886,0.561157995940605,0
"<anonymized_userid>",2,71397,5254,"Thierry Baudet (FvD)",0.94472966893376,0.561264822134387,0
"<anonymized_userid>",2,71399,5255,"Thierry Baudet (FvD)",0.944756133061635,0.56137164832817,0
"<anonymized_userid>",2,71401,5256,"Thierry Baudet (FvD)",0.94478259718951,0.561478474521953,0
"<anonymized_userid>",2,71403,5257,"Thierry Baudet (FvD)",0.944809061317384,0.561585300715736,0
"<anonymized_userid>",2,71405,5258,"Thierry Baudet (FvD)",0.944835525445259,0.561692126909518,0
"<anonymized_userid>",2,71407,5259,"Thierry Baudet (FvD)",0.944861989573134,0.561798953103301,0
"<anonymized_userid>",2,71409,5260,"Thierry Baudet (FvD)",0.944888453701008,0.561905779297084,0
"<anonymized_userid>",2,71411,5261,"Thierry Baudet (FvD)",0.944914917828883,0.562012605490866,0
"<anonymized_userid>",2,71413,5262,"Thierry Baudet (FvD)",0.944941381956758,0.562119431684649,0
"<anonymized_userid>",2,71415,5263,"Thierry Baudet (FvD)",0.944967846084632,0.562226257878432,0
"<anonymized_userid>",2,71417,5264,"Thierry Baudet (FvD)",0.944994310212507,0.562333084072214,0
"<anonymized_userid>",2,71419,5265,"Thierry Baudet (FvD)",0.945020774340382,0.562439910265997,0
"<anonymized_userid>",2,71421,5266,"Thierry Baudet (FvD)",0.945047238468256,0.56254673645978,0
"<anonymized_userid>",2,71423,5267,"Thierry Baudet (FvD)",0.945073702596131,0.562653562653563,0
"<anonymized_userid>",2,71425,5268,"Thierry Baudet (FvD)",0.945100166724006,0.562760388847345,0
"<anonymized_userid>",2,71427,5269,"Thierry Baudet (FvD)",0.94512663085188,0.562867215041128,0
"<anonymized_userid>",2,71429,5270,"Thierry Baudet (FvD)",0.945153094979755,0.562974041234911,0
"<anonymized_userid>",2,71431,5271,"Thierry Baudet (FvD)",0.94517955910763,0.563080867428694,0
"<anonymized_userid>",2,71433,5272,"Thierry Baudet (FvD)",0.945206023235504,0.563187693622476,0
"<anonymized_userid>",2,71435,5273,"Thierry Baudet (FvD)",0.945232487363379,0.563294519816259,0
"<anonymized_userid>",2,71437,5274,"Thierry Baudet (FvD)",0.945258951491254,0.563401346010042,0
"<anonymized_userid>",2,71439,5275,"Thierry Baudet (FvD)",0.945285415619128,0.563508172203824,0
"<anonymized_userid>",2,71441,5276,"Thierry Baudet (FvD)",0.945311879747003,0.563614998397607,0
"<anonymized_userid>",2,71443,5277,"Thierry Baudet (FvD)",0.945338343874878,0.56372182459139,0
"<anonymized_userid>",2,71445,5278,"Thierry Baudet (FvD)",0.945364808002752,0.563828650785173,0
"<anonymized_userid>",2,71447,5279,"Thierry Baudet (FvD)",0.945391272130627,0.563935476978955,0
"<anonymized_userid>",2,71449,5280,"Thierry Baudet (FvD)",0.945417736258502,0.564042303172738,0
"<anonymized_userid>",2,71451,5281,"Thierry Baudet (FvD)",0.945444200386376,0.564149129366521,0
"<anonymized_userid>",2,71453,5282,"Thierry Baudet (FvD)",0.945470664514251,0.564255955560303,0
"<anonymized_userid>",2,71455,5283,"Thierry Baudet (FvD)",0.945497128642126,0.564362781754086,0
"<anonymized_userid>",2,71457,5284,"Thierry Baudet (FvD)",0.94552359277,0.564469607947869,0
"<anonymized_userid>",2,71459,5285,"Thierry Baudet (FvD)",0.945550056897875,0.564576434141651,0
"<anonymized_userid>",2,71461,5286,"Thierry Baudet (FvD)",0.94557652102575,0.564683260335434,0
"<anonymized_userid>",2,71463,5287,"Thierry Baudet (FvD)",0.945602985153624,0.564790086529217,0
"<anonymized_userid>",2,71465,5288,"Thierry Baudet (FvD)",0.945629449281499,0.564896912723,0
"<anonymized_userid>",2,71467,5289,"Thierry Baudet (FvD)",0.945655913409374,0.565003738916782,0
"<anonymized_userid>",2,71469,5290,"Thierry Baudet (FvD)",0.945682377537248,0.565110565110565,0
"<anonymized_userid>",2,71471,5291,"Thierry Baudet (FvD)",0.945708841665123,0.565217391304348,0
"<anonymized_userid>",2,71473,5292,"Thierry Baudet (FvD)",0.945735305792998,0.565324217498131,0
"<anonymized_userid>",2,71475,5293,"Thierry Baudet (FvD)",0.945761769920872,0.565431043691913,0
"<anonymized_userid>",2,71477,5294,"Thierry Baudet (FvD)",0.945788234048747,0.565537869885696,0
"<anonymized_userid>",2,71479,5295,"Thierry Baudet (FvD)",0.945814698176622,0.565644696079479,0
"<anonymized_userid>",2,71481,5296,"Thierry Baudet (FvD)",0.945841162304496,0.565751522273261,0
"<anonymized_userid>",2,71483,5297,"Thierry Baudet (FvD)",0.945867626432371,0.565858348467044,0
"<anonymized_userid>",2,71485,5298,"Thierry Baudet (FvD)",0.945894090560246,0.565965174660827,0
"<anonymized_userid>",2,71487,5299,"Thierry Baudet (FvD)",0.94592055468812,0.56607200085461,0
"<anonymized_userid>",2,71489,5300,"Thierry Baudet (FvD)",0.945947018815995,0.566178827048392,0
"<anonymized_userid>",2,71491,5301,"Thierry Baudet (FvD)",0.94597348294387,0.566285653242175,0
"<anonymized_userid>",2,71493,5302,"Thierry Baudet (FvD)",0.945999947071744,0.566392479435958,0
"<anonymized_userid>",2,71495,5303,"Thierry Baudet (FvD)",0.946026411199619,0.56649930562974,0
"<anonymized_userid>",2,71497,5304,"Thierry Baudet (FvD)",0.946052875327494,0.566606131823523,0
"<anonymized_userid>",2,71499,5305,"Thierry Baudet (FvD)",0.946079339455368,0.566712958017306,0
"<anonymized_userid>",2,71501,5306,"Thierry Baudet (FvD)",0.946105803583243,0.566819784211089,0
"<anonymized_userid>",2,71503,5307,"Thierry Baudet (FvD)",0.946132267711118,0.566926610404871,0
"<anonymized_userid>",2,71505,5308,"Thierry Baudet (FvD)",0.946158731838992,0.567033436598654,0
"<anonymized_userid>",2,71507,5309,"Thierry Baudet (FvD)",0.946185195966867,0.567140262792437,0
"<anonymized_userid>",2,71509,5310,"Thierry Baudet (FvD)",0.946211660094742,0.567247088986219,0
"<anonymized_userid>",2,71511,5311,"Thierry Baudet (FvD)",0.946238124222616,0.567353915180002,0
"<anonymized_userid>",2,71513,5312,"Thierry Baudet (FvD)",0.946264588350491,0.567460741373785,0
"<anonymized_userid>",2,71515,5313,"Thierry Baudet (FvD)",0.946291052478366,0.567567567567568,0
"<anonymized_userid>",2,71517,5314,"Thierry Baudet (FvD)",0.94631751660624,0.56767439376135,0
"<anonymized_userid>",2,71519,5315,"Thierry Baudet (FvD)",0.946343980734115,0.567781219955133,0
"<anonymized_userid>",2,71521,5316,"Thierry Baudet (FvD)",0.94637044486199,0.567888046148916,0
"<anonymized_userid>",2,71523,5317,"Thierry Baudet (FvD)",0.946396908989864,0.567994872342698,0
"<anonymized_userid>",2,71525,5318,"Thierry Baudet (FvD)",0.946423373117739,0.568101698536481,0
"<anonymized_userid>",2,71527,5319,"Thierry Baudet (FvD)",0.946449837245614,0.568208524730264,0
"<anonymized_userid>",2,71529,5320,"Thierry Baudet (FvD)",0.946476301373488,0.568315350924047,0
"<anonymized_userid>",2,71531,5321,"Thierry Baudet (FvD)",0.946502765501363,0.568422177117829,0
"<anonymized_userid>",2,71533,5322,"Thierry Baudet (FvD)",0.946529229629238,0.568529003311612,0
"<anonymized_userid>",2,71535,5323,"Thierry Baudet (FvD)",0.946555693757112,0.568635829505395,0
"<anonymized_userid>",2,71537,5324,"Thierry Baudet (FvD)",0.946582157884987,0.568742655699177,0
"<anonymized_userid>",1,71538,5325,"Thierry Baudet (FvD)",0.946595389948924,0.56884948189296,0
"<anonymized_userid>",1,71539,5326,"Thierry Baudet (FvD)",0.946608622012862,0.568956308086743,0
"<anonymized_userid>",1,71540,5327,"Thierry Baudet (FvD)",0.946621854076799,0.569063134280526,0
"<anonymized_userid>",1,71541,5328,"Thierry Baudet (FvD)",0.946635086140736,0.569169960474308,0
"<anonymized_userid>",1,71542,5329,"Thierry Baudet (FvD)",0.946648318204674,0.569276786668091,0
"<anonymized_userid>",1,71543,5330,"Thierry Baudet (FvD)",0.946661550268611,0.569383612861874,0
"<anonymized_userid>",1,71544,5331,"Thierry Baudet (FvD)",0.946674782332548,0.569490439055656,0
"<anonymized_userid>",1,71545,5332,"Thierry Baudet (FvD)",0.946688014396486,0.569597265249439,0
"<anonymized_userid>",1,71546,5333,"Thierry Baudet (FvD)",0.946701246460423,0.569704091443222,0
"<anonymized_userid>",1,71547,5334,"Thierry Baudet (FvD)",0.94671447852436,0.569810917637005,0
"<anonymized_userid>",1,71548,5335,"Thierry Baudet (FvD)",0.946727710588298,0.569917743830787,0
"<anonymized_userid>",1,71549,5336,"Thierry Baudet (FvD)",0.946740942652235,0.57002457002457,0
"<anonymized_userid>",1,71550,5337,"Thierry Baudet (FvD)",0.946754174716172,0.570131396218353,0
"<anonymized_userid>",1,71551,5338,"Thierry Baudet (FvD)",0.94676740678011,0.570238222412136,0
"<anonymized_userid>",1,71552,5339,"Thierry Baudet (FvD)",0.946780638844047,0.570345048605918,0
"<anonymized_userid>",1,71553,5340,"Thierry Baudet (FvD)",0.946793870907984,0.570451874799701,0
"<anonymized_userid>",1,71554,5341,"Thierry Baudet (FvD)",0.946807102971922,0.570558700993484,0
"<anonymized_userid>",1,71555,5342,"Thierry Baudet (FvD)",0.946820335035859,0.570665527187266,0
"<anonymized_userid>",1,71556,5343,"Thierry Baudet (FvD)",0.946833567099796,0.570772353381049,0
"<anonymized_userid>",1,71557,5344,"Thierry Baudet (FvD)",0.946846799163734,0.570879179574832,0
"<anonymized_userid>",1,71558,5345,"Thierry Baudet (FvD)",0.946860031227671,0.570986005768614,0
"<anonymized_userid>",1,71559,5346,"Thierry Baudet (FvD)",0.946873263291608,0.571092831962397,0
"<anonymized_userid>",1,71560,5347,"Thierry Baudet (FvD)",0.946886495355546,0.57119965815618,0
"<anonymized_userid>",1,71561,5348,"Thierry Baudet (FvD)",0.946899727419483,0.571306484349963,0
"<anonymized_userid>",1,71562,5349,"Thierry Baudet (FvD)",0.94691295948342,0.571413310543745,0
"<anonymized_userid>",1,71563,5350,"Thierry Baudet (FvD)",0.946926191547358,0.571520136737528,0
"<anonymized_userid>",1,71564,5351,"Thierry Baudet (FvD)",0.946939423611295,0.571626962931311,0
"<anonymized_userid>",1,71565,5352,"Thierry Baudet (FvD)",0.946952655675232,0.571733789125093,0
"<anonymized_userid>",1,71566,5353,"Thierry Baudet (FvD)",0.94696588773917,0.571840615318876,0
"<anonymized_userid>",1,71567,5354,"Thierry Baudet (FvD)",0.946979119803107,0.571947441512659,0
"<anonymized_userid>",1,71568,5355,"Thierry Baudet (FvD)",0.946992351867044,0.572054267706442,0
"<anonymized_userid>",1,71569,5356,"Thierry Baudet (FvD)",0.947005583930982,0.572161093900224,0
"<anonymized_userid>",1,71570,5357,"Thierry Baudet (FvD)",0.947018815994919,0.572267920094007,0
"<anonymized_userid>",1,71571,5358,"Thierry Baudet (FvD)",0.947032048058856,0.57237474628779,0
"<anonymized_userid>",1,71572,5359,"Thierry Baudet (FvD)",0.947045280122794,0.572481572481572,0
"<anonymized_userid>",1,71573,5360,"Thierry Baudet (FvD)",0.947058512186731,0.572588398675355,0
"<anonymized_userid>",1,71574,5361,"Thierry Baudet (FvD)",0.947071744250668,0.572695224869138,0
"<anonymized_userid>",1,71575,5362,"Thierry Baudet (FvD)",0.947084976314606,0.572802051062921,0
"<anonymized_userid>",1,71576,5363,"Thierry Baudet (FvD)",0.947098208378543,0.572908877256703,0
"<anonymized_userid>",1,71577,5364,"Thierry Baudet (FvD)",0.94711144044248,0.573015703450486,0
"<anonymized_userid>",1,71578,5365,"Thierry Baudet (FvD)",0.947124672506418,0.573122529644269,0
"<anonymized_userid>",1,71579,5366,"Thierry Baudet (FvD)",0.947137904570355,0.573229355838051,0
"<anonymized_userid>",1,71580,5367,"Thierry Baudet (FvD)",0.947151136634292,0.573336182031834,0
"<anonymized_userid>",1,71581,5368,"Thierry Baudet (FvD)",0.94716436869823,0.573443008225617,0
"<anonymized_userid>",1,71582,5369,"Thierry Baudet (FvD)",0.947177600762167,0.5735498344194,0
"<anonymized_userid>",1,71583,5370,"Thierry Baudet (FvD)",0.947190832826104,0.573656660613182,0
"<anonymized_userid>",1,71584,5371,"Thierry Baudet (FvD)",0.947204064890041,0.573763486806965,0
"<anonymized_userid>",1,71585,5372,"Thierry Baudet (FvD)",0.947217296953979,0.573870313000748,0
"<anonymized_userid>",1,71586,5373,"Thierry Baudet (FvD)",0.947230529017916,0.573977139194531,0
"<anonymized_userid>",1,71587,5374,"Thierry Baudet (FvD)",0.947243761081854,0.574083965388313,0
"<anonymized_userid>",1,71588,5375,"Thierry Baudet (FvD)",0.947256993145791,0.574190791582096,0
"<anonymized_userid>",1,71589,5376,"Thierry Baudet (FvD)",0.947270225209728,0.574297617775879,0
"<anonymized_userid>",1,71590,5377,"Thierry Baudet (FvD)",0.947283457273666,0.574404443969661,0
"<anonymized_userid>",1,71591,5378,"Thierry Baudet (FvD)",0.947296689337603,0.574511270163444,0
"<anonymized_userid>",1,71592,5379,"Thierry Baudet (FvD)",0.94730992140154,0.574618096357227,0
"<anonymized_userid>",1,71593,5380,"Thierry Baudet (FvD)",0.947323153465478,0.574724922551009,0
"<anonymized_userid>",1,71594,5381,"Thierry Baudet (FvD)",0.947336385529415,0.574831748744792,0
"<anonymized_userid>",1,71595,5382,"Thierry Baudet (FvD)",0.947349617593352,0.574938574938575,0
"<anonymized_userid>",1,71596,5383,"Thierry Baudet (FvD)",0.94736284965729,0.575045401132358,0
"<anonymized_userid>",1,71597,5384,"Thierry Baudet (FvD)",0.947376081721227,0.57515222732614,0
"<anonymized_userid>",1,71598,5385,"Thierry Baudet (FvD)",0.947389313785164,0.575259053519923,0
"<anonymized_userid>",1,71599,5386,"Thierry Baudet (FvD)",0.947402545849102,0.575365879713706,0
"<anonymized_userid>",1,71600,5387,"Thierry Baudet (FvD)",0.947415777913039,0.575472705907489,0
"<anonymized_userid>",1,71601,5388,"Thierry Baudet (FvD)",0.947429009976976,0.575579532101271,0
"<anonymized_userid>",1,71602,5389,"Thierry Baudet (FvD)",0.947442242040914,0.575686358295054,0
"<anonymized_userid>",1,71603,5390,"Thierry Baudet (FvD)",0.947455474104851,0.575793184488837,0
"<anonymized_userid>",1,71604,5391,"Thierry Baudet (FvD)",0.947468706168788,0.575900010682619,0
"<anonymized_userid>",1,71605,5392,"Thierry Baudet (FvD)",0.947481938232726,0.576006836876402,0
"<anonymized_userid>",1,71606,5393,"Thierry Baudet (FvD)",0.947495170296663,0.576113663070185,0
"<anonymized_userid>",1,71607,5394,"Thierry Baudet (FvD)",0.9475084023606,0.576220489263968,0
"<anonymized_userid>",1,71608,5395,"Thierry Baudet (FvD)",0.947521634424538,0.57632731545775,0
"<anonymized_userid>",1,71609,5396,"Thierry Baudet (FvD)",0.947534866488475,0.576434141651533,0
"<anonymized_userid>",1,71610,5397,"Thierry Baudet (FvD)",0.947548098552412,0.576540967845316,0
"<anonymized_userid>",1,71611,5398,"Thierry Baudet (FvD)",0.94756133061635,0.576647794039098,0
"<anonymized_userid>",1,71612,5399,"Thierry Baudet (FvD)",0.947574562680287,0.576754620232881,0
"<anonymized_userid>",1,71613,5400,"Thierry Baudet (FvD)",0.947587794744224,0.576861446426664,0
"<anonymized_userid>",1,71614,5401,"Thierry Baudet (FvD)",0.947601026808161,0.576968272620447,0
"<anonymized_userid>",1,71615,5402,"Thierry Baudet (FvD)",0.947614258872099,0.577075098814229,0
"<anonymized_userid>",1,71616,5403,"Thierry Baudet (FvD)",0.947627490936036,0.577181925008012,0
"<anonymized_userid>",1,71617,5404,"Thierry Baudet (FvD)",0.947640722999973,0.577288751201795,0
"<anonymized_userid>",1,71618,5405,"Thierry Baudet (FvD)",0.947653955063911,0.577395577395577,0
"<anonymized_userid>",1,71619,5406,"Thierry Baudet (FvD)",0.947667187127848,0.57750240358936,0
"<anonymized_userid>",1,71620,5407,"Thierry Baudet (FvD)",0.947680419191786,0.577609229783143,0
"<anonymized_userid>",1,71621,5408,"Thierry Baudet (FvD)",0.947693651255723,0.577716055976926,0
"<anonymized_userid>",1,71622,5409,"Thierry Baudet (FvD)",0.94770688331966,0.577822882170708,0
"<anonymized_userid>",1,71623,5410,"Thierry Baudet (FvD)",0.947720115383598,0.577929708364491,0
"<anonymized_userid>",1,71624,5411,"Thierry Baudet (FvD)",0.947733347447535,0.578036534558274,0
"<anonymized_userid>",1,71625,5412,"Thierry Baudet (FvD)",0.947746579511472,0.578143360752056,0
"<anonymized_userid>",1,71626,5413,"Thierry Baudet (FvD)",0.94775981157541,0.578250186945839,0
"<anonymized_userid>",1,71627,5414,"Thierry Baudet (FvD)",0.947773043639347,0.578357013139622,0
"<anonymized_userid>",1,71628,5415,"Thierry Baudet (FvD)",0.947786275703284,0.578463839333405,0
"<anonymized_userid>",1,71629,5416,"Thierry Baudet (FvD)",0.947799507767222,0.578570665527187,0
"<anonymized_userid>",1,71630,5417,"Thierry Baudet (FvD)",0.947812739831159,0.57867749172097,0
"<anonymized_userid>",1,71631,5418,"Thierry Baudet (FvD)",0.947825971895096,0.578784317914753,0
"<anonymized_userid>",1,71632,5419,"Thierry Baudet (FvD)",0.947839203959034,0.578891144108535,0
"<anonymized_userid>",1,71633,5420,"Thierry Baudet (FvD)",0.947852436022971,0.578997970302318,0
"<anonymized_userid>",1,71634,5421,"Thierry Baudet (FvD)",0.947865668086908,0.579104796496101,0
"<anonymized_userid>",1,71635,5422,"Thierry Baudet (FvD)",0.947878900150846,0.579211622689884,0
"<anonymized_userid>",1,71636,5423,"Thierry Baudet (FvD)",0.947892132214783,0.579318448883666,0
"<anonymized_userid>",1,71637,5424,"Thierry Baudet (FvD)",0.94790536427872,0.579425275077449,0
"<anonymized_userid>",1,71638,5425,"Thierry Baudet (FvD)",0.947918596342658,0.579532101271232,0
"<anonymized_userid>",1,71639,5426,"Thierry Baudet (FvD)",0.947931828406595,0.579638927465014,0
"<anonymized_userid>",1,71640,5427,"Thierry Baudet (FvD)",0.947945060470532,0.579745753658797,0
"<anonymized_userid>",1,71641,5428,"Thierry Baudet (FvD)",0.94795829253447,0.57985257985258,0
"<anonymized_userid>",1,71642,5429,"Thierry Baudet (FvD)",0.947971524598407,0.579959406046363,0
"<anonymized_userid>",1,71643,5430,"Thierry Baudet (FvD)",0.947984756662344,0.580066232240145,0
"<anonymized_userid>",1,71644,5431,"Thierry Baudet (FvD)",0.947997988726281,0.580173058433928,0
"<anonymized_userid>",1,71645,5432,"Thierry Baudet (FvD)",0.948011220790219,0.580279884627711,0
"<anonymized_userid>",1,71646,5433,"Thierry Baudet (FvD)",0.948024452854156,0.580386710821493,0
"<anonymized_userid>",1,71647,5434,"Thierry Baudet (FvD)",0.948037684918093,0.580493537015276,0
"<anonymized_userid>",1,71648,5435,"Thierry Baudet (FvD)",0.948050916982031,0.580600363209059,0
"<anonymized_userid>",1,71649,5436,"Thierry Baudet (FvD)",0.948064149045968,0.580707189402842,0
"<anonymized_userid>",1,71650,5437,"Thierry Baudet (FvD)",0.948077381109905,0.580814015596624,0
"<anonymized_userid>",1,71651,5438,"Thierry Baudet (FvD)",0.948090613173843,0.580920841790407,0
"<anonymized_userid>",1,71652,5439,"Thierry Baudet (FvD)",0.94810384523778,0.58102766798419,0
"<anonymized_userid>",1,71653,5440,"Thierry Baudet (FvD)",0.948117077301718,0.581134494177972,0
"<anonymized_userid>",1,71654,5441,"Thierry Baudet (FvD)",0.948130309365655,0.581241320371755,0
"<anonymized_userid>",1,71655,5442,"Thierry Baudet (FvD)",0.948143541429592,0.581348146565538,0
"<anonymized_userid>",1,71656,5443,"Thierry Baudet (FvD)",0.94815677349353,0.581454972759321,0
"<anonymized_userid>",1,71657,5444,"Thierry Baudet (FvD)",0.948170005557467,0.581561798953103,0
"<anonymized_userid>",1,71658,5445,"Thierry Baudet (FvD)",0.948183237621404,0.581668625146886,0
"<anonymized_userid>",1,71659,5446,"Thierry Baudet (FvD)",0.948196469685342,0.581775451340669,0
"<anonymized_userid>",1,71660,5447,"Thierry Baudet (FvD)",0.948209701749279,0.581882277534451,0
"<anonymized_userid>",1,71661,5448,"Thierry Baudet (FvD)",0.948222933813216,0.581989103728234,0
"<anonymized_userid>",1,71662,5449,"Thierry Baudet (FvD)",0.948236165877154,0.582095929922017,0
"<anonymized_userid>",1,71663,5450,"Thierry Baudet (FvD)",0.948249397941091,0.5822027561158,0
"<anonymized_userid>",1,71664,5451,"Thierry Baudet (FvD)",0.948262630005028,0.582309582309582,0
"<anonymized_userid>",1,71665,5452,"Thierry Baudet (FvD)",0.948275862068966,0.582416408503365,0
"<anonymized_userid>",1,71666,5453,"Thierry Baudet (FvD)",0.948289094132903,0.582523234697148,0
"<anonymized_userid>",1,71667,5454,"Thierry Baudet (FvD)",0.94830232619684,0.582630060890931,0
"<anonymized_userid>",1,71668,5455,"Thierry Baudet (FvD)",0.948315558260778,0.582736887084713,0
"<anonymized_userid>",1,71669,5456,"Thierry Baudet (FvD)",0.948328790324715,0.582843713278496,0
"<anonymized_userid>",1,71670,5457,"Thierry Baudet (FvD)",0.948342022388652,0.582950539472279,0
"<anonymized_userid>",1,71671,5458,"Thierry Baudet (FvD)",0.94835525445259,0.583057365666061,0
"<anonymized_userid>",1,71672,5459,"Thierry Baudet (FvD)",0.948368486516527,0.583164191859844,0
"<anonymized_userid>",1,71673,5460,"Thierry Baudet (FvD)",0.948381718580464,0.583271018053627,0
"<anonymized_userid>",1,71674,5461,"Thierry Baudet (FvD)",0.948394950644401,0.583377844247409,0
"<anonymized_userid>",1,71675,5462,"Thierry Baudet (FvD)",0.948408182708339,0.583484670441192,0
"<anonymized_userid>",1,71676,5463,"Thierry Baudet (FvD)",0.948421414772276,0.583591496634975,0
"<anonymized_userid>",1,71677,5464,"Thierry Baudet (FvD)",0.948434646836213,0.583698322828758,0
"<anonymized_userid>",1,71678,5465,"Thierry Baudet (FvD)",0.948447878900151,0.58380514902254,0
"<anonymized_userid>",1,71679,5466,"Thierry Baudet (FvD)",0.948461110964088,0.583911975216323,0
"<anonymized_userid>",1,71680,5467,"Thierry Baudet (FvD)",0.948474343028025,0.584018801410106,0
"<anonymized_userid>",1,71681,5468,"Thierry Baudet (FvD)",0.948487575091963,0.584125627603888,0
"<anonymized_userid>",1,71682,5469,"Thierry Baudet (FvD)",0.9485008071559,0.584232453797671,0
"<anonymized_userid>",1,71683,5470,"Thierry Baudet (FvD)",0.948514039219837,0.584339279991454,0
"<anonymized_userid>",1,71684,5471,"Thierry Baudet (FvD)",0.948527271283775,0.584446106185237,0
"<anonymized_userid>",1,71685,5472,"Thierry Baudet (FvD)",0.948540503347712,0.584552932379019,0
"<anonymized_userid>",1,71686,5473,"Thierry Baudet (FvD)",0.94855373541165,0.584659758572802,0
"<anonymized_userid>",1,71687,5474,"Thierry Baudet (FvD)",0.948566967475587,0.584766584766585,0
"<anonymized_userid>",1,71688,5475,"Thierry Baudet (FvD)",0.948580199539524,0.584873410960367,0
"<anonymized_userid>",1,71689,5476,"Thierry Baudet (FvD)",0.948593431603462,0.58498023715415,0
"<anonymized_userid>",1,71690,5477,"Thierry Baudet (FvD)",0.948606663667399,0.585087063347933,0
"<anonymized_userid>",1,71691,5478,"Thierry Baudet (FvD)",0.948619895731336,0.585193889541716,0
"<anonymized_userid>",1,71692,5479,"Thierry Baudet (FvD)",0.948633127795274,0.585300715735498,0
"<anonymized_userid>",1,71693,5480,"Thierry Baudet (FvD)",0.948646359859211,0.585407541929281,0
"<anonymized_userid>",1,71694,5481,"Thierry Baudet (FvD)",0.948659591923148,0.585514368123064,0
"<anonymized_userid>",1,71695,5482,"Thierry Baudet (FvD)",0.948672823987086,0.585621194316846,0
"<anonymized_userid>",1,71696,5483,"Thierry Baudet (FvD)",0.948686056051023,0.585728020510629,0
"<anonymized_userid>",1,71697,5484,"Thierry Baudet (FvD)",0.94869928811496,0.585834846704412,0
"<anonymized_userid>",1,71698,5485,"Thierry Baudet (FvD)",0.948712520178898,0.585941672898195,0
"<anonymized_userid>",1,71699,5486,"Thierry Baudet (FvD)",0.948725752242835,0.586048499091977,0
"<anonymized_userid>",1,71700,5487,"Thierry Baudet (FvD)",0.948738984306772,0.58615532528576,0
"<anonymized_userid>",1,71701,5488,"Thierry Baudet (FvD)",0.94875221637071,0.586262151479543,0
"<anonymized_userid>",1,71702,5489,"Thierry Baudet (FvD)",0.948765448434647,0.586368977673326,0
"<anonymized_userid>",1,71703,5490,"Thierry Baudet (FvD)",0.948778680498584,0.586475803867108,0
"<anonymized_userid>",1,71704,5491,"Thierry Baudet (FvD)",0.948791912562521,0.586582630060891,0
"<anonymized_userid>",1,71705,5492,"Thierry Baudet (FvD)",0.948805144626459,0.586689456254674,0
"<anonymized_userid>",1,71706,5493,"Thierry Baudet (FvD)",0.948818376690396,0.586796282448456,0
"<anonymized_userid>",1,71707,5494,"Thierry Baudet (FvD)",0.948831608754333,0.586903108642239,0
"<anonymized_userid>",1,71708,5495,"Thierry Baudet (FvD)",0.948844840818271,0.587009934836022,0
"<anonymized_userid>",1,71709,5496,"Thierry Baudet (FvD)",0.948858072882208,0.587116761029804,0
"<anonymized_userid>",1,71710,5497,"Thierry Baudet (FvD)",0.948871304946145,0.587223587223587,0
"<anonymized_userid>",1,71711,5498,"Thierry Baudet (FvD)",0.948884537010083,0.58733041341737,0
"<anonymized_userid>",1,71712,5499,"Thierry Baudet (FvD)",0.94889776907402,0.587437239611153,0
"<anonymized_userid>",1,71713,5500,"Thierry Baudet (FvD)",0.948911001137957,0.587544065804935,0
"<anonymized_userid>",1,71714,5501,"Thierry Baudet (FvD)",0.948924233201895,0.587650891998718,0
"<anonymized_userid>",1,71715,5502,"Thierry Baudet (FvD)",0.948937465265832,0.587757718192501,0
"<anonymized_userid>",1,71716,5503,"Thierry Baudet (FvD)",0.948950697329769,0.587864544386284,0
"<anonymized_userid>",1,71717,5504,"Thierry Baudet (FvD)",0.948963929393707,0.587971370580066,0
"<anonymized_userid>",1,71718,5505,"Thierry Baudet (FvD)",0.948977161457644,0.588078196773849,0
"<anonymized_userid>",1,71719,5506,"Thierry Baudet (FvD)",0.948990393521582,0.588185022967632,0
"<anonymized_userid>",1,71720,5507,"Thierry Baudet (FvD)",0.949003625585519,0.588291849161414,0
"<anonymized_userid>",1,71721,5508,"Thierry Baudet (FvD)",0.949016857649456,0.588398675355197,0
"<anonymized_userid>",1,71722,5509,"Thierry Baudet (FvD)",0.949030089713394,0.58850550154898,0
"<anonymized_userid>",1,71723,5510,"Thierry Baudet (FvD)",0.949043321777331,0.588612327742763,0
"<anonymized_userid>",1,71724,5511,"Thierry Baudet (FvD)",0.949056553841268,0.588719153936545,0
"<anonymized_userid>",1,71725,5512,"Thierry Baudet (FvD)",0.949069785905206,0.588825980130328,0
"<anonymized_userid>",1,71726,5513,"Thierry Baudet (FvD)",0.949083017969143,0.588932806324111,0
"<anonymized_userid>",1,71727,5514,"Thierry Baudet (FvD)",0.94909625003308,0.589039632517893,0
"<anonymized_userid>",1,71728,5515,"Thierry Baudet (FvD)",0.949109482097018,0.589146458711676,0
"<anonymized_userid>",1,71729,5516,"Thierry Baudet (FvD)",0.949122714160955,0.589253284905459,0
"<anonymized_userid>",1,71730,5517,"Thierry Baudet (FvD)",0.949135946224892,0.589360111099242,0
"<anonymized_userid>",1,71731,5518,"Thierry Baudet (FvD)",0.949149178288829,0.589466937293024,0
"<anonymized_userid>",1,71732,5519,"Thierry Baudet (FvD)",0.949162410352767,0.589573763486807,0
"<anonymized_userid>",1,71733,5520,"Thierry Baudet (FvD)",0.949175642416704,0.58968058968059,0
"<anonymized_userid>",1,71734,5521,"Thierry Baudet (FvD)",0.949188874480641,0.589787415874372,0
"<anonymized_userid>",1,71735,5522,"Thierry Baudet (FvD)",0.949202106544579,0.589894242068155,0
"<anonymized_userid>",1,71736,5523,"Thierry Baudet (FvD)",0.949215338608516,0.590001068261938,0
"<anonymized_userid>",1,71737,5524,"Thierry Baudet (FvD)",0.949228570672453,0.590107894455721,0
"<anonymized_userid>",1,71738,5525,"Thierry Baudet (FvD)",0.949241802736391,0.590214720649503,0
"<anonymized_userid>",1,71739,5526,"Thierry Baudet (FvD)",0.949255034800328,0.590321546843286,0
"<anonymized_userid>",1,71740,5527,"Thierry Baudet (FvD)",0.949268266864265,0.590428373037069,0
"<anonymized_userid>",1,71741,5528,"Thierry Baudet (FvD)",0.949281498928203,0.590535199230851,0
"<anonymized_userid>",1,71742,5529,"Thierry Baudet (FvD)",0.94929473099214,0.590642025424634,0
"<anonymized_userid>",1,71743,5530,"Thierry Baudet (FvD)",0.949307963056077,0.590748851618417,0
"<anonymized_userid>",1,71744,5531,"Thierry Baudet (FvD)",0.949321195120015,0.590855677812199,0
"<anonymized_userid>",1,71745,5532,"Thierry Baudet (FvD)",0.949334427183952,0.590962504005982,0
"<anonymized_userid>",1,71746,5533,"Thierry Baudet (FvD)",0.949347659247889,0.591069330199765,0
"<anonymized_userid>",1,71747,5534,"Thierry Baudet (FvD)",0.949360891311827,0.591176156393548,0
"<anonymized_userid>",1,71748,5535,"Thierry Baudet (FvD)",0.949374123375764,0.59128298258733,0
"<anonymized_userid>",1,71749,5536,"Thierry Baudet (FvD)",0.949387355439701,0.591389808781113,0
"<anonymized_userid>",1,71750,5537,"Thierry Baudet (FvD)",0.949400587503639,0.591496634974896,0
"<anonymized_userid>",1,71751,5538,"Thierry Baudet (FvD)",0.949413819567576,0.591603461168679,0
"<anonymized_userid>",1,71752,5539,"Thierry Baudet (FvD)",0.949427051631514,0.591710287362461,0
"<anonymized_userid>",1,71753,5540,"Thierry Baudet (FvD)",0.949440283695451,0.591817113556244,0
"<anonymized_userid>",1,71754,5541,"Thierry Baudet (FvD)",0.949453515759388,0.591923939750027,0
"<anonymized_userid>",1,71755,5542,"Thierry Baudet (FvD)",0.949466747823326,0.592030765943809,0
"<anonymized_userid>",1,71756,5543,"Thierry Baudet (FvD)",0.949479979887263,0.592137592137592,0
"<anonymized_userid>",1,71757,5544,"Thierry Baudet (FvD)",0.9494932119512,0.592244418331375,0
"<anonymized_userid>",1,71758,5545,"Thierry Baudet (FvD)",0.949506444015138,0.592351244525158,0
"<anonymized_userid>",1,71759,5546,"Thierry Baudet (FvD)",0.949519676079075,0.59245807071894,0
"<anonymized_userid>",1,71760,5547,"Thierry Baudet (FvD)",0.949532908143012,0.592564896912723,0
"<anonymized_userid>",1,71761,5548,"Thierry Baudet (FvD)",0.949546140206949,0.592671723106506,0
"<anonymized_userid>",1,71762,5549,"Thierry Baudet (FvD)",0.949559372270887,0.592778549300288,0
"<anonymized_userid>",1,71763,5550,"Thierry Baudet (FvD)",0.949572604334824,0.592885375494071,0
"<anonymized_userid>",1,71764,5551,"Thierry Baudet (FvD)",0.949585836398761,0.592992201687854,0
"<anonymized_userid>",1,71765,5552,"Thierry Baudet (FvD)",0.949599068462699,0.593099027881637,0
"<anonymized_userid>",1,71766,5553,"Thierry Baudet (FvD)",0.949612300526636,0.593205854075419,0
"<anonymized_userid>",1,71767,5554,"Thierry Baudet (FvD)",0.949625532590573,0.593312680269202,0
"<anonymized_userid>",1,71768,5555,"Thierry Baudet (FvD)",0.949638764654511,0.593419506462985,0
"<anonymized_userid>",1,71769,5556,"Thierry Baudet (FvD)",0.949651996718448,0.593526332656767,0
"<anonymized_userid>",1,71770,5557,"Thierry Baudet (FvD)",0.949665228782385,0.59363315885055,0
"<anonymized_userid>",1,71771,5558,"Thierry Baudet (FvD)",0.949678460846323,0.593739985044333,0
"<anonymized_userid>",1,71772,5559,"Thierry Baudet (FvD)",0.94969169291026,0.593846811238116,0
"<anonymized_userid>",1,71773,5560,"Thierry Baudet (FvD)",0.949704924974197,0.593953637431898,0
"<anonymized_userid>",1,71774,5561,"Thierry Baudet (FvD)",0.949718157038135,0.594060463625681,0
"<anonymized_userid>",1,71775,5562,"Thierry Baudet (FvD)",0.949731389102072,0.594167289819464,0
"<anonymized_userid>",1,71776,5563,"Thierry Baudet (FvD)",0.949744621166009,0.594274116013246,0
"<anonymized_userid>",1,71777,5564,"Thierry Baudet (FvD)",0.949757853229947,0.594380942207029,0
"<anonymized_userid>",1,71778,5565,"Thierry Baudet (FvD)",0.949771085293884,0.594487768400812,0
"<anonymized_userid>",1,71779,5566,"Thierry Baudet (FvD)",0.949784317357821,0.594594594594595,0
"<anonymized_userid>",1,71780,5567,"Thierry Baudet (FvD)",0.949797549421759,0.594701420788377,0
"<anonymized_userid>",1,71781,5568,"Thierry Baudet (FvD)",0.949810781485696,0.59480824698216,0
"<anonymized_userid>",1,71782,5569,"Thierry Baudet (FvD)",0.949824013549633,0.594915073175943,0
"<anonymized_userid>",1,71783,5570,"Thierry Baudet (FvD)",0.949837245613571,0.595021899369725,0
"<anonymized_userid>",1,71784,5571,"Thierry Baudet (FvD)",0.949850477677508,0.595128725563508,0
"<anonymized_userid>",1,71785,5572,"Thierry Baudet (FvD)",0.949863709741446,0.595235551757291,0
"<anonymized_userid>",1,71786,5573,"Thierry Baudet (FvD)",0.949876941805383,0.595342377951074,0
"<anonymized_userid>",1,71787,5574,"Thierry Baudet (FvD)",0.94989017386932,0.595449204144856,0
"<anonymized_userid>",1,71788,5575,"Thierry Baudet (FvD)",0.949903405933258,0.595556030338639,0
"<anonymized_userid>",1,71789,5576,"Thierry Baudet (FvD)",0.949916637997195,0.595662856532422,0
"<anonymized_userid>",1,71790,5577,"Thierry Baudet (FvD)",0.949929870061132,0.595769682726204,0
"<anonymized_userid>",1,71791,5578,"Thierry Baudet (FvD)",0.949943102125069,0.595876508919987,0
"<anonymized_userid>",1,71792,5579,"Thierry Baudet (FvD)",0.949956334189007,0.59598333511377,0
"<anonymized_userid>",1,71793,5580,"Thierry Baudet (FvD)",0.949969566252944,0.596090161307553,0
"<anonymized_userid>",1,71794,5581,"Thierry Baudet (FvD)",0.949982798316881,0.596196987501335,0
"<anonymized_userid>",1,71795,5582,"Thierry Baudet (FvD)",0.949996030380819,0.596303813695118,0
"<anonymized_userid>",1,71796,5583,"Thierry Baudet (FvD)",0.950009262444756,0.596410639888901,0
"<anonymized_userid>",1,71797,5584,"Thierry Baudet (FvD)",0.950022494508693,0.596517466082684,0
"<anonymized_userid>",1,71798,5585,"Thierry Baudet (FvD)",0.950035726572631,0.596624292276466,0
"<anonymized_userid>",1,71799,5586,"Thierry Baudet (FvD)",0.950048958636568,0.596731118470249,0
"<anonymized_userid>",1,71800,5587,"Thierry Baudet (FvD)",0.950062190700505,0.596837944664032,0
"<anonymized_userid>",1,71801,5588,"Thierry Baudet (FvD)",0.950075422764443,0.596944770857814,0
"<anonymized_userid>",1,71802,5589,"Thierry Baudet (FvD)",0.95008865482838,0.597051597051597,0
"<anonymized_userid>",1,71803,5590,"Thierry Baudet (FvD)",0.950101886892317,0.59715842324538,0
"<anonymized_userid>",1,71804,5591,"Thierry Baudet (FvD)",0.950115118956255,0.597265249439162,0
"<anonymized_userid>",1,71805,5592,"Thierry Baudet (FvD)",0.950128351020192,0.597372075632945,0
"<anonymized_userid>",1,71806,5593,"Thierry Baudet (FvD)",0.950141583084129,0.597478901826728,0
"<anonymized_userid>",1,71807,5594,"Thierry Baudet (FvD)",0.950154815148067,0.597585728020511,0
"<anonymized_userid>",1,71808,5595,"Thierry Baudet (FvD)",0.950168047212004,0.597692554214293,0
"<anonymized_userid>",1,71809,5596,"Thierry Baudet (FvD)",0.950181279275941,0.597799380408076,0
"<anonymized_userid>",1,71810,5597,"Thierry Baudet (FvD)",0.950194511339879,0.597906206601859,0
"<anonymized_userid>",1,71811,5598,"Thierry Baudet (FvD)",0.950207743403816,0.598013032795641,0
"<anonymized_userid>",1,71812,5599,"Thierry Baudet (FvD)",0.950220975467753,0.598119858989424,0
"<anonymized_userid>",1,71813,5600,"Thierry Baudet (FvD)",0.950234207531691,0.598226685183207,0
"<anonymized_userid>",1,71814,5601,"Thierry Baudet (FvD)",0.950247439595628,0.59833351137699,0
"<anonymized_userid>",1,71815,5602,"Thierry Baudet (FvD)",0.950260671659566,0.598440337570772,0
"<anonymized_userid>",1,71816,5603,"Thierry Baudet (FvD)",0.950273903723503,0.598547163764555,0
"<anonymized_userid>",1,71817,5604,"Thierry Baudet (FvD)",0.95028713578744,0.598653989958338,0
"<anonymized_userid>",1,71818,5605,"Thierry Baudet (FvD)",0.950300367851378,0.598760816152121,0
"<anonymized_userid>",1,71819,5606,"Thierry Baudet (FvD)",0.950313599915315,0.598867642345903,0
"<anonymized_userid>",1,71820,5607,"Thierry Baudet (FvD)",0.950326831979252,0.598974468539686,0
"<anonymized_userid>",1,71821,5608,"Thierry Baudet (FvD)",0.950340064043189,0.599081294733469,0
"<anonymized_userid>",1,71822,5609,"Thierry Baudet (FvD)",0.950353296107127,0.599188120927251,0
"<anonymized_userid>",1,71823,5610,"Thierry Baudet (FvD)",0.950366528171064,0.599294947121034,0
"<anonymized_userid>",1,71824,5611,"Thierry Baudet (FvD)",0.950379760235001,0.599401773314817,0
"<anonymized_userid>",1,71825,5612,"Thierry Baudet (FvD)",0.950392992298939,0.599508599508599,0
"<anonymized_userid>",1,71826,5613,"Thierry Baudet (FvD)",0.950406224362876,0.599615425702382,0
"<anonymized_userid>",1,71827,5614,"Thierry Baudet (FvD)",0.950419456426813,0.599722251896165,0
"<anonymized_userid>",1,71828,5615,"Thierry Baudet (FvD)",0.950432688490751,0.599829078089948,0
"<anonymized_userid>",1,71829,5616,"Thierry Baudet (FvD)",0.950445920554688,0.59993590428373,0
"<anonymized_userid>",1,71830,5617,"Thierry Baudet (FvD)",0.950459152618625,0.600042730477513,0
"<anonymized_userid>",1,71831,5618,"Thierry Baudet (FvD)",0.950472384682563,0.600149556671296,0
"<anonymized_userid>",1,71832,5619,"Thierry Baudet (FvD)",0.9504856167465,0.600256382865079,0
"<anonymized_userid>",1,71833,5620,"Thierry Baudet (FvD)",0.950498848810437,0.600363209058861,0
"<anonymized_userid>",1,71834,5621,"Thierry Baudet (FvD)",0.950512080874375,0.600470035252644,0
"<anonymized_userid>",1,71835,5622,"Thierry Baudet (FvD)",0.950525312938312,0.600576861446427,0
"<anonymized_userid>",1,71836,5623,"Thierry Baudet (FvD)",0.950538545002249,0.600683687640209,0
"<anonymized_userid>",1,71837,5624,"Thierry Baudet (FvD)",0.950551777066187,0.600790513833992,0
"<anonymized_userid>",1,71838,5625,"Thierry Baudet (FvD)",0.950565009130124,0.600897340027775,0
"<anonymized_userid>",1,71839,5626,"Thierry Baudet (FvD)",0.950578241194061,0.601004166221558,0
"<anonymized_userid>",1,71840,5627,"Thierry Baudet (FvD)",0.950591473257999,0.60111099241534,0
"<anonymized_userid>",1,71841,5628,"Thierry Baudet (FvD)",0.950604705321936,0.601217818609123,0
"<anonymized_userid>",1,71842,5629,"Thierry Baudet (FvD)",0.950617937385873,0.601324644802906,0
"<anonymized_userid>",1,71843,5630,"Thierry Baudet (FvD)",0.950631169449811,0.601431470996688,0
"<anonymized_userid>",1,71844,5631,"Thierry Baudet (FvD)",0.950644401513748,0.601538297190471,0
"<anonymized_userid>",1,71845,5632,"Thierry Baudet (FvD)",0.950657633577685,0.601645123384254,0
"<anonymized_userid>",1,71846,5633,"Thierry Baudet (FvD)",0.950670865641623,0.601751949578037,0
"<anonymized_userid>",1,71847,5634,"Thierry Baudet (FvD)",0.95068409770556,0.601858775771819,0
"<anonymized_userid>",1,71848,5635,"Thierry Baudet (FvD)",0.950697329769498,0.601965601965602,0
"<anonymized_userid>",1,71849,5636,"Thierry Baudet (FvD)",0.950710561833435,0.602072428159385,0
"<anonymized_userid>",1,71850,5637,"Thierry Baudet (FvD)",0.950723793897372,0.602179254353167,0
"<anonymized_userid>",1,71851,5638,"Thierry Baudet (FvD)",0.950737025961309,0.60228608054695,0
"<anonymized_userid>",1,71852,5639,"Thierry Baudet (FvD)",0.950750258025247,0.602392906740733,0
"<anonymized_userid>",1,71853,5640,"Thierry Baudet (FvD)",0.950763490089184,0.602499732934516,0
"<anonymized_userid>",1,71854,5641,"Thierry Baudet (FvD)",0.950776722153121,0.602606559128298,0
"<anonymized_userid>",1,71855,5642,"Thierry Baudet (FvD)",0.950789954217059,0.602713385322081,0
"<anonymized_userid>",1,71856,5643,"Thierry Baudet (FvD)",0.950803186280996,0.602820211515864,0
"<anonymized_userid>",1,71857,5644,"Thierry Baudet (FvD)",0.950816418344933,0.602927037709646,0
"<anonymized_userid>",1,71858,5645,"Thierry Baudet (FvD)",0.950829650408871,0.603033863903429,0
"<anonymized_userid>",1,71859,5646,"Thierry Baudet (FvD)",0.950842882472808,0.603140690097212,0
"<anonymized_userid>",1,71860,5647,"Thierry Baudet (FvD)",0.950856114536745,0.603247516290995,0
"<anonymized_userid>",1,71861,5648,"Thierry Baudet (FvD)",0.950869346600683,0.603354342484777,0
"<anonymized_userid>",1,71862,5649,"Thierry Baudet (FvD)",0.95088257866462,0.60346116867856,0
"<anonymized_userid>",1,71863,5650,"Thierry Baudet (FvD)",0.950895810728557,0.603567994872343,0
"<anonymized_userid>",1,71864,5651,"Thierry Baudet (FvD)",0.950909042792495,0.603674821066125,0
"<anonymized_userid>",1,71865,5652,"Thierry Baudet (FvD)",0.950922274856432,0.603781647259908,0
"<anonymized_userid>",1,71866,5653,"Thierry Baudet (FvD)",0.950935506920369,0.603888473453691,0
"<anonymized_userid>",1,71867,5654,"Thierry Baudet (FvD)",0.950948738984307,0.603995299647474,0
"<anonymized_userid>",1,71868,5655,"Thierry Baudet (FvD)",0.950961971048244,0.604102125841256,0
"<anonymized_userid>",1,71869,5656,"Thierry Baudet (FvD)",0.950975203112181,0.604208952035039,0
"<anonymized_userid>",1,71870,5657,"Thierry Baudet (FvD)",0.950988435176119,0.604315778228822,0
"<anonymized_userid>",1,71871,5658,"Thierry Baudet (FvD)",0.951001667240056,0.604422604422604,0
"<anonymized_userid>",1,71872,5659,"Thierry Baudet (FvD)",0.951014899303993,0.604529430616387,0
"<anonymized_userid>",1,71873,5660,"Thierry Baudet (FvD)",0.951028131367931,0.60463625681017,0
"<anonymized_userid>",1,71874,5661,"Thierry Baudet (FvD)",0.951041363431868,0.604743083003953,0
"<anonymized_userid>",1,71875,5662,"Thierry Baudet (FvD)",0.951054595495805,0.604849909197735,0
"<anonymized_userid>",1,71876,5663,"Thierry Baudet (FvD)",0.951067827559743,0.604956735391518,0
"<anonymized_userid>",1,71877,5664,"Thierry Baudet (FvD)",0.95108105962368,0.605063561585301,0
"<anonymized_userid>",1,71878,5665,"Thierry Baudet (FvD)",0.951094291687617,0.605170387779083,0
"<anonymized_userid>",1,71879,5666,"Thierry Baudet (FvD)",0.951107523751555,0.605277213972866,0
"<anonymized_userid>",1,71880,5667,"Thierry Baudet (FvD)",0.951120755815492,0.605384040166649,0
"<anonymized_userid>",1,71881,5668,"Thierry Baudet (FvD)",0.951133987879429,0.605490866360432,0
"<anonymized_userid>",1,71882,5669,"Thierry Baudet (FvD)",0.951147219943367,0.605597692554214,0
"<anonymized_userid>",1,71883,5670,"Thierry Baudet (FvD)",0.951160452007304,0.605704518747997,0
"<anonymized_userid>",1,71884,5671,"Thierry Baudet (FvD)",0.951173684071241,0.60581134494178,0
"<anonymized_userid>",1,71885,5672,"Thierry Baudet (FvD)",0.951186916135179,0.605918171135562,0
"<anonymized_userid>",1,71886,5673,"Thierry Baudet (FvD)",0.951200148199116,0.606024997329345,0
"<anonymized_userid>",1,71887,5674,"Thierry Baudet (FvD)",0.951213380263053,0.606131823523128,0
"<anonymized_userid>",1,71888,5675,"Thierry Baudet (FvD)",0.951226612326991,0.606238649716911,0
"<anonymized_userid>",1,71889,5676,"Thierry Baudet (FvD)",0.951239844390928,0.606345475910693,0
"<anonymized_userid>",1,71890,5677,"Thierry Baudet (FvD)",0.951253076454865,0.606452302104476,0
"<anonymized_userid>",1,71891,5678,"Thierry Baudet (FvD)",0.951266308518803,0.606559128298259,0
"<anonymized_userid>",1,71892,5679,"Thierry Baudet (FvD)",0.95127954058274,0.606665954492041,0
"<anonymized_userid>",1,71893,5680,"Thierry Baudet (FvD)",0.951292772646677,0.606772780685824,0
"<anonymized_userid>",1,71894,5681,"Thierry Baudet (FvD)",0.951306004710615,0.606879606879607,0
"<anonymized_userid>",1,71895,5682,"Thierry Baudet (FvD)",0.951319236774552,0.60698643307339,0
"<anonymized_userid>",1,71896,5683,"Thierry Baudet (FvD)",0.951332468838489,0.607093259267172,0
"<anonymized_userid>",1,71897,5684,"Thierry Baudet (FvD)",0.951345700902427,0.607200085460955,0
"<anonymized_userid>",1,71898,5685,"Thierry Baudet (FvD)",0.951358932966364,0.607306911654738,0
"<anonymized_userid>",1,71899,5686,"Thierry Baudet (FvD)",0.951372165030301,0.60741373784852,0
"<anonymized_userid>",1,71900,5687,"Thierry Baudet (FvD)",0.951385397094239,0.607520564042303,0
"<anonymized_userid>",1,71901,5688,"Thierry Baudet (FvD)",0.951398629158176,0.607627390236086,0
"<anonymized_userid>",1,71902,5689,"Thierry Baudet (FvD)",0.951411861222113,0.607734216429869,0
"<anonymized_userid>",1,71903,5690,"Thierry Baudet (FvD)",0.951425093286051,0.607841042623651,0
"<anonymized_userid>",1,71904,5691,"Thierry Baudet (FvD)",0.951438325349988,0.607947868817434,0
"<anonymized_userid>",1,71905,5692,"Thierry Baudet (FvD)",0.951451557413925,0.608054695011217,0
"<anonymized_userid>",1,71906,5693,"Thierry Baudet (FvD)",0.951464789477863,0.608161521204999,0
"<anonymized_userid>",1,71907,5694,"Thierry Baudet (FvD)",0.9514780215418,0.608268347398782,0
"<anonymized_userid>",1,71908,5695,"Thierry Baudet (FvD)",0.951491253605737,0.608375173592565,0
"<anonymized_userid>",1,71909,5696,"Thierry Baudet (FvD)",0.951504485669675,0.608481999786348,0
"<anonymized_userid>",1,71910,5697,"Thierry Baudet (FvD)",0.951517717733612,0.60858882598013,0
"<anonymized_userid>",1,71911,5698,"Thierry Baudet (FvD)",0.951530949797549,0.608695652173913,0
"<anonymized_userid>",1,71912,5699,"Thierry Baudet (FvD)",0.951544181861487,0.608802478367696,0
"<anonymized_userid>",1,71913,5700,"Thierry Baudet (FvD)",0.951557413925424,0.608909304561479,0
"<anonymized_userid>",1,71914,5701,"Thierry Baudet (FvD)",0.951570645989361,0.609016130755261,0
"<anonymized_userid>",1,71915,5702,"Thierry Baudet (FvD)",0.951583878053299,0.609122956949044,0
"<anonymized_userid>",1,71916,5703,"Thierry Baudet (FvD)",0.951597110117236,0.609229783142827,0
"<anonymized_userid>",1,71917,5704,"Thierry Baudet (FvD)",0.951610342181173,0.609336609336609,0
"<anonymized_userid>",1,71918,5705,"Thierry Baudet (FvD)",0.951623574245111,0.609443435530392,0
"<anonymized_userid>",1,71919,5706,"Thierry Baudet (FvD)",0.951636806309048,0.609550261724175,0
"<anonymized_userid>",1,71920,5707,"Thierry Baudet (FvD)",0.951650038372985,0.609657087917957,0
"<anonymized_userid>",1,71921,5708,"Thierry Baudet (FvD)",0.951663270436923,0.60976391411174,0
"<anonymized_userid>",1,71922,5709,"Thierry Baudet (FvD)",0.95167650250086,0.609870740305523,0
"<anonymized_userid>",1,71923,5710,"Thierry Baudet (FvD)",0.951689734564797,0.609977566499306,0
"<anonymized_userid>",1,71924,5711,"Thierry Baudet (FvD)",0.951702966628735,0.610084392693088,0
"<anonymized_userid>",1,71925,5712,"Thierry Baudet (FvD)",0.951716198692672,0.610191218886871,0
"<anonymized_userid>",1,71926,5713,"Thierry Baudet (FvD)",0.951729430756609,0.610298045080654,0
"<anonymized_userid>",1,71927,5714,"Thierry Baudet (FvD)",0.951742662820547,0.610404871274437,0
"<anonymized_userid>",1,71928,5715,"Thierry Baudet (FvD)",0.951755894884484,0.610511697468219,0
"<anonymized_userid>",1,71929,5716,"Thierry Baudet (FvD)",0.951769126948421,0.610618523662002,0
"<anonymized_userid>",1,71930,5717,"Thierry Baudet (FvD)",0.951782359012359,0.610725349855785,0
"<anonymized_userid>",1,71931,5718,"Thierry Baudet (FvD)",0.951795591076296,0.610832176049567,0
"<anonymized_userid>",1,71932,5719,"Thierry Baudet (FvD)",0.951808823140233,0.61093900224335,0
"<anonymized_userid>",1,71933,5720,"Thierry Baudet (FvD)",0.951822055204171,0.611045828437133,0
"<anonymized_userid>",1,71934,5721,"Thierry Baudet (FvD)",0.951835287268108,0.611152654630916,0
"<anonymized_userid>",1,71935,5722,"Thierry Baudet (FvD)",0.951848519332045,0.611259480824698,0
"<anonymized_userid>",1,71936,5723,"Thierry Baudet (FvD)",0.951861751395983,0.611366307018481,0
"<anonymized_userid>",1,71937,5724,"Thierry Baudet (FvD)",0.95187498345992,0.611473133212264,0
"<anonymized_userid>",1,71938,5725,"Thierry Baudet (FvD)",0.951888215523857,0.611579959406046,0
"<anonymized_userid>",1,71939,5726,"Thierry Baudet (FvD)",0.951901447587795,0.611686785599829,0
"<anonymized_userid>",1,71940,5727,"Thierry Baudet (FvD)",0.951914679651732,0.611793611793612,0
"<anonymized_userid>",1,71941,5728,"Thierry Baudet (FvD)",0.951927911715669,0.611900437987394,0
"<anonymized_userid>",1,71942,5729,"Thierry Baudet (FvD)",0.951941143779607,0.612007264181177,0
"<anonymized_userid>",1,71943,5730,"Thierry Baudet (FvD)",0.951954375843544,0.61211409037496,0
"<anonymized_userid>",1,71944,5731,"Thierry Baudet (FvD)",0.951967607907481,0.612220916568743,0
"<anonymized_userid>",1,71945,5732,"Thierry Baudet (FvD)",0.951980839971419,0.612327742762525,0
"<anonymized_userid>",1,71946,5733,"Thierry Baudet (FvD)",0.951994072035356,0.612434568956308,0
"<anonymized_userid>",1,71947,5734,"Thierry Baudet (FvD)",0.952007304099293,0.612541395150091,0
"<anonymized_userid>",1,71948,5735,"Thierry Baudet (FvD)",0.952020536163231,0.612648221343874,0
"<anonymized_userid>",1,71949,5736,"Thierry Baudet (FvD)",0.952033768227168,0.612755047537656,0
"<anonymized_userid>",1,71950,5737,"Thierry Baudet (FvD)",0.952047000291105,0.612861873731439,0
"<anonymized_userid>",1,71951,5738,"Thierry Baudet (FvD)",0.952060232355043,0.612968699925222,0
"<anonymized_userid>",1,71952,5739,"Thierry Baudet (FvD)",0.95207346441898,0.613075526119004,0
"<anonymized_userid>",1,71953,5740,"Thierry Baudet (FvD)",0.952086696482917,0.613182352312787,0
"<anonymized_userid>",1,71954,5741,"Thierry Baudet (FvD)",0.952099928546855,0.61328917850657,0
"<anonymized_userid>",1,71955,5742,"Thierry Baudet (FvD)",0.952113160610792,0.613396004700352,0
"<anonymized_userid>",1,71956,5743,"Thierry Baudet (FvD)",0.952126392674729,0.613502830894135,0
"<anonymized_userid>",1,71957,5744,"Thierry Baudet (FvD)",0.952139624738667,0.613609657087918,0
"<anonymized_userid>",1,71958,5745,"Thierry Baudet (FvD)",0.952152856802604,0.613716483281701,0
"<anonymized_userid>",1,71959,5746,"Thierry Baudet (FvD)",0.952166088866541,0.613823309475483,0
"<anonymized_userid>",1,71960,5747,"Thierry Baudet (FvD)",0.952179320930479,0.613930135669266,0
"<anonymized_userid>",1,71961,5748,"Thierry Baudet (FvD)",0.952192552994416,0.614036961863049,0
"<anonymized_userid>",1,71962,5749,"Thierry Baudet (FvD)",0.952205785058353,0.614143788056832,0
"<anonymized_userid>",1,71963,5750,"Thierry Baudet (FvD)",0.952219017122291,0.614250614250614,0
"<anonymized_userid>",1,71964,5751,"Thierry Baudet (FvD)",0.952232249186228,0.614357440444397,0
"<anonymized_userid>",1,71965,5752,"Thierry Baudet (FvD)",0.952245481250165,0.61446426663818,0
"<anonymized_userid>",1,71966,5753,"Thierry Baudet (FvD)",0.952258713314103,0.614571092831962,0
"<anonymized_userid>",1,71967,5754,"Thierry Baudet (FvD)",0.95227194537804,0.614677919025745,0
"<anonymized_userid>",1,71968,5755,"Thierry Baudet (FvD)",0.952285177441977,0.614784745219528,0
"<anonymized_userid>",1,71969,5756,"Thierry Baudet (FvD)",0.952298409505915,0.614891571413311,0
"<anonymized_userid>",1,71970,5757,"Thierry Baudet (FvD)",0.952311641569852,0.614998397607093,0
"<anonymized_userid>",1,71971,5758,"Thierry Baudet (FvD)",0.952324873633789,0.615105223800876,0
"<anonymized_userid>",1,71972,5759,"Thierry Baudet (FvD)",0.952338105697727,0.615212049994659,0
"<anonymized_userid>",1,71973,5760,"Thierry Baudet (FvD)",0.952351337761664,0.615318876188441,0
"<anonymized_userid>",1,71974,5761,"Thierry Baudet (FvD)",0.952364569825601,0.615425702382224,0
"<anonymized_userid>",1,71975,5762,"Thierry Baudet (FvD)",0.952377801889539,0.615532528576007,0
"<anonymized_userid>",1,71976,5763,"Thierry Baudet (FvD)",0.952391033953476,0.61563935476979,0
"<anonymized_userid>",1,71977,5764,"Thierry Baudet (FvD)",0.952404266017413,0.615746180963572,0
"<anonymized_userid>",1,71978,5765,"Thierry Baudet (FvD)",0.952417498081351,0.615853007157355,0
"<anonymized_userid>",1,71979,5766,"Thierry Baudet (FvD)",0.952430730145288,0.615959833351138,0
"<anonymized_userid>",1,71980,5767,"Thierry Baudet (FvD)",0.952443962209225,0.61606665954492,0
"<anonymized_userid>",1,71981,5768,"Thierry Baudet (FvD)",0.952457194273163,0.616173485738703,0
"<anonymized_userid>",1,71982,5769,"Thierry Baudet (FvD)",0.9524704263371,0.616280311932486,0
"<anonymized_userid>",1,71983,5770,"Thierry Baudet (FvD)",0.952483658401037,0.616387138126269,0
"<anonymized_userid>",1,71984,5771,"Thierry Baudet (FvD)",0.952496890464975,0.616493964320051,0
"<anonymized_userid>",1,71985,5772,"Thierry Baudet (FvD)",0.952510122528912,0.616600790513834,0
"<anonymized_userid>",1,71986,5773,"Thierry Baudet (FvD)",0.952523354592849,0.616707616707617,0
"<anonymized_userid>",1,71987,5774,"Thierry Baudet (FvD)",0.952536586656787,0.616814442901399,0
"<anonymized_userid>",1,71988,5775,"Thierry Baudet (FvD)",0.952549818720724,0.616921269095182,0
"<anonymized_userid>",1,71989,5776,"Thierry Baudet (FvD)",0.952563050784661,0.617028095288965,0
"<anonymized_userid>",1,71990,5777,"Thierry Baudet (FvD)",0.952576282848599,0.617134921482748,0
"<anonymized_userid>",1,71991,5778,"Thierry Baudet (FvD)",0.952589514912536,0.61724174767653,0
"<anonymized_userid>",1,71992,5779,"Thierry Baudet (FvD)",0.952602746976473,0.617348573870313,0
"<anonymized_userid>",1,71993,5780,"Thierry Baudet (FvD)",0.952615979040411,0.617455400064096,0
"<anonymized_userid>",1,71994,5781,"Thierry Baudet (FvD)",0.952629211104348,0.617562226257878,0
"<anonymized_userid>",1,71995,5782,"Thierry Baudet (FvD)",0.952642443168285,0.617669052451661,0
"<anonymized_userid>",1,71996,5783,"Thierry Baudet (FvD)",0.952655675232223,0.617775878645444,0
"<anonymized_userid>",1,71997,5784,"Thierry Baudet (FvD)",0.95266890729616,0.617882704839227,0
"<anonymized_userid>",1,71998,5785,"Thierry Baudet (FvD)",0.952682139360097,0.617989531033009,0
"<anonymized_userid>",1,71999,5786,"Thierry Baudet (FvD)",0.952695371424035,0.618096357226792,0
"<anonymized_userid>",1,72000,5787,"Thierry Baudet (FvD)",0.952708603487972,0.618203183420575,0
"<anonymized_userid>",1,72001,5788,"Thierry Baudet (FvD)",0.952721835551909,0.618310009614357,0
"<anonymized_userid>",1,72002,5789,"Thierry Baudet (FvD)",0.952735067615847,0.61841683580814,0
"<anonymized_userid>",1,72003,5790,"Thierry Baudet (FvD)",0.952748299679784,0.618523662001923,0
"<anonymized_userid>",1,72004,5791,"Thierry Baudet (FvD)",0.952761531743721,0.618630488195706,0
"<anonymized_userid>",1,72005,5792,"Thierry Baudet (FvD)",0.952774763807659,0.618737314389488,0
"<anonymized_userid>",1,72006,5793,"Thierry Baudet (FvD)",0.952787995871596,0.618844140583271,0
"<anonymized_userid>",1,72007,5794,"Thierry Baudet (FvD)",0.952801227935533,0.618950966777054,0
"<anonymized_userid>",1,72008,5795,"Thierry Baudet (FvD)",0.952814459999471,0.619057792970836,0
"<anonymized_userid>",1,72009,5796,"Thierry Baudet (FvD)",0.952827692063408,0.619164619164619,0
"<anonymized_userid>",1,72010,5797,"Thierry Baudet (FvD)",0.952840924127345,0.619271445358402,0
"<anonymized_userid>",1,72011,5798,"Thierry Baudet (FvD)",0.952854156191283,0.619378271552185,0
"<anonymized_userid>",1,72012,5799,"Thierry Baudet (FvD)",0.95286738825522,0.619485097745967,0
"<anonymized_userid>",1,72013,5800,"Thierry Baudet (FvD)",0.952880620319157,0.61959192393975,0
"<anonymized_userid>",1,72014,5801,"Thierry Baudet (FvD)",0.952893852383095,0.619698750133533,0
"<anonymized_userid>",1,72015,5802,"Thierry Baudet (FvD)",0.952907084447032,0.619805576327315,0
"<anonymized_userid>",1,72016,5803,"Thierry Baudet (FvD)",0.952920316510969,0.619912402521098,0
"<anonymized_userid>",1,72017,5804,"Thierry Baudet (FvD)",0.952933548574907,0.620019228714881,0
"<anonymized_userid>",1,72018,5805,"Thierry Baudet (FvD)",0.952946780638844,0.620126054908664,0
"<anonymized_userid>",1,72019,5806,"Thierry Baudet (FvD)",0.952960012702781,0.620232881102446,0
"<anonymized_userid>",1,72020,5807,"Thierry Baudet (FvD)",0.952973244766719,0.620339707296229,0
"<anonymized_userid>",1,72021,5808,"Thierry Baudet (FvD)",0.952986476830656,0.620446533490012,0
"<anonymized_userid>",1,72022,5809,"Thierry Baudet (FvD)",0.952999708894593,0.620553359683794,0
"<anonymized_userid>",1,72023,5810,"Thierry Baudet (FvD)",0.953012940958531,0.620660185877577,0
"<anonymized_userid>",1,72024,5811,"Thierry Baudet (FvD)",0.953026173022468,0.62076701207136,0
"<anonymized_userid>",1,72025,5812,"Thierry Baudet (FvD)",0.953039405086405,0.620873838265143,0
"<anonymized_userid>",1,72026,5813,"Thierry Baudet (FvD)",0.953052637150343,0.620980664458925,0
"<anonymized_userid>",1,72027,5814,"Thierry Baudet (FvD)",0.95306586921428,0.621087490652708,0
"<anonymized_userid>",1,72028,5815,"Thierry Baudet (FvD)",0.953079101278217,0.621194316846491,0
"<anonymized_userid>",1,72029,5816,"Thierry Baudet (FvD)",0.953092333342155,0.621301143040274,0
"<anonymized_userid>",1,72030,5817,"Thierry Baudet (FvD)",0.953105565406092,0.621407969234056,0
"<anonymized_userid>",1,72031,5818,"Thierry Baudet (FvD)",0.953118797470029,0.621514795427839,0
"<anonymized_userid>",1,72032,5819,"Thierry Baudet (FvD)",0.953132029533967,0.621621621621622,0
"<anonymized_userid>",1,72033,5820,"Thierry Baudet (FvD)",0.953145261597904,0.621728447815404,0
"<anonymized_userid>",1,72034,5821,"Thierry Baudet (FvD)",0.953158493661841,0.621835274009187,0
"<anonymized_userid>",1,72035,5822,"Thierry Baudet (FvD)",0.953171725725779,0.62194210020297,0
"<anonymized_userid>",1,72036,5823,"Thierry Baudet (FvD)",0.953184957789716,0.622048926396752,0
"<anonymized_userid>",1,72037,5824,"Thierry Baudet (FvD)",0.953198189853653,0.622155752590535,0
"<anonymized_userid>",1,72038,5825,"Thierry Baudet (FvD)",0.953211421917591,0.622262578784318,0
"<anonymized_userid>",1,72039,5826,"Thierry Baudet (FvD)",0.953224653981528,0.622369404978101,0
"<anonymized_userid>",1,72040,5827,"Thierry Baudet (FvD)",0.953237886045465,0.622476231171883,0
"<anonymized_userid>",1,72041,5828,"Thierry Baudet (FvD)",0.953251118109403,0.622583057365666,0
"<anonymized_userid>",1,72042,5829,"Thierry Baudet (FvD)",0.95326435017334,0.622689883559449,0
"<anonymized_userid>",1,72043,5830,"Thierry Baudet (FvD)",0.953277582237277,0.622796709753232,0
"<anonymized_userid>",1,72044,5831,"Thierry Baudet (FvD)",0.953290814301215,0.622903535947014,0
"<anonymized_userid>",1,72045,5832,"Thierry Baudet (FvD)",0.953304046365152,0.623010362140797,0
"<anonymized_userid>",1,72046,5833,"Thierry Baudet (FvD)",0.953317278429089,0.62311718833458,0
"<anonymized_userid>",1,72047,5834,"Thierry Baudet (FvD)",0.953330510493027,0.623224014528362,0
"<anonymized_userid>",1,72048,5835,"Thierry Baudet (FvD)",0.953343742556964,0.623330840722145,0
"<anonymized_userid>",1,72049,5836,"Thierry Baudet (FvD)",0.953356974620901,0.623437666915928,0
"<anonymized_userid>",1,72050,5837,"Thierry Baudet (FvD)",0.953370206684839,0.62354449310971,0
"<anonymized_userid>",1,72051,5838,"Thierry Baudet (FvD)",0.953383438748776,0.623651319303493,0
"<anonymized_userid>",1,72052,5839,"Thierry Baudet (FvD)",0.953396670812713,0.623758145497276,0
"<anonymized_userid>",1,72053,5840,"Thierry Baudet (FvD)",0.953409902876651,0.623864971691059,0
"<anonymized_userid>",1,72054,5841,"Thierry Baudet (FvD)",0.953423134940588,0.623971797884841,0
"<anonymized_userid>",1,72055,5842,"Thierry Baudet (FvD)",0.953436367004525,0.624078624078624,0
"<anonymized_userid>",1,72056,5843,"Thierry Baudet (FvD)",0.953449599068463,0.624185450272407,0
"<anonymized_userid>",1,72057,5844,"Thierry Baudet (FvD)",0.9534628311324,0.624292276466189,0
"<anonymized_userid>",1,72058,5845,"Thierry Baudet (FvD)",0.953476063196337,0.624399102659972,0
"<anonymized_userid>",1,72059,5846,"Thierry Baudet (FvD)",0.953489295260275,0.624505928853755,0
"<anonymized_userid>",1,72060,5847,"Thierry Baudet (FvD)",0.953502527324212,0.624612755047538,0
"<anonymized_userid>",1,72061,5848,"Thierry Baudet (FvD)",0.953515759388149,0.62471958124132,0
"<anonymized_userid>",1,72062,5849,"Thierry Baudet (FvD)",0.953528991452087,0.624826407435103,0
"<anonymized_userid>",1,72063,5850,"Thierry Baudet (FvD)",0.953542223516024,0.624933233628886,0
"<anonymized_userid>",1,72064,5851,"Thierry Baudet (FvD)",0.953555455579961,0.625040059822669,0
"<anonymized_userid>",1,72065,5852,"Thierry Baudet (FvD)",0.953568687643899,0.625146886016451,0
"<anonymized_userid>",1,72066,5853,"Thierry Baudet (FvD)",0.953581919707836,0.625253712210234,0
"<anonymized_userid>",1,72067,5854,"Thierry Baudet (FvD)",0.953595151771773,0.625360538404017,0
"<anonymized_userid>",1,72068,5855,"Thierry Baudet (FvD)",0.953608383835711,0.625467364597799,0
"<anonymized_userid>",1,72069,5856,"Thierry Baudet (FvD)",0.953621615899648,0.625574190791582,0
"<anonymized_userid>",1,72070,5857,"Thierry Baudet (FvD)",0.953634847963585,0.625681016985365,0
"<anonymized_userid>",1,72071,5858,"Thierry Baudet (FvD)",0.953648080027523,0.625787843179147,0
"<anonymized_userid>",1,72072,5859,"Thierry Baudet (FvD)",0.95366131209146,0.62589466937293,0
"<anonymized_userid>",1,72073,5860,"Thierry Baudet (FvD)",0.953674544155397,0.626001495566713,0
"<anonymized_userid>",1,72074,5861,"Thierry Baudet (FvD)",0.953687776219335,0.626108321760496,0
"<anonymized_userid>",1,72075,5862,"Thierry Baudet (FvD)",0.953701008283272,0.626215147954278,0
"<anonymized_userid>",1,72076,5863,"Thierry Baudet (FvD)",0.953714240347209,0.626321974148061,0
"<anonymized_userid>",1,72077,5864,"Thierry Baudet (FvD)",0.953727472411147,0.626428800341844,0
"<anonymized_userid>",1,72078,5865,"Thierry Baudet (FvD)",0.953740704475084,0.626535626535627,0
"<anonymized_userid>",1,72079,5866,"Thierry Baudet (FvD)",0.953753936539021,0.626642452729409,0
"<anonymized_userid>",1,72080,5867,"Thierry Baudet (FvD)",0.953767168602959,0.626749278923192,0
"<anonymized_userid>",1,72081,5868,"Thierry Baudet (FvD)",0.953780400666896,0.626856105116975,0
"<anonymized_userid>",1,72082,5869,"Thierry Baudet (FvD)",0.953793632730833,0.626962931310757,0
"<anonymized_userid>",1,72083,5870,"Thierry Baudet (FvD)",0.953806864794771,0.62706975750454,0
"<anonymized_userid>",1,72084,5871,"Thierry Baudet (FvD)",0.953820096858708,0.627176583698323,0
"<anonymized_userid>",1,72085,5872,"Thierry Baudet (FvD)",0.953833328922645,0.627283409892106,0
"<anonymized_userid>",1,72086,5873,"Thierry Baudet (FvD)",0.953846560986583,0.627390236085888,0
"<anonymized_userid>",1,72087,5874,"Thierry Baudet (FvD)",0.95385979305052,0.627497062279671,0
"<anonymized_userid>",1,72088,5875,"Thierry Baudet (FvD)",0.953873025114457,0.627603888473454,0
"<anonymized_userid>",1,72089,5876,"Thierry Baudet (FvD)",0.953886257178395,0.627710714667236,0
"<anonymized_userid>",1,72090,5877,"Thierry Baudet (FvD)",0.953899489242332,0.627817540861019,0
"<anonymized_userid>",1,72091,5878,"Thierry Baudet (FvD)",0.953912721306269,0.627924367054802,0
"<anonymized_userid>",1,72092,5879,"Thierry Baudet (FvD)",0.953925953370207,0.628031193248585,0
"<anonymized_userid>",1,72093,5880,"Thierry Baudet (FvD)",0.953939185434144,0.628138019442367,0
"<anonymized_userid>",1,72094,5881,"Thierry Baudet (FvD)",0.953952417498081,0.62824484563615,0
"<anonymized_userid>",1,72095,5882,"Thierry Baudet (FvD)",0.953965649562019,0.628351671829933,0
"<anonymized_userid>",1,72096,5883,"Thierry Baudet (FvD)",0.953978881625956,0.628458498023715,0
"<anonymized_userid>",1,72097,5884,"Thierry Baudet (FvD)",0.953992113689893,0.628565324217498,0
"<anonymized_userid>",1,72098,5885,"Thierry Baudet (FvD)",0.954005345753831,0.628672150411281,0
"<anonymized_userid>",1,72099,5886,"Thierry Baudet (FvD)",0.954018577817768,0.628778976605064,0
"<anonymized_userid>",1,72100,5887,"Thierry Baudet (FvD)",0.954031809881705,0.628885802798846,0
"<anonymized_userid>",1,72101,5888,"Thierry Baudet (FvD)",0.954045041945643,0.628992628992629,0
"<anonymized_userid>",1,72102,5889,"Thierry Baudet (FvD)",0.95405827400958,0.629099455186412,0
"<anonymized_userid>",1,72103,5890,"Thierry Baudet (FvD)",0.954071506073517,0.629206281380194,0
"<anonymized_userid>",1,72104,5891,"Thierry Baudet (FvD)",0.954084738137455,0.629313107573977,0
"<anonymized_userid>",1,72105,5892,"Thierry Baudet (FvD)",0.954097970201392,0.62941993376776,0
"<anonymized_userid>",1,72106,5893,"Thierry Baudet (FvD)",0.954111202265329,0.629526759961543,0
"<anonymized_userid>",1,72107,5894,"Thierry Baudet (FvD)",0.954124434329267,0.629633586155325,0
"<anonymized_userid>",1,72108,5895,"Thierry Baudet (FvD)",0.954137666393204,0.629740412349108,0
"<anonymized_userid>",1,72109,5896,"Thierry Baudet (FvD)",0.954150898457141,0.629847238542891,0
"<anonymized_userid>",1,72110,5897,"Thierry Baudet (FvD)",0.954164130521079,0.629954064736673,0
"<anonymized_userid>",1,72111,5898,"Thierry Baudet (FvD)",0.954177362585016,0.630060890930456,0
"<anonymized_userid>",1,72112,5899,"Thierry Baudet (FvD)",0.954190594648953,0.630167717124239,0
"<anonymized_userid>",1,72113,5900,"Thierry Baudet (FvD)",0.954203826712891,0.630274543318022,0
"<anonymized_userid>",1,72114,5901,"Thierry Baudet (FvD)",0.954217058776828,0.630381369511804,0
"<anonymized_userid>",1,72115,5902,"Thierry Baudet (FvD)",0.954230290840765,0.630488195705587,0
"<anonymized_userid>",1,72116,5903,"Thierry Baudet (FvD)",0.954243522904703,0.63059502189937,0
"<anonymized_userid>",1,72117,5904,"Thierry Baudet (FvD)",0.95425675496864,0.630701848093152,0
"<anonymized_userid>",1,72118,5905,"Thierry Baudet (FvD)",0.954269987032577,0.630808674286935,0
"<anonymized_userid>",1,72119,5906,"Thierry Baudet (FvD)",0.954283219096515,0.630915500480718,0
"<anonymized_userid>",1,72120,5907,"Thierry Baudet (FvD)",0.954296451160452,0.631022326674501,0
"<anonymized_userid>",1,72121,5908,"Thierry Baudet (FvD)",0.954309683224389,0.631129152868283,0
"<anonymized_userid>",1,72122,5909,"Thierry Baudet (FvD)",0.954322915288327,0.631235979062066,0
"<anonymized_userid>",1,72123,5910,"Thierry Baudet (FvD)",0.954336147352264,0.631342805255849,0
"<anonymized_userid>",1,72124,5911,"Thierry Baudet (FvD)",0.954349379416201,0.631449631449631,0
"<anonymized_userid>",1,72125,5912,"Thierry Baudet (FvD)",0.954362611480139,0.631556457643414,0
"<anonymized_userid>",1,72126,5913,"Thierry Baudet (FvD)",0.954375843544076,0.631663283837197,0
"<anonymized_userid>",1,72127,5914,"Thierry Baudet (FvD)",0.954389075608013,0.63177011003098,0
"<anonymized_userid>",1,72128,5915,"Thierry Baudet (FvD)",0.954402307671951,0.631876936224762,0
"<anonymized_userid>",1,72129,5916,"Thierry Baudet (FvD)",0.954415539735888,0.631983762418545,0
"<anonymized_userid>",1,72130,5917,"Thierry Baudet (FvD)",0.954428771799825,0.632090588612328,0
"<anonymized_userid>",1,72131,5918,"Thierry Baudet (FvD)",0.954442003863763,0.63219741480611,0
"<anonymized_userid>",1,72132,5919,"Thierry Baudet (FvD)",0.9544552359277,0.632304240999893,0
"<anonymized_userid>",1,72133,5920,"Thierry Baudet (FvD)",0.954468467991637,0.632411067193676,0
"<anonymized_userid>",1,72134,5921,"Thierry Baudet (FvD)",0.954481700055575,0.632517893387459,0
"<anonymized_userid>",1,72135,5922,"Thierry Baudet (FvD)",0.954494932119512,0.632624719581241,0
"<anonymized_userid>",1,72136,5923,"Thierry Baudet (FvD)",0.954508164183449,0.632731545775024,0
"<anonymized_userid>",1,72137,5924,"Thierry Baudet (FvD)",0.954521396247387,0.632838371968807,0
"<anonymized_userid>",1,72138,5925,"Thierry Baudet (FvD)",0.954534628311324,0.632945198162589,0
"<anonymized_userid>",1,72139,5926,"Thierry Baudet (FvD)",0.954547860375261,0.633052024356372,0
"<anonymized_userid>",1,72140,5927,"Thierry Baudet (FvD)",0.954561092439199,0.633158850550155,0
"<anonymized_userid>",1,72141,5928,"Thierry Baudet (FvD)",0.954574324503136,0.633265676743938,0
"<anonymized_userid>",1,72142,5929,"Thierry Baudet (FvD)",0.954587556567073,0.63337250293772,0
"<anonymized_userid>",1,72143,5930,"Thierry Baudet (FvD)",0.954600788631011,0.633479329131503,0
"<anonymized_userid>",1,72144,5931,"Thierry Baudet (FvD)",0.954614020694948,0.633586155325286,0
"<anonymized_userid>",1,72145,5932,"Thierry Baudet (FvD)",0.954627252758885,0.633692981519068,0
"<anonymized_userid>",1,72146,5933,"Thierry Baudet (FvD)",0.954640484822823,0.633799807712851,0
"<anonymized_userid>",1,72147,5934,"Thierry Baudet (FvD)",0.95465371688676,0.633906633906634,0
"<anonymized_userid>",1,72148,5935,"Thierry Baudet (FvD)",0.954666948950697,0.634013460100417,0
"<anonymized_userid>",1,72149,5936,"Thierry Baudet (FvD)",0.954680181014635,0.634120286294199,0
"<anonymized_userid>",1,72150,5937,"Thierry Baudet (FvD)",0.954693413078572,0.634227112487982,0
"<anonymized_userid>",1,72151,5938,"Thierry Baudet (FvD)",0.954706645142509,0.634333938681765,0
"<anonymized_userid>",1,72152,5939,"Thierry Baudet (FvD)",0.954719877206447,0.634440764875547,0
"<anonymized_userid>",1,72153,5940,"Thierry Baudet (FvD)",0.954733109270384,0.63454759106933,0
"<anonymized_userid>",1,72154,5941,"Thierry Baudet (FvD)",0.954746341334321,0.634654417263113,0
"<anonymized_userid>",1,72155,5942,"Thierry Baudet (FvD)",0.954759573398259,0.634761243456896,0
"<anonymized_userid>",1,72156,5943,"Thierry Baudet (FvD)",0.954772805462196,0.634868069650678,0
"<anonymized_userid>",1,72157,5944,"Thierry Baudet (FvD)",0.954786037526133,0.634974895844461,0
"<anonymized_userid>",1,72158,5945,"Thierry Baudet (FvD)",0.954799269590071,0.635081722038244,0
"<anonymized_userid>",1,72159,5946,"Thierry Baudet (FvD)",0.954812501654008,0.635188548232027,0
"<anonymized_userid>",1,72160,5947,"Thierry Baudet (FvD)",0.954825733717945,0.635295374425809,0
"<anonymized_userid>",1,72161,5948,"Thierry Baudet (FvD)",0.954838965781883,0.635402200619592,0
"<anonymized_userid>",1,72162,5949,"Thierry Baudet (FvD)",0.95485219784582,0.635509026813375,0
"<anonymized_userid>",1,72163,5950,"Thierry Baudet (FvD)",0.954865429909757,0.635615853007157,0
"<anonymized_userid>",1,72164,5951,"Thierry Baudet (FvD)",0.954878661973695,0.63572267920094,0
"<anonymized_userid>",1,72165,5952,"Thierry Baudet (FvD)",0.954891894037632,0.635829505394723,0
"<anonymized_userid>",1,72166,5953,"Thierry Baudet (FvD)",0.954905126101569,0.635936331588505,0
"<anonymized_userid>",1,72167,5954,"Thierry Baudet (FvD)",0.954918358165507,0.636043157782288,0
"<anonymized_userid>",1,72168,5955,"Thierry Baudet (FvD)",0.954931590229444,0.636149983976071,0
"<anonymized_userid>",1,72169,5956,"Thierry Baudet (FvD)",0.954944822293381,0.636256810169854,0
"<anonymized_userid>",1,72170,5957,"Thierry Baudet (FvD)",0.954958054357319,0.636363636363636,0
"<anonymized_userid>",1,72171,5958,"Thierry Baudet (FvD)",0.954971286421256,0.636470462557419,0
"<anonymized_userid>",1,72172,5959,"Thierry Baudet (FvD)",0.954984518485193,0.636577288751202,0
"<anonymized_userid>",1,72173,5960,"Thierry Baudet (FvD)",0.954997750549131,0.636684114944985,0
"<anonymized_userid>",1,72174,5961,"Thierry Baudet (FvD)",0.955010982613068,0.636790941138767,0
"<anonymized_userid>",1,72175,5962,"Thierry Baudet (FvD)",0.955024214677005,0.63689776733255,0
"<anonymized_userid>",1,72176,5963,"Thierry Baudet (FvD)",0.955037446740943,0.637004593526333,0
"<anonymized_userid>",1,72177,5964,"Thierry Baudet (FvD)",0.95505067880488,0.637111419720115,0
"<anonymized_userid>",1,72178,5965,"Thierry Baudet (FvD)",0.955063910868817,0.637218245913898,0
"<anonymized_userid>",1,72179,5966,"Thierry Baudet (FvD)",0.955077142932755,0.637325072107681,0
"<anonymized_userid>",1,72180,5967,"Thierry Baudet (FvD)",0.955090374996692,0.637431898301464,0
"<anonymized_userid>",1,72181,5968,"Thierry Baudet (FvD)",0.955103607060629,0.637538724495246,0
"<anonymized_userid>",1,72182,5969,"Thierry Baudet (FvD)",0.955116839124567,0.637645550689029,0
"<anonymized_userid>",1,72183,5970,"Thierry Baudet (FvD)",0.955130071188504,0.637752376882812,0
"<anonymized_userid>",1,72184,5971,"Thierry Baudet (FvD)",0.955143303252441,0.637859203076594,0
"<anonymized_userid>",1,72185,5972,"Thierry Baudet (FvD)",0.955156535316379,0.637966029270377,0
"<anonymized_userid>",1,72186,5973,"Thierry Baudet (FvD)",0.955169767380316,0.63807285546416,0
"<anonymized_userid>",1,72187,5974,"Thierry Baudet (FvD)",0.955182999444253,0.638179681657942,0
"<anonymized_userid>",1,72188,5975,"Thierry Baudet (FvD)",0.955196231508191,0.638286507851725,0
"<anonymized_userid>",1,72189,5976,"Thierry Baudet (FvD)",0.955209463572128,0.638393334045508,0
"<anonymized_userid>",1,72190,5977,"Thierry Baudet (FvD)",0.955222695636065,0.638500160239291,0
"<anonymized_userid>",1,72191,5978,"Thierry Baudet (FvD)",0.955235927700003,0.638606986433073,0
"<anonymized_userid>",1,72192,5979,"Thierry Baudet (FvD)",0.95524915976394,0.638713812626856,0
"<anonymized_userid>",1,72193,5980,"Thierry Baudet (FvD)",0.955262391827877,0.638820638820639,0
"<anonymized_userid>",1,72194,5981,"Thierry Baudet (FvD)",0.955275623891815,0.638927465014422,0
"<anonymized_userid>",1,72195,5982,"Thierry Baudet (FvD)",0.955288855955752,0.639034291208204,0
"<anonymized_userid>",1,72196,5983,"Thierry Baudet (FvD)",0.955302088019689,0.639141117401987,0
"<anonymized_userid>",1,72197,5984,"Thierry Baudet (FvD)",0.955315320083627,0.63924794359577,0
"<anonymized_userid>",1,72198,5985,"Thierry Baudet (FvD)",0.955328552147564,0.639354769789552,0
"<anonymized_userid>",1,72199,5986,"Thierry Baudet (FvD)",0.955341784211501,0.639461595983335,0
"<anonymized_userid>",1,72200,5987,"Thierry Baudet (FvD)",0.955355016275439,0.639568422177118,0
"<anonymized_userid>",1,72201,5988,"Thierry Baudet (FvD)",0.955368248339376,0.639675248370901,0
"<anonymized_userid>",1,72202,5989,"Thierry Baudet (FvD)",0.955381480403313,0.639782074564683,0
"<anonymized_userid>",1,72203,5990,"Thierry Baudet (FvD)",0.955394712467251,0.639888900758466,0
"<anonymized_userid>",1,72204,5991,"Thierry Baudet (FvD)",0.955407944531188,0.639995726952249,0
"<anonymized_userid>",1,72205,5992,"Thierry Baudet (FvD)",0.955421176595125,0.640102553146031,0
"<anonymized_userid>",1,72206,5993,"Thierry Baudet (FvD)",0.955434408659063,0.640209379339814,0
"<anonymized_userid>",1,72207,5994,"Thierry Baudet (FvD)",0.955447640723,0.640316205533597,0
"<anonymized_userid>",1,72208,5995,"Thierry Baudet (FvD)",0.955460872786937,0.64042303172738,0
"<anonymized_userid>",1,72209,5996,"Thierry Baudet (FvD)",0.955474104850875,0.640529857921162,0
"<anonymized_userid>",1,72210,5997,"Thierry Baudet (FvD)",0.955487336914812,0.640636684114945,0
"<anonymized_userid>",1,72211,5998,"Thierry Baudet (FvD)",0.955500568978749,0.640743510308728,0
"<anonymized_userid>",1,72212,5999,"Thierry Baudet (FvD)",0.955513801042687,0.64085033650251,0
"<anonymized_userid>",1,72213,6000,"Thierry Baudet (FvD)",0.955527033106624,0.640957162696293,0
"<anonymized_userid>",1,72214,6001,"Thierry Baudet (FvD)",0.955540265170561,0.641063988890076,0
"<anonymized_userid>",1,72215,6002,"Thierry Baudet (FvD)",0.955553497234499,0.641170815083859,0
"<anonymized_userid>",1,72216,6003,"Thierry Baudet (FvD)",0.955566729298436,0.641277641277641,0
"<anonymized_userid>",1,72217,6004,"Thierry Baudet (FvD)",0.955579961362373,0.641384467471424,0
"<anonymized_userid>",1,72218,6005,"Thierry Baudet (FvD)",0.955593193426311,0.641491293665207,0
"<anonymized_userid>",1,72219,6006,"Thierry Baudet (FvD)",0.955606425490248,0.641598119858989,0
"<anonymized_userid>",1,72220,6007,"Thierry Baudet (FvD)",0.955619657554185,0.641704946052772,0
"<anonymized_userid>",1,72221,6008,"Thierry Baudet (FvD)",0.955632889618123,0.641811772246555,0
"<anonymized_userid>",1,72222,6009,"Thierry Baudet (FvD)",0.95564612168206,0.641918598440338,0
"<anonymized_userid>",1,72223,6010,"Thierry Baudet (FvD)",0.955659353745997,0.64202542463412,0
"<anonymized_userid>",1,72224,6011,"Thierry Baudet (FvD)",0.955672585809935,0.642132250827903,0
"<anonymized_userid>",1,72225,6012,"Thierry Baudet (FvD)",0.955685817873872,0.642239077021686,0
"<anonymized_userid>",1,72226,6013,"Thierry Baudet (FvD)",0.955699049937809,0.642345903215468,0
"<anonymized_userid>",1,72227,6014,"Thierry Baudet (FvD)",0.955712282001747,0.642452729409251,0
"<anonymized_userid>",1,72228,6015,"Thierry Baudet (FvD)",0.955725514065684,0.642559555603034,0
"<anonymized_userid>",1,72229,6016,"Thierry Baudet (FvD)",0.955738746129621,0.642666381796817,0
"<anonymized_userid>",1,72230,6017,"Thierry Baudet (FvD)",0.955751978193559,0.642773207990599,0
"<anonymized_userid>",1,72231,6018,"Thierry Baudet (FvD)",0.955765210257496,0.642880034184382,0
"<anonymized_userid>",1,72232,6019,"Thierry Baudet (FvD)",0.955778442321433,0.642986860378165,0
"<anonymized_userid>",1,72233,6020,"Thierry Baudet (FvD)",0.955791674385371,0.643093686571947,0
"<anonymized_userid>",1,72234,6021,"Thierry Baudet (FvD)",0.955804906449308,0.64320051276573,0
"<anonymized_userid>",1,72235,6022,"Thierry Baudet (FvD)",0.955818138513245,0.643307338959513,0
"<anonymized_userid>",1,72236,6023,"Thierry Baudet (FvD)",0.955831370577183,0.643414165153296,0
"<anonymized_userid>",1,72237,6024,"Thierry Baudet (FvD)",0.95584460264112,0.643520991347078,0
"<anonymized_userid>",1,72238,6025,"Thierry Baudet (FvD)",0.955857834705057,0.643627817540861,0
"<anonymized_userid>",1,72239,6026,"Thierry Baudet (FvD)",0.955871066768995,0.643734643734644,0
"<anonymized_userid>",1,72240,6027,"Thierry Baudet (FvD)",0.955884298832932,0.643841469928427,0
"<anonymized_userid>",1,72241,6028,"Thierry Baudet (FvD)",0.955897530896869,0.643948296122209,0
"<anonymized_userid>",1,72242,6029,"Thierry Baudet (FvD)",0.955910762960807,0.644055122315992,0
"<anonymized_userid>",1,72243,6030,"Thierry Baudet (FvD)",0.955923995024744,0.644161948509775,0
"<anonymized_userid>",1,72244,6031,"Thierry Baudet (FvD)",0.955937227088681,0.644268774703557,0
"<anonymized_userid>",1,72245,6032,"Thierry Baudet (FvD)",0.955950459152619,0.64437560089734,0
"<anonymized_userid>",1,72246,6033,"Thierry Baudet (FvD)",0.955963691216556,0.644482427091123,0
"<anonymized_userid>",1,72247,6034,"Thierry Baudet (FvD)",0.955976923280493,0.644589253284905,0
"<anonymized_userid>",1,72248,6035,"Thierry Baudet (FvD)",0.955990155344431,0.644696079478688,0
"<anonymized_userid>",1,72249,6036,"Thierry Baudet (FvD)",0.956003387408368,0.644802905672471,0
"<anonymized_userid>",1,72250,6037,"Thierry Baudet (FvD)",0.956016619472305,0.644909731866254,0
"<anonymized_userid>",1,72251,6038,"Thierry Baudet (FvD)",0.956029851536243,0.645016558060036,0
"<anonymized_userid>",1,72252,6039,"Thierry Baudet (FvD)",0.95604308360018,0.645123384253819,0
"<anonymized_userid>",1,72253,6040,"Thierry Baudet (FvD)",0.956056315664117,0.645230210447602,0
"<anonymized_userid>",1,72254,6041,"Thierry Baudet (FvD)",0.956069547728055,0.645337036641384,0
"<anonymized_userid>",1,72255,6042,"Thierry Baudet (FvD)",0.956082779791992,0.645443862835167,0
"<anonymized_userid>",1,72256,6043,"Thierry Baudet (FvD)",0.956096011855929,0.64555068902895,0
"<anonymized_userid>",1,72257,6044,"Thierry Baudet (FvD)",0.956109243919867,0.645657515222733,0
"<anonymized_userid>",1,72258,6045,"Thierry Baudet (FvD)",0.956122475983804,0.645764341416515,0
"<anonymized_userid>",1,72259,6046,"Thierry Baudet (FvD)",0.956135708047741,0.645871167610298,0
"<anonymized_userid>",1,72260,6047,"Thierry Baudet (FvD)",0.956148940111679,0.645977993804081,0
"<anonymized_userid>",1,72261,6048,"Thierry Baudet (FvD)",0.956162172175616,0.646084819997863,0
"<anonymized_userid>",1,72262,6049,"Thierry Baudet (FvD)",0.956175404239553,0.646191646191646,0
"<anonymized_userid>",1,72263,6050,"Thierry Baudet (FvD)",0.956188636303491,0.646298472385429,0
"<anonymized_userid>",1,72264,6051,"Thierry Baudet (FvD)",0.956201868367428,0.646405298579212,0
"<anonymized_userid>",1,72265,6052,"Thierry Baudet (FvD)",0.956215100431365,0.646512124772994,0
"<anonymized_userid>",1,72266,6053,"Thierry Baudet (FvD)",0.956228332495303,0.646618950966777,0
"<anonymized_userid>",1,72267,6054,"Thierry Baudet (FvD)",0.95624156455924,0.64672577716056,0
"<anonymized_userid>",1,72268,6055,"Thierry Baudet (FvD)",0.956254796623177,0.646832603354342,0
"<anonymized_userid>",1,72269,6056,"Thierry Baudet (FvD)",0.956268028687115,0.646939429548125,0
"<anonymized_userid>",1,72270,6057,"Thierry Baudet (FvD)",0.956281260751052,0.647046255741908,0
"<anonymized_userid>",1,72271,6058,"Thierry Baudet (FvD)",0.956294492814989,0.647153081935691,0
"<anonymized_userid>",1,72272,6059,"Thierry Baudet (FvD)",0.956307724878927,0.647259908129473,0
"<anonymized_userid>",1,72273,6060,"Thierry Baudet (FvD)",0.956320956942864,0.647366734323256,0
"<anonymized_userid>",1,72274,6061,"Thierry Baudet (FvD)",0.956334189006801,0.647473560517039,0
"<anonymized_userid>",1,72275,6062,"Thierry Baudet (FvD)",0.956347421070739,0.647580386710822,0
"<anonymized_userid>",1,72276,6063,"Thierry Baudet (FvD)",0.956360653134676,0.647687212904604,0
"<anonymized_userid>",1,72277,6064,"Thierry Baudet (FvD)",0.956373885198613,0.647794039098387,0
"<anonymized_userid>",1,72278,6065,"Thierry Baudet (FvD)",0.956387117262551,0.64790086529217,0
"<anonymized_userid>",1,72279,6066,"Thierry Baudet (FvD)",0.956400349326488,0.648007691485952,0
"<anonymized_userid>",1,72280,6067,"Thierry Baudet (FvD)",0.956413581390425,0.648114517679735,0
"<anonymized_userid>",1,72281,6068,"Thierry Baudet (FvD)",0.956426813454363,0.648221343873518,0
"<anonymized_userid>",1,72282,6069,"Thierry Baudet (FvD)",0.9564400455183,0.6483281700673,0
"<anonymized_userid>",1,72283,6070,"Thierry Baudet (FvD)",0.956453277582237,0.648434996261083,0
"<anonymized_userid>",1,72284,6071,"Thierry Baudet (FvD)",0.956466509646175,0.648541822454866,0
"<anonymized_userid>",1,72285,6072,"Thierry Baudet (FvD)",0.956479741710112,0.648648648648649,0
"<anonymized_userid>",1,72286,6073,"Thierry Baudet (FvD)",0.956492973774049,0.648755474842431,0
"<anonymized_userid>",1,72287,6074,"Thierry Baudet (FvD)",0.956506205837987,0.648862301036214,0
"<anonymized_userid>",1,72288,6075,"Thierry Baudet (FvD)",0.956519437901924,0.648969127229997,0
"<anonymized_userid>",1,72289,6076,"Thierry Baudet (FvD)",0.956532669965861,0.64907595342378,0
"<anonymized_userid>",1,72290,6077,"Thierry Baudet (FvD)",0.956545902029799,0.649182779617562,0
"<anonymized_userid>",1,72291,6078,"Thierry Baudet (FvD)",0.956559134093736,0.649289605811345,0
"<anonymized_userid>",1,72292,6079,"Thierry Baudet (FvD)",0.956572366157673,0.649396432005128,0
"<anonymized_userid>",1,72293,6080,"Thierry Baudet (FvD)",0.956585598221611,0.64950325819891,0
"<anonymized_userid>",1,72294,6081,"Thierry Baudet (FvD)",0.956598830285548,0.649610084392693,0
"<anonymized_userid>",1,72295,6082,"Thierry Baudet (FvD)",0.956612062349485,0.649716910586476,0
"<anonymized_userid>",1,72296,6083,"Thierry Baudet (FvD)",0.956625294413423,0.649823736780259,0
"<anonymized_userid>",1,72297,6084,"Thierry Baudet (FvD)",0.95663852647736,0.649930562974041,0
"<anonymized_userid>",1,72298,6085,"Thierry Baudet (FvD)",0.956651758541297,0.650037389167824,0
"<anonymized_userid>",1,72299,6086,"Thierry Baudet (FvD)",0.956664990605235,0.650144215361607,0
"<anonymized_userid>",1,72300,6087,"Thierry Baudet (FvD)",0.956678222669172,0.650251041555389,0
"<anonymized_userid>",1,72301,6088,"Thierry Baudet (FvD)",0.956691454733109,0.650357867749172,0
"<anonymized_userid>",1,72302,6089,"Thierry Baudet (FvD)",0.956704686797047,0.650464693942955,0
"<anonymized_userid>",1,72303,6090,"Thierry Baudet (FvD)",0.956717918860984,0.650571520136738,0
"<anonymized_userid>",1,72304,6091,"Thierry Baudet (FvD)",0.956731150924921,0.65067834633052,0
"<anonymized_userid>",1,72305,6092,"Thierry Baudet (FvD)",0.956744382988859,0.650785172524303,0
"<anonymized_userid>",1,72306,6093,"Thierry Baudet (FvD)",0.956757615052796,0.650891998718086,0
"<anonymized_userid>",1,72307,6094,"Thierry Baudet (FvD)",0.956770847116733,0.650998824911868,0
"<anonymized_userid>",1,72308,6095,"Thierry Baudet (FvD)",0.956784079180671,0.651105651105651,0
"<anonymized_userid>",1,72309,6096,"Thierry Baudet (FvD)",0.956797311244608,0.651212477299434,0
"<anonymized_userid>",1,72310,6097,"Thierry Baudet (FvD)",0.956810543308545,0.651319303493217,0
"<anonymized_userid>",1,72311,6098,"Thierry Baudet (FvD)",0.956823775372483,0.651426129686999,0
"<anonymized_userid>",1,72312,6099,"Thierry Baudet (FvD)",0.95683700743642,0.651532955880782,0
"<anonymized_userid>",1,72313,6100,"Thierry Baudet (FvD)",0.956850239500357,0.651639782074565,0
"<anonymized_userid>",1,72314,6101,"Thierry Baudet (FvD)",0.956863471564295,0.651746608268347,0
"<anonymized_userid>",1,72315,6102,"Thierry Baudet (FvD)",0.956876703628232,0.65185343446213,0
"<anonymized_userid>",1,72316,6103,"Thierry Baudet (FvD)",0.956889935692169,0.651960260655913,0
"<anonymized_userid>",1,72317,6104,"Thierry Baudet (FvD)",0.956903167756107,0.652067086849695,0
"<anonymized_userid>",1,72318,6105,"Thierry Baudet (FvD)",0.956916399820044,0.652173913043478,0
"<anonymized_userid>",1,72319,6106,"Thierry Baudet (FvD)",0.956929631883981,0.652280739237261,0
"<anonymized_userid>",1,72320,6107,"Thierry Baudet (FvD)",0.956942863947919,0.652387565431044,0
"<anonymized_userid>",1,72321,6108,"Thierry Baudet (FvD)",0.956956096011856,0.652494391624826,0
"<anonymized_userid>",1,72322,6109,"Thierry Baudet (FvD)",0.956969328075793,0.652601217818609,0
"<anonymized_userid>",1,72323,6110,"Thierry Baudet (FvD)",0.956982560139731,0.652708044012392,0
"<anonymized_userid>",1,72324,6111,"Thierry Baudet (FvD)",0.956995792203668,0.652814870206175,0
"<anonymized_userid>",1,72325,6112,"Thierry Baudet (FvD)",0.957009024267605,0.652921696399957,0
"<anonymized_userid>",1,72326,6113,"Thierry Baudet (FvD)",0.957022256331543,0.65302852259374,0
"<anonymized_userid>",1,72327,6114,"Thierry Baudet (FvD)",0.95703548839548,0.653135348787523,0
"<anonymized_userid>",1,72328,6115,"Thierry Baudet (FvD)",0.957048720459417,0.653242174981305,0
"<anonymized_userid>",1,72329,6116,"Thierry Baudet (FvD)",0.957061952523355,0.653349001175088,0
"<anonymized_userid>",1,72330,6117,"Thierry Baudet (FvD)",0.957075184587292,0.653455827368871,0
"<anonymized_userid>",1,72331,6118,"Thierry Baudet (FvD)",0.957088416651229,0.653562653562654,0
"<anonymized_userid>",1,72332,6119,"Thierry Baudet (FvD)",0.957101648715167,0.653669479756436,0
"<anonymized_userid>",1,72333,6120,"Thierry Baudet (FvD)",0.957114880779104,0.653776305950219,0
"<anonymized_userid>",1,72334,6121,"Thierry Baudet (FvD)",0.957128112843041,0.653883132144002,0
"<anonymized_userid>",1,72335,6122,"Thierry Baudet (FvD)",0.957141344906979,0.653989958337784,0
"<anonymized_userid>",1,72336,6123,"Thierry Baudet (FvD)",0.957154576970916,0.654096784531567,0
"<anonymized_userid>",1,72337,6124,"Thierry Baudet (FvD)",0.957167809034853,0.65420361072535,0
"<anonymized_userid>",1,72338,6125,"Thierry Baudet (FvD)",0.957181041098791,0.654310436919133,0
"<anonymized_userid>",1,72339,6126,"Thierry Baudet (FvD)",0.957194273162728,0.654417263112915,0
"<anonymized_userid>",1,72340,6127,"Thierry Baudet (FvD)",0.957207505226665,0.654524089306698,0
"<anonymized_userid>",1,72341,6128,"Thierry Baudet (FvD)",0.957220737290603,0.654630915500481,0
"<anonymized_userid>",1,72342,6129,"Thierry Baudet (FvD)",0.95723396935454,0.654737741694263,0
"<anonymized_userid>",1,72343,6130,"Thierry Baudet (FvD)",0.957247201418477,0.654844567888046,0
"<anonymized_userid>",1,72344,6131,"Thierry Baudet (FvD)",0.957260433482415,0.654951394081829,0
"<anonymized_userid>",1,72345,6132,"Thierry Baudet (FvD)",0.957273665546352,0.655058220275612,0
"<anonymized_userid>",1,72346,6133,"Thierry Baudet (FvD)",0.957286897610289,0.655165046469394,0
"<anonymized_userid>",1,72347,6134,"Thierry Baudet (FvD)",0.957300129674227,0.655271872663177,0
"<anonymized_userid>",1,72348,6135,"Thierry Baudet (FvD)",0.957313361738164,0.65537869885696,0
"<anonymized_userid>",1,72349,6136,"Thierry Baudet (FvD)",0.957326593802101,0.655485525050742,0
"<anonymized_userid>",1,72350,6137,"Thierry Baudet (FvD)",0.957339825866039,0.655592351244525,0
"<anonymized_userid>",1,72351,6138,"Thierry Baudet (FvD)",0.957353057929976,0.655699177438308,0
"<anonymized_userid>",1,72352,6139,"Thierry Baudet (FvD)",0.957366289993913,0.655806003632091,0
"<anonymized_userid>",1,72353,6140,"Thierry Baudet (FvD)",0.957379522057851,0.655912829825873,0
"<anonymized_userid>",1,72354,6141,"Thierry Baudet (FvD)",0.957392754121788,0.656019656019656,0
"<anonymized_userid>",1,72355,6142,"Thierry Baudet (FvD)",0.957405986185725,0.656126482213439,0
"<anonymized_userid>",1,72356,6143,"Thierry Baudet (FvD)",0.957419218249663,0.656233308407221,0
"<anonymized_userid>",1,72357,6144,"Thierry Baudet (FvD)",0.9574324503136,0.656340134601004,0
"<anonymized_userid>",1,72358,6145,"Thierry Baudet (FvD)",0.957445682377537,0.656446960794787,0
"<anonymized_userid>",1,72359,6146,"Thierry Baudet (FvD)",0.957458914441475,0.65655378698857,0
"<anonymized_userid>",1,72360,6147,"Thierry Baudet (FvD)",0.957472146505412,0.656660613182352,0
"<anonymized_userid>",1,72361,6148,"Thierry Baudet (FvD)",0.957485378569349,0.656767439376135,0
"<anonymized_userid>",1,72362,6149,"Thierry Baudet (FvD)",0.957498610633287,0.656874265569918,0
"<anonymized_userid>",1,72363,6150,"Thierry Baudet (FvD)",0.957511842697224,0.6569810917637,0
"<anonymized_userid>",1,72364,6151,"Thierry Baudet (FvD)",0.957525074761161,0.657087917957483,0
"<anonymized_userid>",1,72365,6152,"Thierry Baudet (FvD)",0.957538306825099,0.657194744151266,0
"<anonymized_userid>",1,72366,6153,"Thierry Baudet (FvD)",0.957551538889036,0.657301570345049,0
"<anonymized_userid>",1,72367,6154,"Thierry Baudet (FvD)",0.957564770952973,0.657408396538831,0
"<anonymized_userid>",1,72368,6155,"Thierry Baudet (FvD)",0.957578003016911,0.657515222732614,0
"<anonymized_userid>",1,72369,6156,"Thierry Baudet (FvD)",0.957591235080848,0.657622048926397,0
"<anonymized_userid>",1,72370,6157,"Thierry Baudet (FvD)",0.957604467144785,0.657728875120179,0
"<anonymized_userid>",1,72371,6158,"Thierry Baudet (FvD)",0.957617699208723,0.657835701313962,0
"<anonymized_userid>",1,72372,6159,"Thierry Baudet (FvD)",0.95763093127266,0.657942527507745,0
"<anonymized_userid>",1,72373,6160,"Thierry Baudet (FvD)",0.957644163336597,0.658049353701528,0
"<anonymized_userid>",1,72374,6161,"Thierry Baudet (FvD)",0.957657395400535,0.65815617989531,0
"<anonymized_userid>",1,72375,6162,"Thierry Baudet (FvD)",0.957670627464472,0.658263006089093,0
"<anonymized_userid>",1,72376,6163,"Thierry Baudet (FvD)",0.957683859528409,0.658369832282876,0
"<anonymized_userid>",1,72377,6164,"Thierry Baudet (FvD)",0.957697091592347,0.658476658476658,0
"<anonymized_userid>",1,72378,6165,"Thierry Baudet (FvD)",0.957710323656284,0.658583484670441,0
"<anonymized_userid>",1,72379,6166,"Thierry Baudet (FvD)",0.957723555720221,0.658690310864224,0
"<anonymized_userid>",1,72380,6167,"Thierry Baudet (FvD)",0.957736787784159,0.658797137058007,0
"<anonymized_userid>",1,72381,6168,"Thierry Baudet (FvD)",0.957750019848096,0.658903963251789,0
"<anonymized_userid>",1,72382,6169,"Thierry Baudet (FvD)",0.957763251912033,0.659010789445572,0
"<anonymized_userid>",1,72383,6170,"Thierry Baudet (FvD)",0.957776483975971,0.659117615639355,0
"<anonymized_userid>",1,72384,6171,"Thierry Baudet (FvD)",0.957789716039908,0.659224441833137,0
"<anonymized_userid>",1,72385,6172,"Thierry Baudet (FvD)",0.957802948103845,0.65933126802692,0
"<anonymized_userid>",1,72386,6173,"Thierry Baudet (FvD)",0.957816180167783,0.659438094220703,0
"<anonymized_userid>",1,72387,6174,"Thierry Baudet (FvD)",0.95782941223172,0.659544920414486,0
"<anonymized_userid>",1,72388,6175,"Thierry Baudet (FvD)",0.957842644295657,0.659651746608268,0
"<anonymized_userid>",1,72389,6176,"Thierry Baudet (FvD)",0.957855876359595,0.659758572802051,0
"<anonymized_userid>",1,72390,6177,"Thierry Baudet (FvD)",0.957869108423532,0.659865398995834,0
"<anonymized_userid>",1,72391,6178,"Thierry Baudet (FvD)",0.957882340487469,0.659972225189617,0
"<anonymized_userid>",1,72392,6179,"Thierry Baudet (FvD)",0.957895572551407,0.660079051383399,0
"<anonymized_userid>",1,72393,6180,"Thierry Baudet (FvD)",0.957908804615344,0.660185877577182,0
"<anonymized_userid>",1,72394,6181,"Thierry Baudet (FvD)",0.957922036679281,0.660292703770965,0
"<anonymized_userid>",1,72395,6182,"Thierry Baudet (FvD)",0.957935268743219,0.660399529964747,0
"<anonymized_userid>",1,72396,6183,"Thierry Baudet (FvD)",0.957948500807156,0.66050635615853,0
"<anonymized_userid>",1,72397,6184,"Thierry Baudet (FvD)",0.957961732871093,0.660613182352313,0
"<anonymized_userid>",1,72398,6185,"Thierry Baudet (FvD)",0.957974964935031,0.660720008546095,0
"<anonymized_userid>",1,72399,6186,"Thierry Baudet (FvD)",0.957988196998968,0.660826834739878,0
"<anonymized_userid>",1,72400,6187,"Thierry Baudet (FvD)",0.958001429062905,0.660933660933661,0
"<anonymized_userid>",1,72401,6188,"Thierry Baudet (FvD)",0.958014661126843,0.661040487127444,0
"<anonymized_userid>",1,72402,6189,"Thierry Baudet (FvD)",0.95802789319078,0.661147313321226,0
"<anonymized_userid>",1,72403,6190,"Thierry Baudet (FvD)",0.958041125254717,0.661254139515009,0
"<anonymized_userid>",1,72404,6191,"Thierry Baudet (FvD)",0.958054357318655,0.661360965708792,0
"<anonymized_userid>",1,72405,6192,"Thierry Baudet (FvD)",0.958067589382592,0.661467791902575,0
"<anonymized_userid>",1,72406,6193,"Thierry Baudet (FvD)",0.958080821446529,0.661574618096357,0
"<anonymized_userid>",1,72407,6194,"Thierry Baudet (FvD)",0.958094053510467,0.66168144429014,0
"<anonymized_userid>",1,72408,6195,"Thierry Baudet (FvD)",0.958107285574404,0.661788270483923,0
"<anonymized_userid>",1,72409,6196,"Thierry Baudet (FvD)",0.958120517638341,0.661895096677705,0
"<anonymized_userid>",1,72410,6197,"Thierry Baudet (FvD)",0.958133749702279,0.662001922871488,0
"<anonymized_userid>",1,72411,6198,"Thierry Baudet (FvD)",0.958146981766216,0.662108749065271,0
"<anonymized_userid>",1,72412,6199,"Thierry Baudet (FvD)",0.958160213830153,0.662215575259054,0
"<anonymized_userid>",1,72413,6200,"Thierry Baudet (FvD)",0.958173445894091,0.662322401452836,0
"<anonymized_userid>",1,72414,6201,"Thierry Baudet (FvD)",0.958186677958028,0.662429227646619,0
"<anonymized_userid>",1,72415,6202,"Thierry Baudet (FvD)",0.958199910021965,0.662536053840402,0
"<anonymized_userid>",1,72416,6203,"Thierry Baudet (FvD)",0.958213142085903,0.662642880034184,0
"<anonymized_userid>",1,72417,6204,"Thierry Baudet (FvD)",0.95822637414984,0.662749706227967,0
"<anonymized_userid>",1,72418,6205,"Thierry Baudet (FvD)",0.958239606213777,0.66285653242175,0
"<anonymized_userid>",1,72419,6206,"Thierry Baudet (FvD)",0.958252838277715,0.662963358615533,0
"<anonymized_userid>",1,72420,6207,"Thierry Baudet (FvD)",0.958266070341652,0.663070184809315,0
"<anonymized_userid>",1,72421,6208,"Thierry Baudet (FvD)",0.958279302405589,0.663177011003098,0
"<anonymized_userid>",1,72422,6209,"Thierry Baudet (FvD)",0.958292534469527,0.663283837196881,0
"<anonymized_userid>",1,72423,6210,"Thierry Baudet (FvD)",0.958305766533464,0.663390663390663,0
"<anonymized_userid>",1,72424,6211,"Thierry Baudet (FvD)",0.958318998597401,0.663497489584446,0
"<anonymized_userid>",1,72425,6212,"Thierry Baudet (FvD)",0.958332230661339,0.663604315778229,0
"<anonymized_userid>",1,72426,6213,"Thierry Baudet (FvD)",0.958345462725276,0.663711141972012,0
"<anonymized_userid>",1,72427,6214,"Thierry Baudet (FvD)",0.958358694789213,0.663817968165794,0
"<anonymized_userid>",1,72428,6215,"Thierry Baudet (FvD)",0.958371926853151,0.663924794359577,0
"<anonymized_userid>",1,72429,6216,"Thierry Baudet (FvD)",0.958385158917088,0.66403162055336,0
"<anonymized_userid>",1,72430,6217,"Thierry Baudet (FvD)",0.958398390981025,0.664138446747142,0
"<anonymized_userid>",1,72431,6218,"Thierry Baudet (FvD)",0.958411623044963,0.664245272940925,0
"<anonymized_userid>",1,72432,6219,"Thierry Baudet (FvD)",0.9584248551089,0.664352099134708,0
"<anonymized_userid>",1,72433,6220,"Thierry Baudet (FvD)",0.958438087172837,0.66445892532849,0
"<anonymized_userid>",1,72434,6221,"Thierry Baudet (FvD)",0.958451319236775,0.664565751522273,0
"<anonymized_userid>",1,72435,6222,"Thierry Baudet (FvD)",0.958464551300712,0.664672577716056,0
"<anonymized_userid>",1,72436,6223,"Thierry Baudet (FvD)",0.958477783364649,0.664779403909839,0
"<anonymized_userid>",1,72437,6224,"Thierry Baudet (FvD)",0.958491015428587,0.664886230103621,0
"<anonymized_userid>",1,72438,6225,"Thierry Baudet (FvD)",0.958504247492524,0.664993056297404,0
"<anonymized_userid>",1,72439,6226,"Thierry Baudet (FvD)",0.958517479556461,0.665099882491187,0
"<anonymized_userid>",1,72440,6227,"Thierry Baudet (FvD)",0.958530711620399,0.66520670868497,0
"<anonymized_userid>",1,72441,6228,"Thierry Baudet (FvD)",0.958543943684336,0.665313534878752,0
"<anonymized_userid>",1,72442,6229,"Thierry Baudet (FvD)",0.958557175748273,0.665420361072535,0
"<anonymized_userid>",1,72443,6230,"Thierry Baudet (FvD)",0.958570407812211,0.665527187266318,0
"<anonymized_userid>",1,72444,6231,"Thierry Baudet (FvD)",0.958583639876148,0.6656340134601,0
"<anonymized_userid>",1,72445,6232,"Thierry Baudet (FvD)",0.958596871940085,0.665740839653883,0
"<anonymized_userid>",1,72446,6233,"Thierry Baudet (FvD)",0.958610104004023,0.665847665847666,0
"<anonymized_userid>",1,72447,6234,"Thierry Baudet (FvD)",0.95862333606796,0.665954492041449,0
"<anonymized_userid>",1,72448,6235,"Thierry Baudet (FvD)",0.958636568131897,0.666061318235231,0
"<anonymized_userid>",1,72449,6236,"Thierry Baudet (FvD)",0.958649800195835,0.666168144429014,0
"<anonymized_userid>",1,72450,6237,"Thierry Baudet (FvD)",0.958663032259772,0.666274970622797,0
"<anonymized_userid>",1,72451,6238,"Thierry Baudet (FvD)",0.958676264323709,0.666381796816579,0
"<anonymized_userid>",1,72452,6239,"Thierry Baudet (FvD)",0.958689496387647,0.666488623010362,0
"<anonymized_userid>",1,72453,6240,"Thierry Baudet (FvD)",0.958702728451584,0.666595449204145,0
"<anonymized_userid>",1,72454,6241,"Thierry Baudet (FvD)",0.958715960515521,0.666702275397928,0
"<anonymized_userid>",1,72455,6242,"Thierry Baudet (FvD)",0.958729192579459,0.66680910159171,0
"<anonymized_userid>",1,72456,6243,"Thierry Baudet (FvD)",0.958742424643396,0.666915927785493,0
"<anonymized_userid>",1,72457,6244,"Thierry Baudet (FvD)",0.958755656707333,0.667022753979276,0
"<anonymized_userid>",1,72458,6245,"Thierry Baudet (FvD)",0.958768888771271,0.667129580173058,0
"<anonymized_userid>",1,72459,6246,"Thierry Baudet (FvD)",0.958782120835208,0.667236406366841,0
"<anonymized_userid>",1,72460,6247,"Thierry Baudet (FvD)",0.958795352899145,0.667343232560624,0
"<anonymized_userid>",1,72461,6248,"Thierry Baudet (FvD)",0.958808584963083,0.667450058754407,0
"<anonymized_userid>",1,72462,6249,"Thierry Baudet (FvD)",0.95882181702702,0.667556884948189,0
"<anonymized_userid>",1,72463,6250,"Thierry Baudet (FvD)",0.958835049090957,0.667663711141972,0
"<anonymized_userid>",1,72464,6251,"Thierry Baudet (FvD)",0.958848281154895,0.667770537335755,0
"<anonymized_userid>",1,72465,6252,"Thierry Baudet (FvD)",0.958861513218832,0.667877363529537,0
"<anonymized_userid>",1,72466,6253,"Thierry Baudet (FvD)",0.958874745282769,0.66798418972332,0
"<anonymized_userid>",1,72467,6254,"Thierry Baudet (FvD)",0.958887977346706,0.668091015917103,0
"<anonymized_userid>",1,72468,6255,"Thierry Baudet (FvD)",0.958901209410644,0.668197842110886,0
"<anonymized_userid>",1,72469,6256,"Thierry Baudet (FvD)",0.958914441474581,0.668304668304668,0
"<anonymized_userid>",1,72470,6257,"Thierry Baudet (FvD)",0.958927673538518,0.668411494498451,0
"<anonymized_userid>",1,72471,6258,"Thierry Baudet (FvD)",0.958940905602456,0.668518320692234,0
"<anonymized_userid>",1,72472,6259,"Thierry Baudet (FvD)",0.958954137666393,0.668625146886016,0
"<anonymized_userid>",1,72473,6260,"Thierry Baudet (FvD)",0.958967369730331,0.668731973079799,0
"<anonymized_userid>",1,72474,6261,"Thierry Baudet (FvD)",0.958980601794268,0.668838799273582,0
"<anonymized_userid>",1,72475,6262,"Thierry Baudet (FvD)",0.958993833858205,0.668945625467365,0
"<anonymized_userid>",1,72476,6263,"Thierry Baudet (FvD)",0.959007065922143,0.669052451661147,0
"<anonymized_userid>",1,72477,6264,"Thierry Baudet (FvD)",0.95902029798608,0.66915927785493,0
"<anonymized_userid>",1,72478,6265,"Thierry Baudet (FvD)",0.959033530050017,0.669266104048713,0
"<anonymized_userid>",1,72479,6266,"Thierry Baudet (FvD)",0.959046762113955,0.669372930242495,0
"<anonymized_userid>",1,72480,6267,"Thierry Baudet (FvD)",0.959059994177892,0.669479756436278,0
"<anonymized_userid>",1,72481,6268,"Thierry Baudet (FvD)",0.959073226241829,0.669586582630061,0
"<anonymized_userid>",1,72482,6269,"Thierry Baudet (FvD)",0.959086458305767,0.669693408823844,0
"<anonymized_userid>",1,72483,6270,"Thierry Baudet (FvD)",0.959099690369704,0.669800235017626,0
"<anonymized_userid>",1,72484,6271,"Thierry Baudet (FvD)",0.959112922433641,0.669907061211409,0
"<anonymized_userid>",1,72485,6272,"Thierry Baudet (FvD)",0.959126154497579,0.670013887405192,0
"<anonymized_userid>",1,72486,6273,"Thierry Baudet (FvD)",0.959139386561516,0.670120713598975,0
"<anonymized_userid>",1,72487,6274,"Thierry Baudet (FvD)",0.959152618625453,0.670227539792757,0
"<anonymized_userid>",1,72488,6275,"Thierry Baudet (FvD)",0.959165850689391,0.67033436598654,0
"<anonymized_userid>",1,72489,6276,"Thierry Baudet (FvD)",0.959179082753328,0.670441192180323,0
"<anonymized_userid>",1,72490,6277,"Thierry Baudet (FvD)",0.959192314817265,0.670548018374105,0
"<anonymized_userid>",1,72491,6278,"Thierry Baudet (FvD)",0.959205546881203,0.670654844567888,0
"<anonymized_userid>",1,72492,6279,"Thierry Baudet (FvD)",0.95921877894514,0.670761670761671,0
"<anonymized_userid>",1,72493,6280,"Thierry Baudet (FvD)",0.959232011009077,0.670868496955453,0
"<anonymized_userid>",1,72494,6281,"Thierry Baudet (FvD)",0.959245243073015,0.670975323149236,0
"<anonymized_userid>",1,72495,6282,"Thierry Baudet (FvD)",0.959258475136952,0.671082149343019,0
"<anonymized_userid>",1,72496,6283,"Thierry Baudet (FvD)",0.959271707200889,0.671188975536802,0
"<anonymized_userid>",1,72497,6284,"Thierry Baudet (FvD)",0.959284939264826,0.671295801730584,0
"<anonymized_userid>",1,72498,6285,"Thierry Baudet (FvD)",0.959298171328764,0.671402627924367,0
"<anonymized_userid>",1,72499,6286,"Thierry Baudet (FvD)",0.959311403392701,0.67150945411815,0
"<anonymized_userid>",1,72500,6287,"Thierry Baudet (FvD)",0.959324635456638,0.671616280311932,0
"<anonymized_userid>",1,72501,6288,"Thierry Baudet (FvD)",0.959337867520576,0.671723106505715,0
"<anonymized_userid>",1,72502,6289,"Thierry Baudet (FvD)",0.959351099584513,0.671829932699498,0
"<anonymized_userid>",1,72503,6290,"Thierry Baudet (FvD)",0.95936433164845,0.671936758893281,0
"<anonymized_userid>",1,72504,6291,"Thierry Baudet (FvD)",0.959377563712388,0.672043585087063,0
"<anonymized_userid>",1,72505,6292,"Thierry Baudet (FvD)",0.959390795776325,0.672150411280846,0
"<anonymized_userid>",1,72506,6293,"Thierry Baudet (FvD)",0.959404027840263,0.672257237474629,0
"<anonymized_userid>",1,72507,6294,"Thierry Baudet (FvD)",0.9594172599042,0.672364063668412,0
"<anonymized_userid>",1,72508,6295,"Thierry Baudet (FvD)",0.959430491968137,0.672470889862194,0
"<anonymized_userid>",1,72509,6296,"Thierry Baudet (FvD)",0.959443724032075,0.672577716055977,0
"<anonymized_userid>",1,72510,6297,"Thierry Baudet (FvD)",0.959456956096012,0.67268454224976,0
"<anonymized_userid>",1,72511,6298,"Thierry Baudet (FvD)",0.959470188159949,0.672791368443542,0
"<anonymized_userid>",1,72512,6299,"Thierry Baudet (FvD)",0.959483420223887,0.672898194637325,0
"<anonymized_userid>",1,72513,6300,"Thierry Baudet (FvD)",0.959496652287824,0.673005020831108,0
"<anonymized_userid>",1,72514,6301,"Thierry Baudet (FvD)",0.959509884351761,0.67311184702489,0
"<anonymized_userid>",1,72515,6302,"Thierry Baudet (FvD)",0.959523116415699,0.673218673218673,0
"<anonymized_userid>",1,72516,6303,"Thierry Baudet (FvD)",0.959536348479636,0.673325499412456,0
"<anonymized_userid>",1,72517,6304,"Thierry Baudet (FvD)",0.959549580543573,0.673432325606239,0
"<anonymized_userid>",1,72518,6305,"Thierry Baudet (FvD)",0.959562812607511,0.673539151800021,0
"<anonymized_userid>",1,72519,6306,"Thierry Baudet (FvD)",0.959576044671448,0.673645977993804,0
"<anonymized_userid>",1,72520,6307,"Thierry Baudet (FvD)",0.959589276735385,0.673752804187587,0
"<anonymized_userid>",1,72521,6308,"Thierry Baudet (FvD)",0.959602508799323,0.67385963038137,0
"<anonymized_userid>",1,72522,6309,"Thierry Baudet (FvD)",0.95961574086326,0.673966456575152,0
"<anonymized_userid>",1,72523,6310,"Thierry Baudet (FvD)",0.959628972927197,0.674073282768935,0
"<anonymized_userid>",1,72524,6311,"Thierry Baudet (FvD)",0.959642204991135,0.674180108962718,0
"<anonymized_userid>",1,72525,6312,"Thierry Baudet (FvD)",0.959655437055072,0.6742869351565,0
"<anonymized_userid>",1,72526,6313,"Thierry Baudet (FvD)",0.959668669119009,0.674393761350283,0
"<anonymized_userid>",1,72527,6314,"Thierry Baudet (FvD)",0.959681901182946,0.674500587544066,0
"<anonymized_userid>",1,72528,6315,"Thierry Baudet (FvD)",0.959695133246884,0.674607413737848,0
"<anonymized_userid>",1,72529,6316,"Thierry Baudet (FvD)",0.959708365310821,0.674714239931631,0
"<anonymized_userid>",1,72530,6317,"Thierry Baudet (FvD)",0.959721597374758,0.674821066125414,0
"<anonymized_userid>",1,72531,6318,"Thierry Baudet (FvD)",0.959734829438696,0.674927892319197,0
"<anonymized_userid>",1,72532,6319,"Thierry Baudet (FvD)",0.959748061502633,0.675034718512979,0
"<anonymized_userid>",1,72533,6320,"Thierry Baudet (FvD)",0.95976129356657,0.675141544706762,0
"<anonymized_userid>",1,72534,6321,"Thierry Baudet (FvD)",0.959774525630508,0.675248370900545,0
"<anonymized_userid>",1,72535,6322,"Thierry Baudet (FvD)",0.959787757694445,0.675355197094328,0
"<anonymized_userid>",1,72536,6323,"Thierry Baudet (FvD)",0.959800989758382,0.67546202328811,0
"<anonymized_userid>",1,72537,6324,"Thierry Baudet (FvD)",0.95981422182232,0.675568849481893,0
"<anonymized_userid>",1,72538,6325,"Thierry Baudet (FvD)",0.959827453886257,0.675675675675676,0
"<anonymized_userid>",1,72539,6326,"Thierry Baudet (FvD)",0.959840685950195,0.675782501869458,0
"<anonymized_userid>",1,72540,6327,"Thierry Baudet (FvD)",0.959853918014132,0.675889328063241,0
"<anonymized_userid>",1,72541,6328,"Thierry Baudet (FvD)",0.959867150078069,0.675996154257024,0
"<anonymized_userid>",1,72542,6329,"Thierry Baudet (FvD)",0.959880382142007,0.676102980450807,0
"<anonymized_userid>",1,72543,6330,"Thierry Baudet (FvD)",0.959893614205944,0.676209806644589,0
"<anonymized_userid>",1,72544,6331,"Thierry Baudet (FvD)",0.959906846269881,0.676316632838372,0
"<anonymized_userid>",1,72545,6332,"Thierry Baudet (FvD)",0.959920078333819,0.676423459032155,0
"<anonymized_userid>",1,72546,6333,"Thierry Baudet (FvD)",0.959933310397756,0.676530285225937,0
"<anonymized_userid>",1,72547,6334,"Thierry Baudet (FvD)",0.959946542461693,0.67663711141972,0
"<anonymized_userid>",1,72548,6335,"Thierry Baudet (FvD)",0.959959774525631,0.676743937613503,0
"<anonymized_userid>",1,72549,6336,"Thierry Baudet (FvD)",0.959973006589568,0.676850763807286,0
"<anonymized_userid>",1,72550,6337,"Thierry Baudet (FvD)",0.959986238653505,0.676957590001068,0
"<anonymized_userid>",1,72551,6338,"Thierry Baudet (FvD)",0.959999470717443,0.677064416194851,0
"<anonymized_userid>",1,72552,6339,"Thierry Baudet (FvD)",0.96001270278138,0.677171242388634,0
"<anonymized_userid>",1,72553,6340,"Thierry Baudet (FvD)",0.960025934845317,0.677278068582416,0
"<anonymized_userid>",1,72554,6341,"Thierry Baudet (FvD)",0.960039166909255,0.677384894776199,0
"<anonymized_userid>",1,72555,6342,"Thierry Baudet (FvD)",0.960052398973192,0.677491720969982,0
"<anonymized_userid>",1,72556,6343,"Thierry Baudet (FvD)",0.960065631037129,0.677598547163765,0
"<anonymized_userid>",1,72557,6344,"Thierry Baudet (FvD)",0.960078863101066,0.677705373357547,0
"<anonymized_userid>",1,72558,6345,"Thierry Baudet (FvD)",0.960092095165004,0.67781219955133,0
"<anonymized_userid>",1,72559,6346,"Thierry Baudet (FvD)",0.960105327228941,0.677919025745113,0
"<anonymized_userid>",1,72560,6347,"Thierry Baudet (FvD)",0.960118559292878,0.678025851938895,0
"<anonymized_userid>",1,72561,6348,"Thierry Baudet (FvD)",0.960131791356816,0.678132678132678,0
"<anonymized_userid>",1,72562,6349,"Thierry Baudet (FvD)",0.960145023420753,0.678239504326461,0
"<anonymized_userid>",1,72563,6350,"Thierry Baudet (FvD)",0.96015825548469,0.678346330520244,0
"<anonymized_userid>",1,72564,6351,"Thierry Baudet (FvD)",0.960171487548628,0.678453156714026,0
"<anonymized_userid>",1,72565,6352,"Thierry Baudet (FvD)",0.960184719612565,0.678559982907809,0
"<anonymized_userid>",1,72566,6353,"Thierry Baudet (FvD)",0.960197951676502,0.678666809101592,0
"<anonymized_userid>",1,72567,6354,"Thierry Baudet (FvD)",0.96021118374044,0.678773635295374,0
"<anonymized_userid>",1,72568,6355,"Thierry Baudet (FvD)",0.960224415804377,0.678880461489157,0
"<anonymized_userid>",1,72569,6356,"Thierry Baudet (FvD)",0.960237647868314,0.67898728768294,0
"<anonymized_userid>",1,72570,6357,"Thierry Baudet (FvD)",0.960250879932252,0.679094113876723,0
"<anonymized_userid>",1,72571,6358,"Thierry Baudet (FvD)",0.960264111996189,0.679200940070505,0
"<anonymized_userid>",1,72572,6359,"Thierry Baudet (FvD)",0.960277344060127,0.679307766264288,0
"<anonymized_userid>",1,72573,6360,"Thierry Baudet (FvD)",0.960290576124064,0.679414592458071,0
"<anonymized_userid>",1,72574,6361,"Thierry Baudet (FvD)",0.960303808188001,0.679521418651853,0
"<anonymized_userid>",1,72575,6362,"Thierry Baudet (FvD)",0.960317040251939,0.679628244845636,0
"<anonymized_userid>",1,72576,6363,"Thierry Baudet (FvD)",0.960330272315876,0.679735071039419,0
"<anonymized_userid>",1,72577,6364,"Thierry Baudet (FvD)",0.960343504379813,0.679841897233202,0
"<anonymized_userid>",1,72578,6365,"Thierry Baudet (FvD)",0.960356736443751,0.679948723426984,0
"<anonymized_userid>",1,72579,6366,"Thierry Baudet (FvD)",0.960369968507688,0.680055549620767,0
"<anonymized_userid>",1,72580,6367,"Thierry Baudet (FvD)",0.960383200571625,0.68016237581455,0
"<anonymized_userid>",1,72581,6368,"Thierry Baudet (FvD)",0.960396432635563,0.680269202008332,0
"<anonymized_userid>",1,72582,6369,"Thierry Baudet (FvD)",0.9604096646995,0.680376028202115,0
"<anonymized_userid>",1,72583,6370,"Thierry Baudet (FvD)",0.960422896763437,0.680482854395898,0
"<anonymized_userid>",1,72584,6371,"Thierry Baudet (FvD)",0.960436128827375,0.680589680589681,0
"<anonymized_userid>",1,72585,6372,"Thierry Baudet (FvD)",0.960449360891312,0.680696506783463,0
"<anonymized_userid>",1,72586,6373,"Thierry Baudet (FvD)",0.960462592955249,0.680803332977246,0
"<anonymized_userid>",1,72587,6374,"Thierry Baudet (FvD)",0.960475825019186,0.680910159171029,0
"<anonymized_userid>",1,72588,6375,"Thierry Baudet (FvD)",0.960489057083124,0.681016985364811,0
"<anonymized_userid>",1,72589,6376,"Thierry Baudet (FvD)",0.960502289147061,0.681123811558594,0
"<anonymized_userid>",1,72590,6377,"Thierry Baudet (FvD)",0.960515521210998,0.681230637752377,0
"<anonymized_userid>",1,72591,6378,"Thierry Baudet (FvD)",0.960528753274936,0.68133746394616,0
"<anonymized_userid>",1,72592,6379,"Thierry Baudet (FvD)",0.960541985338873,0.681444290139942,0
"<anonymized_userid>",1,72593,6380,"Thierry Baudet (FvD)",0.96055521740281,0.681551116333725,0
"<anonymized_userid>",1,72594,6381,"Thierry Baudet (FvD)",0.960568449466748,0.681657942527508,0
"<anonymized_userid>",1,72595,6382,"Thierry Baudet (FvD)",0.960581681530685,0.68176476872129,0
"<anonymized_userid>",1,72596,6383,"Thierry Baudet (FvD)",0.960594913594622,0.681871594915073,0
"<anonymized_userid>",1,72597,6384,"Thierry Baudet (FvD)",0.96060814565856,0.681978421108856,0
"<anonymized_userid>",1,72598,6385,"Thierry Baudet (FvD)",0.960621377722497,0.682085247302639,0
"<anonymized_userid>",1,72599,6386,"Thierry Baudet (FvD)",0.960634609786434,0.682192073496421,0
"<anonymized_userid>",1,72600,6387,"Thierry Baudet (FvD)",0.960647841850372,0.682298899690204,0
"<anonymized_userid>",1,72601,6388,"Thierry Baudet (FvD)",0.960661073914309,0.682405725883987,0
"<anonymized_userid>",1,72602,6389,"Thierry Baudet (FvD)",0.960674305978246,0.68251255207777,0
"<anonymized_userid>",1,72603,6390,"Thierry Baudet (FvD)",0.960687538042184,0.682619378271552,0
"<anonymized_userid>",1,72604,6391,"Thierry Baudet (FvD)",0.960700770106121,0.682726204465335,0
"<anonymized_userid>",1,72605,6392,"Thierry Baudet (FvD)",0.960714002170059,0.682833030659118,0
"<anonymized_userid>",1,72606,6393,"Thierry Baudet (FvD)",0.960727234233996,0.6829398568529,0
"<anonymized_userid>",1,72607,6394,"Thierry Baudet (FvD)",0.960740466297933,0.683046683046683,0
"<anonymized_userid>",1,72608,6395,"Thierry Baudet (FvD)",0.960753698361871,0.683153509240466,0
"<anonymized_userid>",1,72609,6396,"Thierry Baudet (FvD)",0.960766930425808,0.683260335434248,0
"<anonymized_userid>",1,72610,6397,"Thierry Baudet (FvD)",0.960780162489745,0.683367161628031,0
"<anonymized_userid>",1,72611,6398,"Thierry Baudet (FvD)",0.960793394553683,0.683473987821814,0
"<anonymized_userid>",1,72612,6399,"Thierry Baudet (FvD)",0.96080662661762,0.683580814015597,0
"<anonymized_userid>",1,72613,6400,"Thierry Baudet (FvD)",0.960819858681557,0.683687640209379,0
"<anonymized_userid>",1,72614,6401,"Thierry Baudet (FvD)",0.960833090745495,0.683794466403162,0
"<anonymized_userid>",1,72615,6402,"Thierry Baudet (FvD)",0.960846322809432,0.683901292596945,0
"<anonymized_userid>",1,72616,6403,"Thierry Baudet (FvD)",0.960859554873369,0.684008118790728,0
"<anonymized_userid>",1,72617,6404,"Thierry Baudet (FvD)",0.960872786937306,0.68411494498451,0
"<anonymized_userid>",1,72618,6405,"Thierry Baudet (FvD)",0.960886019001244,0.684221771178293,0
"<anonymized_userid>",1,72619,6406,"Thierry Baudet (FvD)",0.960899251065181,0.684328597372076,0
"<anonymized_userid>",1,72620,6407,"Thierry Baudet (FvD)",0.960912483129118,0.684435423565858,0
"<anonymized_userid>",1,72621,6408,"Thierry Baudet (FvD)",0.960925715193056,0.684542249759641,0
"<anonymized_userid>",1,72622,6409,"Thierry Baudet (FvD)",0.960938947256993,0.684649075953424,0
"<anonymized_userid>",1,72623,6410,"Thierry Baudet (FvD)",0.96095217932093,0.684755902147206,0
"<anonymized_userid>",1,72624,6411,"Thierry Baudet (FvD)",0.960965411384868,0.684862728340989,0
"<anonymized_userid>",1,72625,6412,"Thierry Baudet (FvD)",0.960978643448805,0.684969554534772,0
"<anonymized_userid>",1,72626,6413,"Thierry Baudet (FvD)",0.960991875512742,0.685076380728555,0
"<anonymized_userid>",1,72627,6414,"Thierry Baudet (FvD)",0.96100510757668,0.685183206922337,0
"<anonymized_userid>",1,72628,6415,"Thierry Baudet (FvD)",0.961018339640617,0.68529003311612,0
"<anonymized_userid>",1,72629,6416,"Thierry Baudet (FvD)",0.961031571704554,0.685396859309903,0
"<anonymized_userid>",1,72630,6417,"Thierry Baudet (FvD)",0.961044803768492,0.685503685503685,0
"<anonymized_userid>",1,72631,6418,"Thierry Baudet (FvD)",0.961058035832429,0.685610511697468,0
"<anonymized_userid>",1,72632,6419,"Thierry Baudet (FvD)",0.961071267896366,0.685717337891251,0
"<anonymized_userid>",1,72633,6420,"Thierry Baudet (FvD)",0.961084499960304,0.685824164085034,0
"<anonymized_userid>",1,72634,6421,"Thierry Baudet (FvD)",0.961097732024241,0.685930990278816,0
"<anonymized_userid>",1,72635,6422,"Thierry Baudet (FvD)",0.961110964088178,0.686037816472599,0
"<anonymized_userid>",1,72636,6423,"Thierry Baudet (FvD)",0.961124196152116,0.686144642666382,0
"<anonymized_userid>",1,72637,6424,"Thierry Baudet (FvD)",0.961137428216053,0.686251468860165,0
"<anonymized_userid>",1,72638,6425,"Thierry Baudet (FvD)",0.961150660279991,0.686358295053947,0
"<anonymized_userid>",1,72639,6426,"Thierry Baudet (FvD)",0.961163892343928,0.68646512124773,0
"<anonymized_userid>",1,72640,6427,"Thierry Baudet (FvD)",0.961177124407865,0.686571947441513,0
"<anonymized_userid>",1,72641,6428,"Thierry Baudet (FvD)",0.961190356471803,0.686678773635295,0
"<anonymized_userid>",1,72642,6429,"Thierry Baudet (FvD)",0.96120358853574,0.686785599829078,0
"<anonymized_userid>",1,72643,6430,"Thierry Baudet (FvD)",0.961216820599677,0.686892426022861,0
"<anonymized_userid>",1,72644,6431,"Thierry Baudet (FvD)",0.961230052663614,0.686999252216643,0
"<anonymized_userid>",1,72645,6432,"Thierry Baudet (FvD)",0.961243284727552,0.687106078410426,0
"<anonymized_userid>",1,72646,6433,"Thierry Baudet (FvD)",0.961256516791489,0.687212904604209,0
"<anonymized_userid>",1,72647,6434,"Thierry Baudet (FvD)",0.961269748855426,0.687319730797992,0
"<anonymized_userid>",1,72648,6435,"Thierry Baudet (FvD)",0.961282980919364,0.687426556991774,0
"<anonymized_userid>",1,72649,6436,"Thierry Baudet (FvD)",0.961296212983301,0.687533383185557,0
"<anonymized_userid>",1,72650,6437,"Thierry Baudet (FvD)",0.961309445047238,0.68764020937934,0
"<anonymized_userid>",1,72651,6438,"Thierry Baudet (FvD)",0.961322677111176,0.687747035573123,0
"<anonymized_userid>",1,72652,6439,"Thierry Baudet (FvD)",0.961335909175113,0.687853861766905,0
"<anonymized_userid>",1,72653,6440,"Thierry Baudet (FvD)",0.96134914123905,0.687960687960688,0
"<anonymized_userid>",1,72654,6441,"Thierry Baudet (FvD)",0.961362373302988,0.688067514154471,0
"<anonymized_userid>",1,72655,6442,"Thierry Baudet (FvD)",0.961375605366925,0.688174340348253,0
"<anonymized_userid>",1,72656,6443,"Thierry Baudet (FvD)",0.961388837430862,0.688281166542036,0
"<anonymized_userid>",1,72657,6444,"Thierry Baudet (FvD)",0.9614020694948,0.688387992735819,0
"<anonymized_userid>",1,72658,6445,"Thierry Baudet (FvD)",0.961415301558737,0.688494818929602,0
"<anonymized_userid>",1,72659,6446,"Thierry Baudet (FvD)",0.961428533622674,0.688601645123384,0
"<anonymized_userid>",1,72660,6447,"Thierry Baudet (FvD)",0.961441765686612,0.688708471317167,0
"<anonymized_userid>",1,72661,6448,"Thierry Baudet (FvD)",0.961454997750549,0.68881529751095,0
"<anonymized_userid>",1,72662,6449,"Thierry Baudet (FvD)",0.961468229814486,0.688922123704732,0
"<anonymized_userid>",1,72663,6450,"Thierry Baudet (FvD)",0.961481461878424,0.689028949898515,0
"<anonymized_userid>",1,72664,6451,"Thierry Baudet (FvD)",0.961494693942361,0.689135776092298,0
"<anonymized_userid>",1,72665,6452,"Thierry Baudet (FvD)",0.961507926006298,0.689242602286081,0
"<anonymized_userid>",1,72666,6453,"Thierry Baudet (FvD)",0.961521158070236,0.689349428479863,0
"<anonymized_userid>",1,72667,6454,"Thierry Baudet (FvD)",0.961534390134173,0.689456254673646,0
"<anonymized_userid>",1,72668,6455,"Thierry Baudet (FvD)",0.96154762219811,0.689563080867429,0
"<anonymized_userid>",1,72669,6456,"Thierry Baudet (FvD)",0.961560854262048,0.689669907061211,0
"<anonymized_userid>",1,72670,6457,"Thierry Baudet (FvD)",0.961574086325985,0.689776733254994,0
"<anonymized_userid>",1,72671,6458,"Thierry Baudet (FvD)",0.961587318389923,0.689883559448777,0
"<anonymized_userid>",1,72672,6459,"Thierry Baudet (FvD)",0.96160055045386,0.68999038564256,0
"<anonymized_userid>",1,72673,6460,"Thierry Baudet (FvD)",0.961613782517797,0.690097211836342,0
"<anonymized_userid>",1,72674,6461,"Thierry Baudet (FvD)",0.961627014581734,0.690204038030125,0
"<anonymized_userid>",1,72675,6462,"Thierry Baudet (FvD)",0.961640246645672,0.690310864223908,0
"<anonymized_userid>",1,72676,6463,"Thierry Baudet (FvD)",0.961653478709609,0.69041769041769,0
"<anonymized_userid>",1,72677,6464,"Thierry Baudet (FvD)",0.961666710773546,0.690524516611473,0
"<anonymized_userid>",1,72678,6465,"Thierry Baudet (FvD)",0.961679942837484,0.690631342805256,0
"<anonymized_userid>",1,72679,6466,"Thierry Baudet (FvD)",0.961693174901421,0.690738168999039,0
"<anonymized_userid>",1,72680,6467,"Thierry Baudet (FvD)",0.961706406965358,0.690844995192821,0
"<anonymized_userid>",1,72681,6468,"Thierry Baudet (FvD)",0.961719639029296,0.690951821386604,0
"<anonymized_userid>",1,72682,6469,"Thierry Baudet (FvD)",0.961732871093233,0.691058647580387,0
"<anonymized_userid>",1,72683,6470,"Thierry Baudet (FvD)",0.96174610315717,0.691165473774169,0
"<anonymized_userid>",1,72684,6471,"Thierry Baudet (FvD)",0.961759335221108,0.691272299967952,0
"<anonymized_userid>",1,72685,6472,"Thierry Baudet (FvD)",0.961772567285045,0.691379126161735,0
"<anonymized_userid>",1,72686,6473,"Thierry Baudet (FvD)",0.961785799348982,0.691485952355518,0
"<anonymized_userid>",1,72687,6474,"Thierry Baudet (FvD)",0.96179903141292,0.6915927785493,0
"<anonymized_userid>",1,72688,6475,"Thierry Baudet (FvD)",0.961812263476857,0.691699604743083,0
"<anonymized_userid>",1,72689,6476,"Thierry Baudet (FvD)",0.961825495540794,0.691806430936866,0
"<anonymized_userid>",1,72690,6477,"Thierry Baudet (FvD)",0.961838727604732,0.691913257130648,0
"<anonymized_userid>",1,72691,6478,"Thierry Baudet (FvD)",0.961851959668669,0.692020083324431,0
"<anonymized_userid>",1,72692,6479,"Thierry Baudet (FvD)",0.961865191732606,0.692126909518214,0
"<anonymized_userid>",1,72693,6480,"Thierry Baudet (FvD)",0.961878423796544,0.692233735711997,0
"<anonymized_userid>",1,72694,6481,"Thierry Baudet (FvD)",0.961891655860481,0.692340561905779,0
"<anonymized_userid>",1,72695,6482,"Thierry Baudet (FvD)",0.961904887924418,0.692447388099562,0
"<anonymized_userid>",1,72696,6483,"Thierry Baudet (FvD)",0.961918119988356,0.692554214293345,0
"<anonymized_userid>",1,72697,6484,"Thierry Baudet (FvD)",0.961931352052293,0.692661040487127,0
"<anonymized_userid>",1,72698,6485,"Thierry Baudet (FvD)",0.96194458411623,0.69276786668091,0
"<anonymized_userid>",1,72699,6486,"Thierry Baudet (FvD)",0.961957816180168,0.692874692874693,0
"<anonymized_userid>",1,72700,6487,"Thierry Baudet (FvD)",0.961971048244105,0.692981519068476,0
"<anonymized_userid>",1,72701,6488,"Thierry Baudet (FvD)",0.961984280308042,0.693088345262258,0
"<anonymized_userid>",1,72702,6489,"Thierry Baudet (FvD)",0.96199751237198,0.693195171456041,0
"<anonymized_userid>",1,72703,6490,"Thierry Baudet (FvD)",0.962010744435917,0.693301997649824,0
"<anonymized_userid>",1,72704,6491,"Thierry Baudet (FvD)",0.962023976499854,0.693408823843606,0
"<anonymized_userid>",1,72705,6492,"Thierry Baudet (FvD)",0.962037208563792,0.693515650037389,0
"<anonymized_userid>",1,72706,6493,"Thierry Baudet (FvD)",0.962050440627729,0.693622476231172,0
"<anonymized_userid>",1,72707,6494,"Thierry Baudet (FvD)",0.962063672691666,0.693729302424955,0
"<anonymized_userid>",1,72708,6495,"Thierry Baudet (FvD)",0.962076904755604,0.693836128618737,0
"<anonymized_userid>",1,72709,6496,"Thierry Baudet (FvD)",0.962090136819541,0.69394295481252,0
"<anonymized_userid>",1,72710,6497,"Thierry Baudet (FvD)",0.962103368883478,0.694049781006303,0
"<anonymized_userid>",1,72711,6498,"Thierry Baudet (FvD)",0.962116600947416,0.694156607200085,0
"<anonymized_userid>",1,72712,6499,"Thierry Baudet (FvD)",0.962129833011353,0.694263433393868,0
"<anonymized_userid>",1,72713,6500,"Thierry Baudet (FvD)",0.96214306507529,0.694370259587651,0
"<anonymized_userid>",1,72714,6501,"Thierry Baudet (FvD)",0.962156297139228,0.694477085781434,0
"<anonymized_userid>",1,72715,6502,"Thierry Baudet (FvD)",0.962169529203165,0.694583911975216,0
"<anonymized_userid>",1,72716,6503,"Thierry Baudet (FvD)",0.962182761267102,0.694690738168999,0
"<anonymized_userid>",1,72717,6504,"Thierry Baudet (FvD)",0.96219599333104,0.694797564362782,0
"<anonymized_userid>",1,72718,6505,"Thierry Baudet (FvD)",0.962209225394977,0.694904390556564,0
"<anonymized_userid>",1,72719,6506,"Thierry Baudet (FvD)",0.962222457458914,0.695011216750347,0
"<anonymized_userid>",1,72720,6507,"Thierry Baudet (FvD)",0.962235689522852,0.69511804294413,0
"<anonymized_userid>",1,72721,6508,"Thierry Baudet (FvD)",0.962248921586789,0.695224869137913,0
"<anonymized_userid>",1,72722,6509,"Thierry Baudet (FvD)",0.962262153650726,0.695331695331695,0
"<anonymized_userid>",1,72723,6510,"Thierry Baudet (FvD)",0.962275385714664,0.695438521525478,0
"<anonymized_userid>",1,72724,6511,"Thierry Baudet (FvD)",0.962288617778601,0.695545347719261,0
"<anonymized_userid>",1,72725,6512,"Thierry Baudet (FvD)",0.962301849842538,0.695652173913043,0
"<anonymized_userid>",1,72726,6513,"Thierry Baudet (FvD)",0.962315081906476,0.695759000106826,0
"<anonymized_userid>",1,72727,6514,"Thierry Baudet (FvD)",0.962328313970413,0.695865826300609,0
"<anonymized_userid>",1,72728,6515,"Thierry Baudet (FvD)",0.96234154603435,0.695972652494392,0
"<anonymized_userid>",1,72729,6516,"Thierry Baudet (FvD)",0.962354778098288,0.696079478688174,0
"<anonymized_userid>",1,72730,6517,"Thierry Baudet (FvD)",0.962368010162225,0.696186304881957,0
"<anonymized_userid>",1,72731,6518,"Thierry Baudet (FvD)",0.962381242226162,0.69629313107574,0
"<anonymized_userid>",1,72732,6519,"Thierry Baudet (FvD)",0.9623944742901,0.696399957269523,0
"<anonymized_userid>",1,72733,6520,"Thierry Baudet (FvD)",0.962407706354037,0.696506783463305,0
"<anonymized_userid>",1,72734,6521,"Thierry Baudet (FvD)",0.962420938417974,0.696613609657088,0
"<anonymized_userid>",1,72735,6522,"Thierry Baudet (FvD)",0.962434170481912,0.696720435850871,0
"<anonymized_userid>",1,72736,6523,"Thierry Baudet (FvD)",0.962447402545849,0.696827262044653,0
"<anonymized_userid>",1,72737,6524,"Thierry Baudet (FvD)",0.962460634609786,0.696934088238436,0
"<anonymized_userid>",1,72738,6525,"Thierry Baudet (FvD)",0.962473866673724,0.697040914432219,0
"<anonymized_userid>",1,72739,6526,"Thierry Baudet (FvD)",0.962487098737661,0.697147740626001,0
"<anonymized_userid>",1,72740,6527,"Thierry Baudet (FvD)",0.962500330801598,0.697254566819784,0
"<anonymized_userid>",1,72741,6528,"Thierry Baudet (FvD)",0.962513562865536,0.697361393013567,0
"<anonymized_userid>",1,72742,6529,"Thierry Baudet (FvD)",0.962526794929473,0.69746821920735,0
"<anonymized_userid>",1,72743,6530,"Thierry Baudet (FvD)",0.96254002699341,0.697575045401132,0
"<anonymized_userid>",1,72744,6531,"Thierry Baudet (FvD)",0.962553259057348,0.697681871594915,0
"<anonymized_userid>",1,72745,6532,"Thierry Baudet (FvD)",0.962566491121285,0.697788697788698,0
"<anonymized_userid>",1,72746,6533,"Thierry Baudet (FvD)",0.962579723185222,0.697895523982481,0
"<anonymized_userid>",1,72747,6534,"Thierry Baudet (FvD)",0.96259295524916,0.698002350176263,0
"<anonymized_userid>",1,72748,6535,"Thierry Baudet (FvD)",0.962606187313097,0.698109176370046,0
"<anonymized_userid>",1,72749,6536,"Thierry Baudet (FvD)",0.962619419377034,0.698216002563829,0
"<anonymized_userid>",1,72750,6537,"Thierry Baudet (FvD)",0.962632651440972,0.698322828757611,0
"<anonymized_userid>",1,72751,6538,"Thierry Baudet (FvD)",0.962645883504909,0.698429654951394,0
"<anonymized_userid>",1,72752,6539,"Thierry Baudet (FvD)",0.962659115568846,0.698536481145177,0
"<anonymized_userid>",1,72753,6540,"Thierry Baudet (FvD)",0.962672347632784,0.69864330733896,0
"<anonymized_userid>",1,72754,6541,"Thierry Baudet (FvD)",0.962685579696721,0.698750133532742,0
"<anonymized_userid>",1,72755,6542,"Thierry Baudet (FvD)",0.962698811760658,0.698856959726525,0
"<anonymized_userid>",1,72756,6543,"Thierry Baudet (FvD)",0.962712043824596,0.698963785920308,0
"<anonymized_userid>",1,72757,6544,"Thierry Baudet (FvD)",0.962725275888533,0.69907061211409,0
"<anonymized_userid>",1,72758,6545,"Thierry Baudet (FvD)",0.96273850795247,0.699177438307873,0
"<anonymized_userid>",1,72759,6546,"Thierry Baudet (FvD)",0.962751740016408,0.699284264501656,0
"<anonymized_userid>",1,72760,6547,"Thierry Baudet (FvD)",0.962764972080345,0.699391090695438,0
"<anonymized_userid>",1,72761,6548,"Thierry Baudet (FvD)",0.962778204144282,0.699497916889221,0
"<anonymized_userid>",1,72762,6549,"Thierry Baudet (FvD)",0.96279143620822,0.699604743083004,0
"<anonymized_userid>",1,72763,6550,"Thierry Baudet (FvD)",0.962804668272157,0.699711569276787,0
"<anonymized_userid>",1,72764,6551,"Thierry Baudet (FvD)",0.962817900336094,0.699818395470569,0
"<anonymized_userid>",1,72765,6552,"Thierry Baudet (FvD)",0.962831132400032,0.699925221664352,0
"<anonymized_userid>",1,72766,6553,"Thierry Baudet (FvD)",0.962844364463969,0.700032047858135,0
"<anonymized_userid>",1,72767,6554,"Thierry Baudet (FvD)",0.962857596527906,0.700138874051918,0
"<anonymized_userid>",1,72768,6555,"Thierry Baudet (FvD)",0.962870828591844,0.7002457002457,0
"<anonymized_userid>",1,72769,6556,"Thierry Baudet (FvD)",0.962884060655781,0.700352526439483,0
"<anonymized_userid>",1,72770,6557,"Thierry Baudet (FvD)",0.962897292719718,0.700459352633266,0
"<anonymized_userid>",1,72771,6558,"Thierry Baudet (FvD)",0.962910524783656,0.700566178827048,0
"<anonymized_userid>",1,72772,6559,"Thierry Baudet (FvD)",0.962923756847593,0.700673005020831,0
"<anonymized_userid>",1,72773,6560,"Thierry Baudet (FvD)",0.96293698891153,0.700779831214614,0
"<anonymized_userid>",1,72774,6561,"Thierry Baudet (FvD)",0.962950220975468,0.700886657408397,0
"<anonymized_userid>",1,72775,6562,"Thierry Baudet (FvD)",0.962963453039405,0.700993483602179,0
"<anonymized_userid>",1,72776,6563,"Thierry Baudet (FvD)",0.962976685103342,0.701100309795962,0
"<anonymized_userid>",1,72777,6564,"Thierry Baudet (FvD)",0.96298991716728,0.701207135989745,0
"<anonymized_userid>",1,72778,6565,"Thierry Baudet (FvD)",0.963003149231217,0.701313962183527,0
"<anonymized_userid>",1,72779,6566,"Thierry Baudet (FvD)",0.963016381295154,0.70142078837731,0
"<anonymized_userid>",1,72780,6567,"Thierry Baudet (FvD)",0.963029613359092,0.701527614571093,0
"<anonymized_userid>",1,72781,6568,"Thierry Baudet (FvD)",0.963042845423029,0.701634440764876,0
"<anonymized_userid>",1,72782,6569,"Thierry Baudet (FvD)",0.963056077486966,0.701741266958658,0
"<anonymized_userid>",1,72783,6570,"Thierry Baudet (FvD)",0.963069309550904,0.701848093152441,0
"<anonymized_userid>",1,72784,6571,"Thierry Baudet (FvD)",0.963082541614841,0.701954919346224,0
"<anonymized_userid>",1,72785,6572,"Thierry Baudet (FvD)",0.963095773678778,0.702061745540006,0
"<anonymized_userid>",1,72786,6573,"Thierry Baudet (FvD)",0.963109005742716,0.702168571733789,0
"<anonymized_userid>",1,72787,6574,"Thierry Baudet (FvD)",0.963122237806653,0.702275397927572,0
"<anonymized_userid>",1,72788,6575,"Thierry Baudet (FvD)",0.96313546987059,0.702382224121355,0
"<anonymized_userid>",1,72789,6576,"Thierry Baudet (FvD)",0.963148701934528,0.702489050315137,0
"<anonymized_userid>",1,72790,6577,"Thierry Baudet (FvD)",0.963161933998465,0.70259587650892,0
"<anonymized_userid>",1,72791,6578,"Thierry Baudet (FvD)",0.963175166062402,0.702702702702703,0
"<anonymized_userid>",1,72792,6579,"Thierry Baudet (FvD)",0.96318839812634,0.702809528896485,0
"<anonymized_userid>",1,72793,6580,"Thierry Baudet (FvD)",0.963201630190277,0.702916355090268,0
"<anonymized_userid>",1,72794,6581,"Thierry Baudet (FvD)",0.963214862254214,0.703023181284051,0
"<anonymized_userid>",1,72795,6582,"Thierry Baudet (FvD)",0.963228094318152,0.703130007477834,0
"<anonymized_userid>",1,72796,6583,"Thierry Baudet (FvD)",0.963241326382089,0.703236833671616,0
"<anonymized_userid>",1,72797,6584,"Thierry Baudet (FvD)",0.963254558446026,0.703343659865399,0
"<anonymized_userid>",1,72798,6585,"Thierry Baudet (FvD)",0.963267790509964,0.703450486059182,0
"<anonymized_userid>",1,72799,6586,"Thierry Baudet (FvD)",0.963281022573901,0.703557312252964,0
"<anonymized_userid>",1,72800,6587,"Thierry Baudet (FvD)",0.963294254637838,0.703664138446747,0
"<anonymized_userid>",1,72801,6588,"Thierry Baudet (FvD)",0.963307486701776,0.70377096464053,0
"<anonymized_userid>",1,72802,6589,"Thierry Baudet (FvD)",0.963320718765713,0.703877790834313,0
"<anonymized_userid>",1,72803,6590,"Thierry Baudet (FvD)",0.96333395082965,0.703984617028095,0
"<anonymized_userid>",1,72804,6591,"Thierry Baudet (FvD)",0.963347182893588,0.704091443221878,0
"<anonymized_userid>",1,72805,6592,"Thierry Baudet (FvD)",0.963360414957525,0.704198269415661,0
"<anonymized_userid>",1,72806,6593,"Thierry Baudet (FvD)",0.963373647021462,0.704305095609443,0
"<anonymized_userid>",1,72807,6594,"Thierry Baudet (FvD)",0.9633868790854,0.704411921803226,0
"<anonymized_userid>",1,72808,6595,"Thierry Baudet (FvD)",0.963400111149337,0.704518747997009,0
"<anonymized_userid>",1,72809,6596,"Thierry Baudet (FvD)",0.963413343213274,0.704625574190792,0
"<anonymized_userid>",1,72810,6597,"Thierry Baudet (FvD)",0.963426575277212,0.704732400384574,0
"<anonymized_userid>",1,72811,6598,"Thierry Baudet (FvD)",0.963439807341149,0.704839226578357,0
"<anonymized_userid>",1,72812,6599,"Thierry Baudet (FvD)",0.963453039405086,0.70494605277214,0
"<anonymized_userid>",1,72813,6600,"Thierry Baudet (FvD)",0.963466271469024,0.705052878965922,0
"<anonymized_userid>",1,72814,6601,"Thierry Baudet (FvD)",0.963479503532961,0.705159705159705,0
"<anonymized_userid>",1,72815,6602,"Thierry Baudet (FvD)",0.963492735596898,0.705266531353488,0
"<anonymized_userid>",1,72816,6603,"Thierry Baudet (FvD)",0.963505967660836,0.705373357547271,0
"<anonymized_userid>",1,72817,6604,"Thierry Baudet (FvD)",0.963519199724773,0.705480183741053,0
"<anonymized_userid>",1,72818,6605,"Thierry Baudet (FvD)",0.96353243178871,0.705587009934836,0
"<anonymized_userid>",1,72819,6606,"Thierry Baudet (FvD)",0.963545663852648,0.705693836128619,0
"<anonymized_userid>",1,72820,6607,"Thierry Baudet (FvD)",0.963558895916585,0.705800662322401,0
"<anonymized_userid>",1,72821,6608,"Thierry Baudet (FvD)",0.963572127980522,0.705907488516184,0
"<anonymized_userid>",1,72822,6609,"Thierry Baudet (FvD)",0.96358536004446,0.706014314709967,0
"<anonymized_userid>",1,72823,6610,"Thierry Baudet (FvD)",0.963598592108397,0.70612114090375,0
"<anonymized_userid>",1,72824,6611,"Thierry Baudet (FvD)",0.963611824172334,0.706227967097532,0
"<anonymized_userid>",1,72825,6612,"Thierry Baudet (FvD)",0.963625056236272,0.706334793291315,0
"<anonymized_userid>",1,72826,6613,"Thierry Baudet (FvD)",0.963638288300209,0.706441619485098,0
"<anonymized_userid>",1,72827,6614,"Thierry Baudet (FvD)",0.963651520364146,0.70654844567888,0
"<anonymized_userid>",1,72828,6615,"Thierry Baudet (FvD)",0.963664752428084,0.706655271872663,0
"<anonymized_userid>",1,72829,6616,"Thierry Baudet (FvD)",0.963677984492021,0.706762098066446,0
"<anonymized_userid>",1,72830,6617,"Thierry Baudet (FvD)",0.963691216555958,0.706868924260229,0
"<anonymized_userid>",1,72831,6618,"Thierry Baudet (FvD)",0.963704448619896,0.706975750454011,0
"<anonymized_userid>",1,72832,6619,"Thierry Baudet (FvD)",0.963717680683833,0.707082576647794,0
"<anonymized_userid>",1,72833,6620,"Thierry Baudet (FvD)",0.96373091274777,0.707189402841577,0
"<anonymized_userid>",1,72834,6621,"Thierry Baudet (FvD)",0.963744144811708,0.707296229035359,0
"<anonymized_userid>",1,72835,6622,"Thierry Baudet (FvD)",0.963757376875645,0.707403055229142,0
"<anonymized_userid>",1,72836,6623,"Thierry Baudet (FvD)",0.963770608939582,0.707509881422925,0
"<anonymized_userid>",1,72837,6624,"Thierry Baudet (FvD)",0.96378384100352,0.707616707616708,0
"<anonymized_userid>",1,72838,6625,"Thierry Baudet (FvD)",0.963797073067457,0.70772353381049,0
"<anonymized_userid>",1,72839,6626,"Thierry Baudet (FvD)",0.963810305131394,0.707830360004273,0
"<anonymized_userid>",1,72840,6627,"Thierry Baudet (FvD)",0.963823537195332,0.707937186198056,0
"<anonymized_userid>",1,72841,6628,"Thierry Baudet (FvD)",0.963836769259269,0.708044012391838,0
"<anonymized_userid>",1,72842,6629,"Thierry Baudet (FvD)",0.963850001323206,0.708150838585621,0
"<anonymized_userid>",1,72843,6630,"Thierry Baudet (FvD)",0.963863233387144,0.708257664779404,0
"<anonymized_userid>",1,72844,6631,"Thierry Baudet (FvD)",0.963876465451081,0.708364490973187,0
"<anonymized_userid>",1,72845,6632,"Thierry Baudet (FvD)",0.963889697515018,0.708471317166969,0
"<anonymized_userid>",1,72846,6633,"Thierry Baudet (FvD)",0.963902929578956,0.708578143360752,0
"<anonymized_userid>",1,72847,6634,"Thierry Baudet (FvD)",0.963916161642893,0.708684969554535,0
"<anonymized_userid>",1,72848,6635,"Thierry Baudet (FvD)",0.96392939370683,0.708791795748318,0
"<anonymized_userid>",1,72849,6636,"Thierry Baudet (FvD)",0.963942625770768,0.7088986219421,0
"<anonymized_userid>",1,72850,6637,"Thierry Baudet (FvD)",0.963955857834705,0.709005448135883,0
"<anonymized_userid>",1,72851,6638,"Thierry Baudet (FvD)",0.963969089898642,0.709112274329666,0
"<anonymized_userid>",1,72852,6639,"Thierry Baudet (FvD)",0.96398232196258,0.709219100523448,0
"<anonymized_userid>",1,72853,6640,"Thierry Baudet (FvD)",0.963995554026517,0.709325926717231,0
"<anonymized_userid>",1,72854,6641,"Thierry Baudet (FvD)",0.964008786090454,0.709432752911014,0
"<anonymized_userid>",1,72855,6642,"Thierry Baudet (FvD)",0.964022018154392,0.709539579104796,0
"<anonymized_userid>",1,72856,6643,"Thierry Baudet (FvD)",0.964035250218329,0.709646405298579,0
"<anonymized_userid>",1,72857,6644,"Thierry Baudet (FvD)",0.964048482282266,0.709753231492362,0
"<anonymized_userid>",1,72858,6645,"Thierry Baudet (FvD)",0.964061714346204,0.709860057686145,0
"<anonymized_userid>",1,72859,6646,"Thierry Baudet (FvD)",0.964074946410141,0.709966883879927,0
"<anonymized_userid>",1,72860,6647,"Thierry Baudet (FvD)",0.964088178474078,0.71007371007371,0
"<anonymized_userid>",1,72861,6648,"Thierry Baudet (FvD)",0.964101410538016,0.710180536267493,0
"<anonymized_userid>",1,72862,6649,"Thierry Baudet (FvD)",0.964114642601953,0.710287362461276,0
"<anonymized_userid>",1,72863,6650,"Thierry Baudet (FvD)",0.96412787466589,0.710394188655058,0
"<anonymized_userid>",1,72864,6651,"Thierry Baudet (FvD)",0.964141106729828,0.710501014848841,0
"<anonymized_userid>",1,72865,6652,"Thierry Baudet (FvD)",0.964154338793765,0.710607841042624,0
"<anonymized_userid>",1,72866,6653,"Thierry Baudet (FvD)",0.964167570857702,0.710714667236406,0
"<anonymized_userid>",1,72867,6654,"Thierry Baudet (FvD)",0.96418080292164,0.710821493430189,0
"<anonymized_userid>",1,72868,6655,"Thierry Baudet (FvD)",0.964194034985577,0.710928319623972,0
"<anonymized_userid>",1,72869,6656,"Thierry Baudet (FvD)",0.964207267049514,0.711035145817755,0
"<anonymized_userid>",1,72870,6657,"Thierry Baudet (FvD)",0.964220499113452,0.711141972011537,0
"<anonymized_userid>",1,72871,6658,"Thierry Baudet (FvD)",0.964233731177389,0.71124879820532,0
"<anonymized_userid>",1,72872,6659,"Thierry Baudet (FvD)",0.964246963241326,0.711355624399103,0
"<anonymized_userid>",1,72873,6660,"Thierry Baudet (FvD)",0.964260195305264,0.711462450592885,0
"<anonymized_userid>",1,72874,6661,"Thierry Baudet (FvD)",0.964273427369201,0.711569276786668,0
"<anonymized_userid>",1,72875,6662,"Thierry Baudet (FvD)",0.964286659433138,0.711676102980451,0
"<anonymized_userid>",1,72876,6663,"Thierry Baudet (FvD)",0.964299891497076,0.711782929174233,0
"<anonymized_userid>",1,72877,6664,"Thierry Baudet (FvD)",0.964313123561013,0.711889755368016,0
"<anonymized_userid>",1,72878,6665,"Thierry Baudet (FvD)",0.96432635562495,0.711996581561799,0
"<anonymized_userid>",1,72879,6666,"Thierry Baudet (FvD)",0.964339587688888,0.712103407755582,0
"<anonymized_userid>",1,72880,6667,"Thierry Baudet (FvD)",0.964352819752825,0.712210233949364,0
"<anonymized_userid>",1,72881,6668,"Thierry Baudet (FvD)",0.964366051816762,0.712317060143147,0
"<anonymized_userid>",1,72882,6669,"Thierry Baudet (FvD)",0.9643792838807,0.71242388633693,0
"<anonymized_userid>",1,72883,6670,"Thierry Baudet (FvD)",0.964392515944637,0.712530712530713,0
"<anonymized_userid>",1,72884,6671,"Thierry Baudet (FvD)",0.964405748008574,0.712637538724495,0
"<anonymized_userid>",1,72885,6672,"Thierry Baudet (FvD)",0.964418980072512,0.712744364918278,0
"<anonymized_userid>",1,72886,6673,"Thierry Baudet (FvD)",0.964432212136449,0.712851191112061,0
"<anonymized_userid>",1,72887,6674,"Thierry Baudet (FvD)",0.964445444200386,0.712958017305843,0
"<anonymized_userid>",1,72888,6675,"Thierry Baudet (FvD)",0.964458676264324,0.713064843499626,0
"<anonymized_userid>",1,72889,6676,"Thierry Baudet (FvD)",0.964471908328261,0.713171669693409,0
"<anonymized_userid>",1,72890,6677,"Thierry Baudet (FvD)",0.964485140392198,0.713278495887191,0
"<anonymized_userid>",1,72891,6678,"Thierry Baudet (FvD)",0.964498372456136,0.713385322080974,0
"<anonymized_userid>",1,72892,6679,"Thierry Baudet (FvD)",0.964511604520073,0.713492148274757,0
"<anonymized_userid>",1,72893,6680,"Thierry Baudet (FvD)",0.96452483658401,0.71359897446854,0
"<anonymized_userid>",1,72894,6681,"Thierry Baudet (FvD)",0.964538068647948,0.713705800662322,0
"<anonymized_userid>",1,72895,6682,"Thierry Baudet (FvD)",0.964551300711885,0.713812626856105,0
"<anonymized_userid>",1,72896,6683,"Thierry Baudet (FvD)",0.964564532775822,0.713919453049888,0
"<anonymized_userid>",1,72897,6684,"Thierry Baudet (FvD)",0.96457776483976,0.714026279243671,0
"<anonymized_userid>",1,72898,6685,"Thierry Baudet (FvD)",0.964590996903697,0.714133105437453,0
"<anonymized_userid>",1,72899,6686,"Thierry Baudet (FvD)",0.964604228967634,0.714239931631236,0
"<anonymized_userid>",1,72900,6687,"Thierry Baudet (FvD)",0.964617461031572,0.714346757825019,0
"<anonymized_userid>",1,72901,6688,"Thierry Baudet (FvD)",0.964630693095509,0.714453584018801,0
"<anonymized_userid>",1,72902,6689,"Thierry Baudet (FvD)",0.964643925159446,0.714560410212584,0
"<anonymized_userid>",1,72903,6690,"Thierry Baudet (FvD)",0.964657157223384,0.714667236406367,0
"<anonymized_userid>",1,72904,6691,"Thierry Baudet (FvD)",0.964670389287321,0.71477406260015,0
"<anonymized_userid>",1,72905,6692,"Thierry Baudet (FvD)",0.964683621351258,0.714880888793932,0
"<anonymized_userid>",1,72906,6693,"Thierry Baudet (FvD)",0.964696853415196,0.714987714987715,0
"<anonymized_userid>",1,72907,6694,"Thierry Baudet (FvD)",0.964710085479133,0.715094541181498,0
"<anonymized_userid>",1,72908,6695,"Thierry Baudet (FvD)",0.96472331754307,0.71520136737528,0
"<anonymized_userid>",1,72909,6696,"Thierry Baudet (FvD)",0.964736549607008,0.715308193569063,0
"<anonymized_userid>",1,72910,6697,"Thierry Baudet (FvD)",0.964749781670945,0.715415019762846,0
"<anonymized_userid>",1,72911,6698,"Thierry Baudet (FvD)",0.964763013734882,0.715521845956629,0
"<anonymized_userid>",1,72912,6699,"Thierry Baudet (FvD)",0.96477624579882,0.715628672150411,0
"<anonymized_userid>",1,72913,6700,"Thierry Baudet (FvD)",0.964789477862757,0.715735498344194,0
"<anonymized_userid>",1,72914,6701,"Thierry Baudet (FvD)",0.964802709926694,0.715842324537977,0
"<anonymized_userid>",1,72915,6702,"Thierry Baudet (FvD)",0.964815941990632,0.715949150731759,0
"<anonymized_userid>",1,72916,6703,"Thierry Baudet (FvD)",0.964829174054569,0.716055976925542,0
"<anonymized_userid>",1,72917,6704,"Thierry Baudet (FvD)",0.964842406118506,0.716162803119325,0
"<anonymized_userid>",1,72918,6705,"Thierry Baudet (FvD)",0.964855638182444,0.716269629313108,0
"<anonymized_userid>",1,72919,6706,"Thierry Baudet (FvD)",0.964868870246381,0.71637645550689,0
"<anonymized_userid>",1,72920,6707,"Thierry Baudet (FvD)",0.964882102310318,0.716483281700673,0
"<anonymized_userid>",1,72921,6708,"Thierry Baudet (FvD)",0.964895334374256,0.716590107894456,0
"<anonymized_userid>",1,72922,6709,"Thierry Baudet (FvD)",0.964908566438193,0.716696934088238,0
"<anonymized_userid>",1,72923,6710,"Thierry Baudet (FvD)",0.96492179850213,0.716803760282021,0
"<anonymized_userid>",1,72924,6711,"Thierry Baudet (FvD)",0.964935030566068,0.716910586475804,0
"<anonymized_userid>",1,72925,6712,"Thierry Baudet (FvD)",0.964948262630005,0.717017412669587,0
"<anonymized_userid>",1,72926,6713,"Thierry Baudet (FvD)",0.964961494693942,0.717124238863369,0
"<anonymized_userid>",1,72927,6714,"Thierry Baudet (FvD)",0.96497472675788,0.717231065057152,0
"<anonymized_userid>",1,72928,6715,"Thierry Baudet (FvD)",0.964987958821817,0.717337891250935,0
"<anonymized_userid>",1,72929,6716,"Thierry Baudet (FvD)",0.965001190885754,0.717444717444717,0
"<anonymized_userid>",1,72930,6717,"Thierry Baudet (FvD)",0.965014422949692,0.7175515436385,0
"<anonymized_userid>",1,72931,6718,"Thierry Baudet (FvD)",0.965027655013629,0.717658369832283,0
"<anonymized_userid>",1,72932,6719,"Thierry Baudet (FvD)",0.965040887077566,0.717765196026066,0
"<anonymized_userid>",1,72933,6720,"Thierry Baudet (FvD)",0.965054119141504,0.717872022219848,0
"<anonymized_userid>",1,72934,6721,"Thierry Baudet (FvD)",0.965067351205441,0.717978848413631,0
"<anonymized_userid>",1,72935,6722,"Thierry Baudet (FvD)",0.965080583269378,0.718085674607414,0
"<anonymized_userid>",1,72936,6723,"Thierry Baudet (FvD)",0.965093815333316,0.718192500801196,0
"<anonymized_userid>",1,72937,6724,"Thierry Baudet (FvD)",0.965107047397253,0.718299326994979,0
"<anonymized_userid>",1,72938,6725,"Thierry Baudet (FvD)",0.96512027946119,0.718406153188762,0
"<anonymized_userid>",1,72939,6726,"Thierry Baudet (FvD)",0.965133511525128,0.718512979382545,0
"<anonymized_userid>",1,72940,6727,"Thierry Baudet (FvD)",0.965146743589065,0.718619805576327,0
"<anonymized_userid>",1,72941,6728,"Thierry Baudet (FvD)",0.965159975653002,0.71872663177011,0
"<anonymized_userid>",1,72942,6729,"Thierry Baudet (FvD)",0.96517320771694,0.718833457963893,0
"<anonymized_userid>",1,72943,6730,"Thierry Baudet (FvD)",0.965186439780877,0.718940284157675,0
"<anonymized_userid>",1,72944,6731,"Thierry Baudet (FvD)",0.965199671844814,0.719047110351458,0
"<anonymized_userid>",1,72945,6732,"Thierry Baudet (FvD)",0.965212903908752,0.719153936545241,0
"<anonymized_userid>",1,72946,6733,"Thierry Baudet (FvD)",0.965226135972689,0.719260762739024,0
"<anonymized_userid>",1,72947,6734,"Thierry Baudet (FvD)",0.965239368036626,0.719367588932806,0
"<anonymized_userid>",1,72948,6735,"Thierry Baudet (FvD)",0.965252600100564,0.719474415126589,0
"<anonymized_userid>",1,72949,6736,"Thierry Baudet (FvD)",0.965265832164501,0.719581241320372,0
"<anonymized_userid>",1,72950,6737,"Thierry Baudet (FvD)",0.965279064228438,0.719688067514154,0
"<anonymized_userid>",1,72951,6738,"Thierry Baudet (FvD)",0.965292296292376,0.719794893707937,0
"<anonymized_userid>",1,72952,6739,"Thierry Baudet (FvD)",0.965305528356313,0.71990171990172,0
"<anonymized_userid>",1,72953,6740,"Thierry Baudet (FvD)",0.96531876042025,0.720008546095503,0
"<anonymized_userid>",1,72954,6741,"Thierry Baudet (FvD)",0.965331992484188,0.720115372289285,0
"<anonymized_userid>",1,72955,6742,"Thierry Baudet (FvD)",0.965345224548125,0.720222198483068,0
"<anonymized_userid>",1,72956,6743,"Thierry Baudet (FvD)",0.965358456612062,0.720329024676851,0
"<anonymized_userid>",1,72957,6744,"Thierry Baudet (FvD)",0.965371688676,0.720435850870633,0
"<anonymized_userid>",1,72958,6745,"Thierry Baudet (FvD)",0.965384920739937,0.720542677064416,0
"<anonymized_userid>",1,72959,6746,"Thierry Baudet (FvD)",0.965398152803874,0.720649503258199,0
"<anonymized_userid>",1,72960,6747,"Thierry Baudet (FvD)",0.965411384867812,0.720756329451982,0
"<anonymized_userid>",1,72961,6748,"Thierry Baudet (FvD)",0.965424616931749,0.720863155645764,0
"<anonymized_userid>",1,72962,6749,"Thierry Baudet (FvD)",0.965437848995686,0.720969981839547,0
"<anonymized_userid>",1,72963,6750,"Thierry Baudet (FvD)",0.965451081059624,0.72107680803333,0
"<anonymized_userid>",1,72964,6751,"Thierry Baudet (FvD)",0.965464313123561,0.721183634227113,0
"<anonymized_userid>",1,72965,6752,"Thierry Baudet (FvD)",0.965477545187498,0.721290460420895,0
"<anonymized_userid>",1,72966,6753,"Thierry Baudet (FvD)",0.965490777251436,0.721397286614678,0
"<anonymized_userid>",1,72967,6754,"Thierry Baudet (FvD)",0.965504009315373,0.721504112808461,0
"<anonymized_userid>",1,72968,6755,"Thierry Baudet (FvD)",0.96551724137931,0.721610939002243,0
"<anonymized_userid>",1,72969,6756,"Thierry Baudet (FvD)",0.965530473443248,0.721717765196026,0
"<anonymized_userid>",1,72970,6757,"Thierry Baudet (FvD)",0.965543705507185,0.721824591389809,0
"<anonymized_userid>",1,72971,6758,"Thierry Baudet (FvD)",0.965556937571122,0.721931417583591,0
"<anonymized_userid>",1,72972,6759,"Thierry Baudet (FvD)",0.96557016963506,0.722038243777374,0
"<anonymized_userid>",1,72973,6760,"Thierry Baudet (FvD)",0.965583401698997,0.722145069971157,0
"<anonymized_userid>",1,72974,6761,"Thierry Baudet (FvD)",0.965596633762934,0.72225189616494,0
"<anonymized_userid>",1,72975,6762,"Thierry Baudet (FvD)",0.965609865826872,0.722358722358722,0
"<anonymized_userid>",1,72976,6763,"Thierry Baudet (FvD)",0.965623097890809,0.722465548552505,0
"<anonymized_userid>",1,72977,6764,"Thierry Baudet (FvD)",0.965636329954746,0.722572374746288,0
"<anonymized_userid>",1,72978,6765,"Thierry Baudet (FvD)",0.965649562018684,0.722679200940071,0
"<anonymized_userid>",1,72979,6766,"Thierry Baudet (FvD)",0.965662794082621,0.722786027133853,0
"<anonymized_userid>",1,72980,6767,"Thierry Baudet (FvD)",0.965676026146558,0.722892853327636,0
"<anonymized_userid>",1,72981,6768,"Thierry Baudet (FvD)",0.965689258210496,0.722999679521419,0
"<anonymized_userid>",1,72982,6769,"Thierry Baudet (FvD)",0.965702490274433,0.723106505715201,0
"<anonymized_userid>",1,72983,6770,"Thierry Baudet (FvD)",0.96571572233837,0.723213331908984,0
"<anonymized_userid>",1,72984,6771,"Thierry Baudet (FvD)",0.965728954402308,0.723320158102767,0
"<anonymized_userid>",1,72985,6772,"Thierry Baudet (FvD)",0.965742186466245,0.72342698429655,0
"<anonymized_userid>",1,72986,6773,"Thierry Baudet (FvD)",0.965755418530182,0.723533810490332,0
"<anonymized_userid>",1,72987,6774,"Thierry Baudet (FvD)",0.96576865059412,0.723640636684115,0
"<anonymized_userid>",1,72988,6775,"Thierry Baudet (FvD)",0.965781882658057,0.723747462877898,0
"<anonymized_userid>",1,72989,6776,"Thierry Baudet (FvD)",0.965795114721994,0.72385428907168,0
"<anonymized_userid>",1,72990,6777,"Thierry Baudet (FvD)",0.965808346785932,0.723961115265463,0
"<anonymized_userid>",1,72991,6778,"Thierry Baudet (FvD)",0.965821578849869,0.724067941459246,0
"<anonymized_userid>",1,72992,6779,"Thierry Baudet (FvD)",0.965834810913806,0.724174767653029,0
"<anonymized_userid>",1,72993,6780,"Thierry Baudet (FvD)",0.965848042977744,0.724281593846811,0
"<anonymized_userid>",1,72994,6781,"Thierry Baudet (FvD)",0.965861275041681,0.724388420040594,0
"<anonymized_userid>",1,72995,6782,"Thierry Baudet (FvD)",0.965874507105618,0.724495246234377,0
"<anonymized_userid>",1,72996,6783,"Thierry Baudet (FvD)",0.965887739169556,0.724602072428159,0
"<anonymized_userid>",1,72997,6784,"Thierry Baudet (FvD)",0.965900971233493,0.724708898621942,0
"<anonymized_userid>",1,72998,6785,"Thierry Baudet (FvD)",0.96591420329743,0.724815724815725,0
"<anonymized_userid>",1,72999,6786,"Thierry Baudet (FvD)",0.965927435361368,0.724922551009508,0
"<anonymized_userid>",1,73000,6787,"Thierry Baudet (FvD)",0.965940667425305,0.72502937720329,0
"<anonymized_userid>",1,73001,6788,"Thierry Baudet (FvD)",0.965953899489242,0.725136203397073,0
"<anonymized_userid>",1,73002,6789,"Thierry Baudet (FvD)",0.96596713155318,0.725243029590856,0
"<anonymized_userid>",1,73003,6790,"Thierry Baudet (FvD)",0.965980363617117,0.725349855784638,0
"<anonymized_userid>",1,73004,6791,"Thierry Baudet (FvD)",0.965993595681054,0.725456681978421,0
"<anonymized_userid>",1,73005,6792,"Thierry Baudet (FvD)",0.966006827744992,0.725563508172204,0
"<anonymized_userid>",1,73006,6793,"Thierry Baudet (FvD)",0.966020059808929,0.725670334365986,0
"<anonymized_userid>",1,73007,6794,"Thierry Baudet (FvD)",0.966033291872866,0.725777160559769,0
"<anonymized_userid>",1,73008,6795,"Thierry Baudet (FvD)",0.966046523936804,0.725883986753552,0
"<anonymized_userid>",1,73009,6796,"Thierry Baudet (FvD)",0.966059756000741,0.725990812947335,0
"<anonymized_userid>",1,73010,6797,"Thierry Baudet (FvD)",0.966072988064678,0.726097639141117,0
"<anonymized_userid>",1,73011,6798,"Thierry Baudet (FvD)",0.966086220128616,0.7262044653349,0
"<anonymized_userid>",1,73012,6799,"Thierry Baudet (FvD)",0.966099452192553,0.726311291528683,0
"<anonymized_userid>",1,73013,6800,"Thierry Baudet (FvD)",0.96611268425649,0.726418117722466,0
"<anonymized_userid>",1,73014,6801,"Thierry Baudet (FvD)",0.966125916320428,0.726524943916248,0
"<anonymized_userid>",1,73015,6802,"Thierry Baudet (FvD)",0.966139148384365,0.726631770110031,0
"<anonymized_userid>",1,73016,6803,"Thierry Baudet (FvD)",0.966152380448302,0.726738596303814,0
"<anonymized_userid>",1,73017,6804,"Thierry Baudet (FvD)",0.96616561251224,0.726845422497596,0
"<anonymized_userid>",1,73018,6805,"Thierry Baudet (FvD)",0.966178844576177,0.726952248691379,0
"<anonymized_userid>",1,73019,6806,"Thierry Baudet (FvD)",0.966192076640114,0.727059074885162,0
"<anonymized_userid>",1,73020,6807,"Thierry Baudet (FvD)",0.966205308704052,0.727165901078945,0
"<anonymized_userid>",1,73021,6808,"Thierry Baudet (FvD)",0.966218540767989,0.727272727272727,0
"<anonymized_userid>",1,73022,6809,"Thierry Baudet (FvD)",0.966231772831926,0.72737955346651,0
"<anonymized_userid>",1,73023,6810,"Thierry Baudet (FvD)",0.966245004895864,0.727486379660293,0
"<anonymized_userid>",1,73024,6811,"Thierry Baudet (FvD)",0.966258236959801,0.727593205854075,0
"<anonymized_userid>",1,73025,6812,"Thierry Baudet (FvD)",0.966271469023738,0.727700032047858,0
"<anonymized_userid>",1,73026,6813,"Thierry Baudet (FvD)",0.966284701087676,0.727806858241641,0
"<anonymized_userid>",1,73027,6814,"Thierry Baudet (FvD)",0.966297933151613,0.727913684435424,0
"<anonymized_userid>",1,73028,6815,"Thierry Baudet (FvD)",0.96631116521555,0.728020510629206,0
"<anonymized_userid>",1,73029,6816,"Thierry Baudet (FvD)",0.966324397279488,0.728127336822989,0
"<anonymized_userid>",1,73030,6817,"Thierry Baudet (FvD)",0.966337629343425,0.728234163016772,0
"<anonymized_userid>",1,73031,6818,"Thierry Baudet (FvD)",0.966350861407362,0.728340989210554,0
"<anonymized_userid>",1,73032,6819,"Thierry Baudet (FvD)",0.9663640934713,0.728447815404337,0
"<anonymized_userid>",1,73033,6820,"Thierry Baudet (FvD)",0.966377325535237,0.72855464159812,0
"<anonymized_userid>",1,73034,6821,"Thierry Baudet (FvD)",0.966390557599174,0.728661467791903,0
"<anonymized_userid>",1,73035,6822,"Thierry Baudet (FvD)",0.966403789663112,0.728768293985685,0
"<anonymized_userid>",1,73036,6823,"Thierry Baudet (FvD)",0.966417021727049,0.728875120179468,0
"<anonymized_userid>",1,73037,6824,"Thierry Baudet (FvD)",0.966430253790986,0.728981946373251,0
"<anonymized_userid>",1,73038,6825,"Thierry Baudet (FvD)",0.966443485854924,0.729088772567033,0
"<anonymized_userid>",1,73039,6826,"Thierry Baudet (FvD)",0.966456717918861,0.729195598760816,0
"<anonymized_userid>",1,73040,6827,"Thierry Baudet (FvD)",0.966469949982798,0.729302424954599,0
"<anonymized_userid>",1,73041,6828,"Thierry Baudet (FvD)",0.966483182046736,0.729409251148382,0
"<anonymized_userid>",1,73042,6829,"Thierry Baudet (FvD)",0.966496414110673,0.729516077342164,0
"<anonymized_userid>",1,73043,6830,"Thierry Baudet (FvD)",0.96650964617461,0.729622903535947,0
"<anonymized_userid>",1,73044,6831,"Thierry Baudet (FvD)",0.966522878238548,0.72972972972973,0
"<anonymized_userid>",1,73045,6832,"Thierry Baudet (FvD)",0.966536110302485,0.729836555923512,0
"<anonymized_userid>",1,73046,6833,"Thierry Baudet (FvD)",0.966549342366422,0.729943382117295,0
"<anonymized_userid>",1,73047,6834,"Thierry Baudet (FvD)",0.96656257443036,0.730050208311078,0
"<anonymized_userid>",1,73048,6835,"Thierry Baudet (FvD)",0.966575806494297,0.730157034504861,0
"<anonymized_userid>",1,73049,6836,"Thierry Baudet (FvD)",0.966589038558234,0.730263860698643,0
"<anonymized_userid>",1,73050,6837,"Thierry Baudet (FvD)",0.966602270622172,0.730370686892426,0
"<anonymized_userid>",1,73051,6838,"Thierry Baudet (FvD)",0.966615502686109,0.730477513086209,0
"<anonymized_userid>",1,73052,6839,"Thierry Baudet (FvD)",0.966628734750046,0.730584339279991,0
"<anonymized_userid>",1,73053,6840,"Thierry Baudet (FvD)",0.966641966813984,0.730691165473774,0
"<anonymized_userid>",1,73054,6841,"Thierry Baudet (FvD)",0.966655198877921,0.730797991667557,0
"<anonymized_userid>",1,73055,6842,"Thierry Baudet (FvD)",0.966668430941858,0.73090481786134,0
"<anonymized_userid>",1,73056,6843,"Thierry Baudet (FvD)",0.966681663005796,0.731011644055122,0
"<anonymized_userid>",1,73057,6844,"Thierry Baudet (FvD)",0.966694895069733,0.731118470248905,0
"<anonymized_userid>",1,73058,6845,"Thierry Baudet (FvD)",0.96670812713367,0.731225296442688,0
"<anonymized_userid>",1,73059,6846,"Thierry Baudet (FvD)",0.966721359197608,0.731332122636471,0
"<anonymized_userid>",1,73060,6847,"Thierry Baudet (FvD)",0.966734591261545,0.731438948830253,0
"<anonymized_userid>",1,73061,6848,"Thierry Baudet (FvD)",0.966747823325482,0.731545775024036,0
"<anonymized_userid>",1,73062,6849,"Thierry Baudet (FvD)",0.96676105538942,0.731652601217819,0
"<anonymized_userid>",1,73063,6850,"Thierry Baudet (FvD)",0.966774287453357,0.731759427411601,0
"<anonymized_userid>",1,73064,6851,"Thierry Baudet (FvD)",0.966787519517294,0.731866253605384,0
"<anonymized_userid>",1,73065,6852,"Thierry Baudet (FvD)",0.966800751581232,0.731973079799167,0
"<anonymized_userid>",1,73066,6853,"Thierry Baudet (FvD)",0.966813983645169,0.732079905992949,0
"<anonymized_userid>",1,73067,6854,"Thierry Baudet (FvD)",0.966827215709106,0.732186732186732,0
"<anonymized_userid>",1,73068,6855,"Thierry Baudet (FvD)",0.966840447773044,0.732293558380515,0
"<anonymized_userid>",1,73069,6856,"Thierry Baudet (FvD)",0.966853679836981,0.732400384574298,0
"<anonymized_userid>",1,73070,6857,"Thierry Baudet (FvD)",0.966866911900918,0.73250721076808,0
"<anonymized_userid>",1,73071,6858,"Thierry Baudet (FvD)",0.966880143964856,0.732614036961863,0
"<anonymized_userid>",1,73072,6859,"Thierry Baudet (FvD)",0.966893376028793,0.732720863155646,0
"<anonymized_userid>",1,73073,6860,"Thierry Baudet (FvD)",0.96690660809273,0.732827689349428,0
"<anonymized_userid>",1,73074,6861,"Thierry Baudet (FvD)",0.966919840156668,0.732934515543211,0
"<anonymized_userid>",1,73075,6862,"Thierry Baudet (FvD)",0.966933072220605,0.733041341736994,0
"<anonymized_userid>",1,73076,6863,"Thierry Baudet (FvD)",0.966946304284542,0.733148167930777,0
"<anonymized_userid>",1,73077,6864,"Thierry Baudet (FvD)",0.96695953634848,0.733254994124559,0
"<anonymized_userid>",1,73078,6865,"Thierry Baudet (FvD)",0.966972768412417,0.733361820318342,0
"<anonymized_userid>",1,73079,6866,"Thierry Baudet (FvD)",0.966986000476354,0.733468646512125,0
"<anonymized_userid>",1,73080,6867,"Thierry Baudet (FvD)",0.966999232540292,0.733575472705908,0
"<anonymized_userid>",1,73081,6868,"Thierry Baudet (FvD)",0.967012464604229,0.73368229889969,0
"<anonymized_userid>",1,73082,6869,"Thierry Baudet (FvD)",0.967025696668166,0.733789125093473,0
"<anonymized_userid>",1,73083,6870,"Thierry Baudet (FvD)",0.967038928732104,0.733895951287256,0
"<anonymized_userid>",1,73084,6871,"Thierry Baudet (FvD)",0.967052160796041,0.734002777481038,0
"<anonymized_userid>",1,73085,6872,"Thierry Baudet (FvD)",0.967065392859978,0.734109603674821,0
"<anonymized_userid>",1,73086,6873,"Thierry Baudet (FvD)",0.967078624923916,0.734216429868604,0
"<anonymized_userid>",1,73087,6874,"Thierry Baudet (FvD)",0.967091856987853,0.734323256062386,0
"<anonymized_userid>",1,73088,6875,"Thierry Baudet (FvD)",0.96710508905179,0.734430082256169,0
"<anonymized_userid>",1,73089,6876,"Thierry Baudet (FvD)",0.967118321115728,0.734536908449952,0
"<anonymized_userid>",1,73090,6877,"Thierry Baudet (FvD)",0.967131553179665,0.734643734643735,0
"<anonymized_userid>",1,73091,6878,"Thierry Baudet (FvD)",0.967144785243602,0.734750560837517,0
"<anonymized_userid>",1,73092,6879,"Thierry Baudet (FvD)",0.96715801730754,0.7348573870313,0
"<anonymized_userid>",1,73093,6880,"Thierry Baudet (FvD)",0.967171249371477,0.734964213225083,0
"<anonymized_userid>",1,73094,6881,"Thierry Baudet (FvD)",0.967184481435414,0.735071039418866,0
"<anonymized_userid>",1,73095,6882,"Thierry Baudet (FvD)",0.967197713499352,0.735177865612648,0
"<anonymized_userid>",1,73096,6883,"Thierry Baudet (FvD)",0.967210945563289,0.735284691806431,0
"<anonymized_userid>",1,73097,6884,"Thierry Baudet (FvD)",0.967224177627226,0.735391518000214,0
"<anonymized_userid>",1,73098,6885,"Thierry Baudet (FvD)",0.967237409691164,0.735498344193996,0
"<anonymized_userid>",1,73099,6886,"Thierry Baudet (FvD)",0.967250641755101,0.735605170387779,0
"<anonymized_userid>",1,73100,6887,"Thierry Baudet (FvD)",0.967263873819038,0.735711996581562,0
"<anonymized_userid>",1,73101,6888,"Thierry Baudet (FvD)",0.967277105882976,0.735818822775344,0
"<anonymized_userid>",1,73102,6889,"Thierry Baudet (FvD)",0.967290337946913,0.735925648969127,0
"<anonymized_userid>",1,73103,6890,"Thierry Baudet (FvD)",0.96730357001085,0.73603247516291,0
"<anonymized_userid>",1,73104,6891,"Thierry Baudet (FvD)",0.967316802074788,0.736139301356693,0
"<anonymized_userid>",1,73105,6892,"Thierry Baudet (FvD)",0.967330034138725,0.736246127550475,0
"<anonymized_userid>",1,73106,6893,"Thierry Baudet (FvD)",0.967343266202662,0.736352953744258,0
"<anonymized_userid>",1,73107,6894,"Thierry Baudet (FvD)",0.9673564982666,0.736459779938041,0
"<anonymized_userid>",1,73108,6895,"Thierry Baudet (FvD)",0.967369730330537,0.736566606131824,0
"<anonymized_userid>",1,73109,6896,"Thierry Baudet (FvD)",0.967382962394474,0.736673432325606,0
"<anonymized_userid>",1,73110,6897,"Thierry Baudet (FvD)",0.967396194458412,0.736780258519389,0
"<anonymized_userid>",1,73111,6898,"Thierry Baudet (FvD)",0.967409426522349,0.736887084713172,0
"<anonymized_userid>",1,73112,6899,"Thierry Baudet (FvD)",0.967422658586286,0.736993910906954,0
"<anonymized_userid>",1,73113,6900,"Thierry Baudet (FvD)",0.967435890650224,0.737100737100737,0
"<anonymized_userid>",1,73114,6901,"Thierry Baudet (FvD)",0.967449122714161,0.73720756329452,0
"<anonymized_userid>",1,73115,6902,"Thierry Baudet (FvD)",0.967462354778098,0.737314389488303,0
"<anonymized_userid>",1,73116,6903,"Thierry Baudet (FvD)",0.967475586842036,0.737421215682085,0
"<anonymized_userid>",1,73117,6904,"Thierry Baudet (FvD)",0.967488818905973,0.737528041875868,0
"<anonymized_userid>",1,73118,6905,"Thierry Baudet (FvD)",0.96750205096991,0.737634868069651,0
"<anonymized_userid>",1,73119,6906,"Thierry Baudet (FvD)",0.967515283033848,0.737741694263433,0
"<anonymized_userid>",1,73120,6907,"Thierry Baudet (FvD)",0.967528515097785,0.737848520457216,0
"<anonymized_userid>",1,73121,6908,"Thierry Baudet (FvD)",0.967541747161722,0.737955346650999,0
"<anonymized_userid>",1,73122,6909,"Thierry Baudet (FvD)",0.96755497922566,0.738062172844782,0
"<anonymized_userid>",1,73123,6910,"Thierry Baudet (FvD)",0.967568211289597,0.738168999038564,0
"<anonymized_userid>",1,73124,6911,"Thierry Baudet (FvD)",0.967581443353534,0.738275825232347,0
"<anonymized_userid>",1,73125,6912,"Thierry Baudet (FvD)",0.967594675417472,0.73838265142613,0
"<anonymized_userid>",1,73126,6913,"Thierry Baudet (FvD)",0.967607907481409,0.738489477619912,0
"<anonymized_userid>",1,73127,6914,"Thierry Baudet (FvD)",0.967621139545346,0.738596303813695,0
"<anonymized_userid>",1,73128,6915,"Thierry Baudet (FvD)",0.967634371609284,0.738703130007478,0
"<anonymized_userid>",1,73129,6916,"Thierry Baudet (FvD)",0.967647603673221,0.738809956201261,0
"<anonymized_userid>",1,73130,6917,"Thierry Baudet (FvD)",0.967660835737158,0.738916782395043,0
"<anonymized_userid>",1,73131,6918,"Thierry Baudet (FvD)",0.967674067801096,0.739023608588826,0
"<anonymized_userid>",1,73132,6919,"Thierry Baudet (FvD)",0.967687299865033,0.739130434782609,0
"<anonymized_userid>",1,73133,6920,"Thierry Baudet (FvD)",0.96770053192897,0.739237260976391,0
"<anonymized_userid>",1,73134,6921,"Thierry Baudet (FvD)",0.967713763992908,0.739344087170174,0
"<anonymized_userid>",1,73135,6922,"Thierry Baudet (FvD)",0.967726996056845,0.739450913363957,0
"<anonymized_userid>",1,73136,6923,"Thierry Baudet (FvD)",0.967740228120782,0.73955773955774,0
"<anonymized_userid>",1,73137,6924,"Thierry Baudet (FvD)",0.96775346018472,0.739664565751522,0
"<anonymized_userid>",1,73138,6925,"Thierry Baudet (FvD)",0.967766692248657,0.739771391945305,0
"<anonymized_userid>",1,73139,6926,"Thierry Baudet (FvD)",0.967779924312594,0.739878218139088,0
"<anonymized_userid>",1,73140,6927,"Thierry Baudet (FvD)",0.967793156376532,0.73998504433287,0
"<anonymized_userid>",1,73141,6928,"Thierry Baudet (FvD)",0.967806388440469,0.740091870526653,0
"<anonymized_userid>",1,73142,6929,"Thierry Baudet (FvD)",0.967819620504406,0.740198696720436,0
"<anonymized_userid>",1,73143,6930,"Thierry Baudet (FvD)",0.967832852568344,0.740305522914219,0
"<anonymized_userid>",1,73144,6931,"Thierry Baudet (FvD)",0.967846084632281,0.740412349108001,0
"<anonymized_userid>",1,73145,6932,"Thierry Baudet (FvD)",0.967859316696218,0.740519175301784,0
"<anonymized_userid>",1,73146,6933,"Thierry Baudet (FvD)",0.967872548760156,0.740626001495567,0
"<anonymized_userid>",1,73147,6934,"Thierry Baudet (FvD)",0.967885780824093,0.740732827689349,0
"<anonymized_userid>",1,73148,6935,"Thierry Baudet (FvD)",0.96789901288803,0.740839653883132,0
"<anonymized_userid>",1,73149,6936,"Thierry Baudet (FvD)",0.967912244951968,0.740946480076915,0
"<anonymized_userid>",1,73150,6937,"Thierry Baudet (FvD)",0.967925477015905,0.741053306270698,0
"<anonymized_userid>",1,73151,6938,"Thierry Baudet (FvD)",0.967938709079842,0.74116013246448,0
"<anonymized_userid>",1,73152,6939,"Thierry Baudet (FvD)",0.96795194114378,0.741266958658263,0
"<anonymized_userid>",1,73153,6940,"Thierry Baudet (FvD)",0.967965173207717,0.741373784852046,0
"<anonymized_userid>",1,73154,6941,"Thierry Baudet (FvD)",0.967978405271654,0.741480611045828,0
"<anonymized_userid>",1,73155,6942,"Thierry Baudet (FvD)",0.967991637335592,0.741587437239611,0
"<anonymized_userid>",1,73156,6943,"Thierry Baudet (FvD)",0.968004869399529,0.741694263433394,0
"<anonymized_userid>",1,73157,6944,"Thierry Baudet (FvD)",0.968018101463466,0.741801089627177,0
"<anonymized_userid>",1,73158,6945,"Thierry Baudet (FvD)",0.968031333527404,0.741907915820959,0
"<anonymized_userid>",1,73159,6946,"Thierry Baudet (FvD)",0.968044565591341,0.742014742014742,0
"<anonymized_userid>",1,73160,6947,"Thierry Baudet (FvD)",0.968057797655278,0.742121568208525,0
"<anonymized_userid>",1,73161,6948,"Thierry Baudet (FvD)",0.968071029719216,0.742228394402307,0
"<anonymized_userid>",1,73162,6949,"Thierry Baudet (FvD)",0.968084261783153,0.74233522059609,0
"<anonymized_userid>",1,73163,6950,"Thierry Baudet (FvD)",0.96809749384709,0.742442046789873,0
"<anonymized_userid>",1,73164,6951,"Thierry Baudet (FvD)",0.968110725911028,0.742548872983656,0
"<anonymized_userid>",1,73165,6952,"Thierry Baudet (FvD)",0.968123957974965,0.742655699177438,0
"<anonymized_userid>",1,73166,6953,"Thierry Baudet (FvD)",0.968137190038902,0.742762525371221,0
"<anonymized_userid>",1,73167,6954,"Thierry Baudet (FvD)",0.96815042210284,0.742869351565004,0
"<anonymized_userid>",1,73168,6955,"Thierry Baudet (FvD)",0.968163654166777,0.742976177758786,0
"<anonymized_userid>",1,73169,6956,"Thierry Baudet (FvD)",0.968176886230714,0.743083003952569,0
"<anonymized_userid>",1,73170,6957,"Thierry Baudet (FvD)",0.968190118294652,0.743189830146352,0
"<anonymized_userid>",1,73171,6958,"Thierry Baudet (FvD)",0.968203350358589,0.743296656340135,0
"<anonymized_userid>",1,73172,6959,"Thierry Baudet (FvD)",0.968216582422526,0.743403482533917,0
"<anonymized_userid>",1,73173,6960,"Thierry Baudet (FvD)",0.968229814486464,0.7435103087277,0
"<anonymized_userid>",1,73174,6961,"Thierry Baudet (FvD)",0.968243046550401,0.743617134921483,0
"<anonymized_userid>",1,73175,6962,"Thierry Baudet (FvD)",0.968256278614338,0.743723961115266,0
"<anonymized_userid>",1,73176,6963,"Thierry Baudet (FvD)",0.968269510678276,0.743830787309048,0
"<anonymized_userid>",1,73177,6964,"Thierry Baudet (FvD)",0.968282742742213,0.743937613502831,0
"<anonymized_userid>",1,73178,6965,"Thierry Baudet (FvD)",0.96829597480615,0.744044439696614,0
"<anonymized_userid>",1,73179,6966,"Thierry Baudet (FvD)",0.968309206870088,0.744151265890396,0
"<anonymized_userid>",1,73180,6967,"Thierry Baudet (FvD)",0.968322438934025,0.744258092084179,0
"<anonymized_userid>",1,73181,6968,"Thierry Baudet (FvD)",0.968335670997962,0.744364918277962,0
"<anonymized_userid>",1,73182,6969,"Thierry Baudet (FvD)",0.9683489030619,0.744471744471744,0
"<anonymized_userid>",1,73183,6970,"Thierry Baudet (FvD)",0.968362135125837,0.744578570665527,0
"<anonymized_userid>",1,73184,6971,"Thierry Baudet (FvD)",0.968375367189774,0.74468539685931,0
"<anonymized_userid>",1,73185,6972,"Thierry Baudet (FvD)",0.968388599253712,0.744792223053093,0
"<anonymized_userid>",1,73186,6973,"Thierry Baudet (FvD)",0.968401831317649,0.744899049246875,0
"<anonymized_userid>",1,73187,6974,"Thierry Baudet (FvD)",0.968415063381586,0.745005875440658,0
"<anonymized_userid>",1,73188,6975,"Thierry Baudet (FvD)",0.968428295445524,0.745112701634441,0
"<anonymized_userid>",1,73189,6976,"Thierry Baudet (FvD)",0.968441527509461,0.745219527828223,0
"<anonymized_userid>",1,73190,6977,"Thierry Baudet (FvD)",0.968454759573398,0.745326354022006,0
"<anonymized_userid>",1,73191,6978,"Thierry Baudet (FvD)",0.968467991637336,0.745433180215789,0
"<anonymized_userid>",1,73192,6979,"Thierry Baudet (FvD)",0.968481223701273,0.745540006409572,0
"<anonymized_userid>",1,73193,6980,"Thierry Baudet (FvD)",0.96849445576521,0.745646832603354,0
"<anonymized_userid>",1,73194,6981,"Thierry Baudet (FvD)",0.968507687829148,0.745753658797137,0
"<anonymized_userid>",1,73195,6982,"Thierry Baudet (FvD)",0.968520919893085,0.74586048499092,0
"<anonymized_userid>",1,73196,6983,"Thierry Baudet (FvD)",0.968534151957022,0.745967311184702,0
"<anonymized_userid>",1,73197,6984,"Thierry Baudet (FvD)",0.96854738402096,0.746074137378485,0
"<anonymized_userid>",1,73198,6985,"Thierry Baudet (FvD)",0.968560616084897,0.746180963572268,0
"<anonymized_userid>",1,73199,6986,"Thierry Baudet (FvD)",0.968573848148834,0.746287789766051,0
"<anonymized_userid>",1,73200,6987,"Thierry Baudet (FvD)",0.968587080212772,0.746394615959833,0
"<anonymized_userid>",1,73201,6988,"Thierry Baudet (FvD)",0.968600312276709,0.746501442153616,0
"<anonymized_userid>",1,73202,6989,"Thierry Baudet (FvD)",0.968613544340646,0.746608268347399,0
"<anonymized_userid>",1,73203,6990,"Thierry Baudet (FvD)",0.968626776404584,0.746715094541181,0
"<anonymized_userid>",1,73204,6991,"Thierry Baudet (FvD)",0.968640008468521,0.746821920734964,0
"<anonymized_userid>",1,73205,6992,"Thierry Baudet (FvD)",0.968653240532458,0.746928746928747,0
"<anonymized_userid>",1,73206,6993,"Thierry Baudet (FvD)",0.968666472596396,0.74703557312253,0
"<anonymized_userid>",1,73207,6994,"Thierry Baudet (FvD)",0.968679704660333,0.747142399316312,0
"<anonymized_userid>",1,73208,6995,"Thierry Baudet (FvD)",0.96869293672427,0.747249225510095,0
"<anonymized_userid>",1,73209,6996,"Thierry Baudet (FvD)",0.968706168788208,0.747356051703878,0
"<anonymized_userid>",1,73210,6997,"Thierry Baudet (FvD)",0.968719400852145,0.747462877897661,0
"<anonymized_userid>",1,73211,6998,"Thierry Baudet (FvD)",0.968732632916082,0.747569704091443,0
"<anonymized_userid>",1,73212,6999,"Thierry Baudet (FvD)",0.96874586498002,0.747676530285226,0
"<anonymized_userid>",1,73213,7000,"Thierry Baudet (FvD)",0.968759097043957,0.747783356479009,0
"<anonymized_userid>",1,73214,7001,"Thierry Baudet (FvD)",0.968772329107894,0.747890182672791,0
"<anonymized_userid>",1,73215,7002,"Thierry Baudet (FvD)",0.968785561171832,0.747997008866574,0
"<anonymized_userid>",1,73216,7003,"Thierry Baudet (FvD)",0.968798793235769,0.748103835060357,0
"<anonymized_userid>",1,73217,7004,"Thierry Baudet (FvD)",0.968812025299706,0.748210661254139,0
"<anonymized_userid>",1,73218,7005,"Thierry Baudet (FvD)",0.968825257363644,0.748317487447922,0
"<anonymized_userid>",1,73219,7006,"Thierry Baudet (FvD)",0.968838489427581,0.748424313641705,0
"<anonymized_userid>",1,73220,7007,"Thierry Baudet (FvD)",0.968851721491518,0.748531139835488,0
"<anonymized_userid>",1,73221,7008,"Thierry Baudet (FvD)",0.968864953555456,0.74863796602927,0
"<anonymized_userid>",1,73222,7009,"Thierry Baudet (FvD)",0.968878185619393,0.748744792223053,0
"<anonymized_userid>",1,73223,7010,"Thierry Baudet (FvD)",0.96889141768333,0.748851618416836,0
"<anonymized_userid>",1,73224,7011,"Thierry Baudet (FvD)",0.968904649747268,0.748958444610619,0
"<anonymized_userid>",1,73225,7012,"Thierry Baudet (FvD)",0.968917881811205,0.749065270804401,0
"<anonymized_userid>",1,73226,7013,"Thierry Baudet (FvD)",0.968931113875142,0.749172096998184,0
"<anonymized_userid>",1,73227,7014,"Thierry Baudet (FvD)",0.96894434593908,0.749278923191967,0
"<anonymized_userid>",1,73228,7015,"Thierry Baudet (FvD)",0.968957578003017,0.749385749385749,0
"<anonymized_userid>",1,73229,7016,"Thierry Baudet (FvD)",0.968970810066954,0.749492575579532,0
"<anonymized_userid>",1,73230,7017,"Thierry Baudet (FvD)",0.968984042130892,0.749599401773315,0
"<anonymized_userid>",1,73231,7018,"Thierry Baudet (FvD)",0.968997274194829,0.749706227967098,0
"<anonymized_userid>",1,73232,7019,"Thierry Baudet (FvD)",0.969010506258766,0.74981305416088,0
"<anonymized_userid>",1,73233,7020,"Thierry Baudet (FvD)",0.969023738322704,0.749919880354663,0
"<anonymized_userid>",1,73234,7021,"Thierry Baudet (FvD)",0.969036970386641,0.750026706548446,1
"<anonymized_userid>",1,73235,7022,"Thierry Baudet (FvD)",0.969050202450578,0.750133532742228,0
"<anonymized_userid>",1,73236,7023,"Thierry Baudet (FvD)",0.969063434514516,0.750240358936011,0
"<anonymized_userid>",1,73237,7024,"Thierry Baudet (FvD)",0.969076666578453,0.750347185129794,0
"<anonymized_userid>",1,73238,7025,"Thierry Baudet (FvD)",0.96908989864239,0.750454011323577,0
"<anonymized_userid>",1,73239,7026,"Thierry Baudet (FvD)",0.969103130706328,0.750560837517359,0
"<anonymized_userid>",1,73240,7027,"Thierry Baudet (FvD)",0.969116362770265,0.750667663711142,0
"<anonymized_userid>",1,73241,7028,"Thierry Baudet (FvD)",0.969129594834202,0.750774489904925,0
"<anonymized_userid>",1,73242,7029,"Thierry Baudet (FvD)",0.96914282689814,0.750881316098707,0
"<anonymized_userid>",1,73243,7030,"Thierry Baudet (FvD)",0.969156058962077,0.75098814229249,0
"<anonymized_userid>",1,73244,7031,"Thierry Baudet (FvD)",0.969169291026014,0.751094968486273,0
"<anonymized_userid>",1,73245,7032,"Thierry Baudet (FvD)",0.969182523089952,0.751201794680056,0
"<anonymized_userid>",1,73246,7033,"Thierry Baudet (FvD)",0.969195755153889,0.751308620873838,0
"<anonymized_userid>",1,73247,7034,"Thierry Baudet (FvD)",0.969208987217826,0.751415447067621,0
"<anonymized_userid>",1,73248,7035,"Thierry Baudet (FvD)",0.969222219281764,0.751522273261404,0
"<anonymized_userid>",1,73249,7036,"Thierry Baudet (FvD)",0.969235451345701,0.751629099455186,0
"<anonymized_userid>",1,73250,7037,"Thierry Baudet (FvD)",0.969248683409638,0.751735925648969,0
"<anonymized_userid>",1,73251,7038,"Thierry Baudet (FvD)",0.969261915473576,0.751842751842752,0
"<anonymized_userid>",1,73252,7039,"Thierry Baudet (FvD)",0.969275147537513,0.751949578036535,0
"<anonymized_userid>",1,73253,7040,"Thierry Baudet (FvD)",0.96928837960145,0.752056404230317,0
"<anonymized_userid>",1,73254,7041,"Thierry Baudet (FvD)",0.969301611665388,0.7521632304241,0
"<anonymized_userid>",1,73255,7042,"Thierry Baudet (FvD)",0.969314843729325,0.752270056617883,0
"<anonymized_userid>",1,73256,7043,"Thierry Baudet (FvD)",0.969328075793262,0.752376882811665,0
"<anonymized_userid>",1,73257,7044,"Thierry Baudet (FvD)",0.9693413078572,0.752483709005448,0
"<anonymized_userid>",1,73258,7045,"Thierry Baudet (FvD)",0.969354539921137,0.752590535199231,0
"<anonymized_userid>",1,73259,7046,"Thierry Baudet (FvD)",0.969367771985074,0.752697361393014,0
"<anonymized_userid>",1,73260,7047,"Thierry Baudet (FvD)",0.969381004049012,0.752804187586796,0
"<anonymized_userid>",1,73261,7048,"Thierry Baudet (FvD)",0.969394236112949,0.752911013780579,0
"<anonymized_userid>",1,73262,7049,"Thierry Baudet (FvD)",0.969407468176886,0.753017839974362,0
"<anonymized_userid>",1,73263,7050,"Thierry Baudet (FvD)",0.969420700240824,0.753124666168144,0
"<anonymized_userid>",1,73264,7051,"Thierry Baudet (FvD)",0.969433932304761,0.753231492361927,0
"<anonymized_userid>",1,73265,7052,"Thierry Baudet (FvD)",0.969447164368698,0.75333831855571,0
"<anonymized_userid>",1,73266,7053,"Thierry Baudet (FvD)",0.969460396432636,0.753445144749493,0
"<anonymized_userid>",1,73267,7054,"Thierry Baudet (FvD)",0.969473628496573,0.753551970943275,0
"<anonymized_userid>",1,73268,7055,"Thierry Baudet (FvD)",0.96948686056051,0.753658797137058,0
"<anonymized_userid>",1,73269,7056,"Thierry Baudet (FvD)",0.969500092624448,0.753765623330841,0
"<anonymized_userid>",1,73270,7057,"Thierry Baudet (FvD)",0.969513324688385,0.753872449524623,0
"<anonymized_userid>",1,73271,7058,"Thierry Baudet (FvD)",0.969526556752322,0.753979275718406,0
"<anonymized_userid>",1,73272,7059,"Thierry Baudet (FvD)",0.96953978881626,0.754086101912189,0
"<anonymized_userid>",1,73273,7060,"Thierry Baudet (FvD)",0.969553020880197,0.754192928105972,0
"<anonymized_userid>",1,73274,7061,"Thierry Baudet (FvD)",0.969566252944134,0.754299754299754,0
"<anonymized_userid>",1,73275,7062,"Thierry Baudet (FvD)",0.969579485008072,0.754406580493537,0
"<anonymized_userid>",1,73276,7063,"Thierry Baudet (FvD)",0.969592717072009,0.75451340668732,0
"<anonymized_userid>",1,73277,7064,"Thierry Baudet (FvD)",0.969605949135946,0.754620232881102,0
"<anonymized_userid>",1,73278,7065,"Thierry Baudet (FvD)",0.969619181199884,0.754727059074885,0
"<anonymized_userid>",1,73279,7066,"Thierry Baudet (FvD)",0.969632413263821,0.754833885268668,0
"<anonymized_userid>",1,73280,7067,"Thierry Baudet (FvD)",0.969645645327758,0.754940711462451,0
"<anonymized_userid>",1,73281,7068,"Thierry Baudet (FvD)",0.969658877391696,0.755047537656233,0
"<anonymized_userid>",1,73282,7069,"Thierry Baudet (FvD)",0.969672109455633,0.755154363850016,0
"<anonymized_userid>",1,73283,7070,"Thierry Baudet (FvD)",0.96968534151957,0.755261190043799,0
"<anonymized_userid>",1,73284,7071,"Thierry Baudet (FvD)",0.969698573583508,0.755368016237581,0
"<anonymized_userid>",1,73285,7072,"Thierry Baudet (FvD)",0.969711805647445,0.755474842431364,0
"<anonymized_userid>",1,73286,7073,"Thierry Baudet (FvD)",0.969725037711382,0.755581668625147,0
"<anonymized_userid>",1,73287,7074,"Thierry Baudet (FvD)",0.96973826977532,0.75568849481893,0
"<anonymized_userid>",1,73288,7075,"Thierry Baudet (FvD)",0.969751501839257,0.755795321012712,0
"<anonymized_userid>",1,73289,7076,"Thierry Baudet (FvD)",0.969764733903194,0.755902147206495,0
"<anonymized_userid>",1,73290,7077,"Thierry Baudet (FvD)",0.969777965967132,0.756008973400278,0
"<anonymized_userid>",1,73291,7078,"Thierry Baudet (FvD)",0.969791198031069,0.756115799594061,0
"<anonymized_userid>",1,73292,7079,"Thierry Baudet (FvD)",0.969804430095006,0.756222625787843,0
"<anonymized_userid>",1,73293,7080,"Thierry Baudet (FvD)",0.969817662158944,0.756329451981626,0
"<anonymized_userid>",1,73294,7081,"Thierry Baudet (FvD)",0.969830894222881,0.756436278175409,0
"<anonymized_userid>",1,73295,7082,"Thierry Baudet (FvD)",0.969844126286818,0.756543104369191,0
"<anonymized_userid>",1,73296,7083,"Thierry Baudet (FvD)",0.969857358350756,0.756649930562974,0
"<anonymized_userid>",1,73297,7084,"Thierry Baudet (FvD)",0.969870590414693,0.756756756756757,0
"<anonymized_userid>",1,73298,7085,"Thierry Baudet (FvD)",0.96988382247863,0.756863582950539,0
"<anonymized_userid>",1,73299,7086,"Thierry Baudet (FvD)",0.969897054542568,0.756970409144322,0
"<anonymized_userid>",1,73300,7087,"Thierry Baudet (FvD)",0.969910286606505,0.757077235338105,0
"<anonymized_userid>",1,73301,7088,"Thierry Baudet (FvD)",0.969923518670442,0.757184061531888,0
"<anonymized_userid>",1,73302,7089,"Thierry Baudet (FvD)",0.96993675073438,0.75729088772567,0
"<anonymized_userid>",1,73303,7090,"Thierry Baudet (FvD)",0.969949982798317,0.757397713919453,0
"<anonymized_userid>",1,73304,7091,"Thierry Baudet (FvD)",0.969963214862254,0.757504540113236,0
"<anonymized_userid>",1,73305,7092,"Thierry Baudet (FvD)",0.969976446926192,0.757611366307019,0
"<anonymized_userid>",1,73306,7093,"Thierry Baudet (FvD)",0.969989678990129,0.757718192500801,0
"<anonymized_userid>",1,73307,7094,"Thierry Baudet (FvD)",0.970002911054066,0.757825018694584,0
"<anonymized_userid>",1,73308,7095,"Thierry Baudet (FvD)",0.970016143118004,0.757931844888367,0
"<anonymized_userid>",1,73309,7096,"Thierry Baudet (FvD)",0.970029375181941,0.758038671082149,0
"<anonymized_userid>",1,73310,7097,"Thierry Baudet (FvD)",0.970042607245878,0.758145497275932,0
"<anonymized_userid>",1,73311,7098,"Thierry Baudet (FvD)",0.970055839309816,0.758252323469715,0
"<anonymized_userid>",1,73312,7099,"Thierry Baudet (FvD)",0.970069071373753,0.758359149663497,0
"<anonymized_userid>",1,73313,7100,"Thierry Baudet (FvD)",0.97008230343769,0.75846597585728,0
"<anonymized_userid>",1,73314,7101,"Thierry Baudet (FvD)",0.970095535501628,0.758572802051063,0
"<anonymized_userid>",1,73315,7102,"Thierry Baudet (FvD)",0.970108767565565,0.758679628244846,0
"<anonymized_userid>",1,73316,7103,"Thierry Baudet (FvD)",0.970121999629502,0.758786454438628,0
"<anonymized_userid>",1,73317,7104,"Thierry Baudet (FvD)",0.97013523169344,0.758893280632411,0
"<anonymized_userid>",1,73318,7105,"Thierry Baudet (FvD)",0.970148463757377,0.759000106826194,0
"<anonymized_userid>",1,73319,7106,"Thierry Baudet (FvD)",0.970161695821314,0.759106933019976,0
"<anonymized_userid>",1,73320,7107,"Thierry Baudet (FvD)",0.970174927885252,0.759213759213759,0
"<anonymized_userid>",1,73321,7108,"Thierry Baudet (FvD)",0.970188159949189,0.759320585407542,0
"<anonymized_userid>",1,73322,7109,"Thierry Baudet (FvD)",0.970201392013126,0.759427411601325,0
"<anonymized_userid>",1,73323,7110,"Thierry Baudet (FvD)",0.970214624077063,0.759534237795107,0
"<anonymized_userid>",1,73324,7111,"Thierry Baudet (FvD)",0.970227856141001,0.75964106398889,0
"<anonymized_userid>",1,73325,7112,"Thierry Baudet (FvD)",0.970241088204938,0.759747890182673,0
"<anonymized_userid>",1,73326,7113,"Thierry Baudet (FvD)",0.970254320268876,0.759854716376456,0
"<anonymized_userid>",1,73327,7114,"Thierry Baudet (FvD)",0.970267552332813,0.759961542570238,0
"<anonymized_userid>",1,73328,7115,"Thierry Baudet (FvD)",0.97028078439675,0.760068368764021,0
"<anonymized_userid>",1,73329,7116,"Thierry Baudet (FvD)",0.970294016460688,0.760175194957804,0
"<anonymized_userid>",1,73330,7117,"Thierry Baudet (FvD)",0.970307248524625,0.760282021151586,0
"<anonymized_userid>",1,73331,7118,"Thierry Baudet (FvD)",0.970320480588562,0.760388847345369,0
"<anonymized_userid>",1,73332,7119,"Thierry Baudet (FvD)",0.9703337126525,0.760495673539152,0
"<anonymized_userid>",1,73333,7120,"Thierry Baudet (FvD)",0.970346944716437,0.760602499732934,0
"<anonymized_userid>",1,73334,7121,"Thierry Baudet (FvD)",0.970360176780374,0.760709325926717,0
"<anonymized_userid>",1,73335,7122,"Thierry Baudet (FvD)",0.970373408844312,0.7608161521205,0
"<anonymized_userid>",1,73336,7123,"Thierry Baudet (FvD)",0.970386640908249,0.760922978314283,0
"<anonymized_userid>",1,73337,7124,"Thierry Baudet (FvD)",0.970399872972186,0.761029804508065,0
"<anonymized_userid>",1,73338,7125,"Thierry Baudet (FvD)",0.970413105036124,0.761136630701848,0
"<anonymized_userid>",1,73339,7126,"Thierry Baudet (FvD)",0.970426337100061,0.761243456895631,0
"<anonymized_userid>",1,73340,7127,"Thierry Baudet (FvD)",0.970439569163998,0.761350283089414,0
"<anonymized_userid>",1,73341,7128,"Thierry Baudet (FvD)",0.970452801227936,0.761457109283196,0
"<anonymized_userid>",1,73342,7129,"Thierry Baudet (FvD)",0.970466033291873,0.761563935476979,0
"<anonymized_userid>",1,73343,7130,"Thierry Baudet (FvD)",0.97047926535581,0.761670761670762,0
"<anonymized_userid>",1,73344,7131,"Thierry Baudet (FvD)",0.970492497419748,0.761777587864544,0
"<anonymized_userid>",1,73345,7132,"Thierry Baudet (FvD)",0.970505729483685,0.761884414058327,0
"<anonymized_userid>",1,73346,7133,"Thierry Baudet (FvD)",0.970518961547622,0.76199124025211,0
"<anonymized_userid>",1,73347,7134,"Thierry Baudet (FvD)",0.97053219361156,0.762098066445893,0
"<anonymized_userid>",1,73348,7135,"Thierry Baudet (FvD)",0.970545425675497,0.762204892639675,0
"<anonymized_userid>",1,73349,7136,"Thierry Baudet (FvD)",0.970558657739434,0.762311718833458,0
"<anonymized_userid>",1,73350,7137,"Thierry Baudet (FvD)",0.970571889803372,0.762418545027241,0
"<anonymized_userid>",1,73351,7138,"Thierry Baudet (FvD)",0.970585121867309,0.762525371221023,0
"<anonymized_userid>",1,73352,7139,"Thierry Baudet (FvD)",0.970598353931246,0.762632197414806,0
"<anonymized_userid>",1,73353,7140,"Thierry Baudet (FvD)",0.970611585995183,0.762739023608589,0
"<anonymized_userid>",1,73354,7141,"Thierry Baudet (FvD)",0.970624818059121,0.762845849802372,0
"<anonymized_userid>",1,73355,7142,"Thierry Baudet (FvD)",0.970638050123058,0.762952675996154,0
"<anonymized_userid>",1,73356,7143,"Thierry Baudet (FvD)",0.970651282186995,0.763059502189937,0
"<anonymized_userid>",1,73357,7144,"Thierry Baudet (FvD)",0.970664514250933,0.76316632838372,0
"<anonymized_userid>",1,73358,7145,"Thierry Baudet (FvD)",0.97067774631487,0.763273154577502,0
"<anonymized_userid>",1,73359,7146,"Thierry Baudet (FvD)",0.970690978378808,0.763379980771285,0
"<anonymized_userid>",1,73360,7147,"Thierry Baudet (FvD)",0.970704210442745,0.763486806965068,0
"<anonymized_userid>",1,73361,7148,"Thierry Baudet (FvD)",0.970717442506682,0.763593633158851,0
"<anonymized_userid>",1,73362,7149,"Thierry Baudet (FvD)",0.97073067457062,0.763700459352633,0
"<anonymized_userid>",1,73363,7150,"Thierry Baudet (FvD)",0.970743906634557,0.763807285546416,0
"<anonymized_userid>",1,73364,7151,"Thierry Baudet (FvD)",0.970757138698494,0.763914111740199,0
"<anonymized_userid>",1,73365,7152,"Thierry Baudet (FvD)",0.970770370762432,0.764020937933981,0
"<anonymized_userid>",1,73366,7153,"Thierry Baudet (FvD)",0.970783602826369,0.764127764127764,0
"<anonymized_userid>",1,73367,7154,"Thierry Baudet (FvD)",0.970796834890306,0.764234590321547,0
"<anonymized_userid>",1,73368,7155,"Thierry Baudet (FvD)",0.970810066954244,0.76434141651533,0
"<anonymized_userid>",1,73369,7156,"Thierry Baudet (FvD)",0.970823299018181,0.764448242709112,0
"<anonymized_userid>",1,73370,7157,"Thierry Baudet (FvD)",0.970836531082118,0.764555068902895,0
"<anonymized_userid>",1,73371,7158,"Thierry Baudet (FvD)",0.970849763146056,0.764661895096678,0
"<anonymized_userid>",1,73372,7159,"Thierry Baudet (FvD)",0.970862995209993,0.76476872129046,0
"<anonymized_userid>",1,73373,7160,"Thierry Baudet (FvD)",0.97087622727393,0.764875547484243,0
"<anonymized_userid>",1,73374,7161,"Thierry Baudet (FvD)",0.970889459337868,0.764982373678026,0
"<anonymized_userid>",1,73375,7162,"Thierry Baudet (FvD)",0.970902691401805,0.765089199871809,0
"<anonymized_userid>",1,73376,7163,"Thierry Baudet (FvD)",0.970915923465742,0.765196026065591,0
"<anonymized_userid>",1,73377,7164,"Thierry Baudet (FvD)",0.97092915552968,0.765302852259374,0
"<anonymized_userid>",1,73378,7165,"Thierry Baudet (FvD)",0.970942387593617,0.765409678453157,0
"<anonymized_userid>",1,73379,7166,"Thierry Baudet (FvD)",0.970955619657554,0.765516504646939,0
"<anonymized_userid>",1,73380,7167,"Thierry Baudet (FvD)",0.970968851721491,0.765623330840722,0
"<anonymized_userid>",1,73381,7168,"Thierry Baudet (FvD)",0.970982083785429,0.765730157034505,0
"<anonymized_userid>",1,73382,7169,"Thierry Baudet (FvD)",0.970995315849366,0.765836983228288,0
"<anonymized_userid>",1,73383,7170,"Thierry Baudet (FvD)",0.971008547913303,0.76594380942207,0
"<anonymized_userid>",1,73384,7171,"Thierry Baudet (FvD)",0.971021779977241,0.766050635615853,0
"<anonymized_userid>",1,73385,7172,"Thierry Baudet (FvD)",0.971035012041178,0.766157461809636,0
"<anonymized_userid>",1,73386,7173,"Thierry Baudet (FvD)",0.971048244105115,0.766264288003418,0
"<anonymized_userid>",1,73387,7174,"Thierry Baudet (FvD)",0.971061476169053,0.766371114197201,0
"<anonymized_userid>",1,73388,7175,"Thierry Baudet (FvD)",0.97107470823299,0.766477940390984,0
"<anonymized_userid>",1,73389,7176,"Thierry Baudet (FvD)",0.971087940296927,0.766584766584767,0
"<anonymized_userid>",1,73390,7177,"Thierry Baudet (FvD)",0.971101172360865,0.766691592778549,0
"<anonymized_userid>",1,73391,7178,"Thierry Baudet (FvD)",0.971114404424802,0.766798418972332,0
"<anonymized_userid>",1,73392,7179,"Thierry Baudet (FvD)",0.97112763648874,0.766905245166115,0
"<anonymized_userid>",1,73393,7180,"Thierry Baudet (FvD)",0.971140868552677,0.767012071359897,0
"<anonymized_userid>",1,73394,7181,"Thierry Baudet (FvD)",0.971154100616614,0.76711889755368,0
"<anonymized_userid>",1,73395,7182,"Thierry Baudet (FvD)",0.971167332680552,0.767225723747463,0
"<anonymized_userid>",1,73396,7183,"Thierry Baudet (FvD)",0.971180564744489,0.767332549941246,0
"<anonymized_userid>",1,73397,7184,"Thierry Baudet (FvD)",0.971193796808426,0.767439376135028,0
"<anonymized_userid>",1,73398,7185,"Thierry Baudet (FvD)",0.971207028872364,0.767546202328811,0
"<anonymized_userid>",1,73399,7186,"Thierry Baudet (FvD)",0.971220260936301,0.767653028522594,0
"<anonymized_userid>",1,73400,7187,"Thierry Baudet (FvD)",0.971233493000238,0.767759854716376,0
"<anonymized_userid>",1,73401,7188,"Thierry Baudet (FvD)",0.971246725064176,0.767866680910159,0
"<anonymized_userid>",1,73402,7189,"Thierry Baudet (FvD)",0.971259957128113,0.767973507103942,0
"<anonymized_userid>",1,73403,7190,"Thierry Baudet (FvD)",0.97127318919205,0.768080333297725,0
"<anonymized_userid>",1,73404,7191,"Thierry Baudet (FvD)",0.971286421255988,0.768187159491507,0
"<anonymized_userid>",1,73405,7192,"Thierry Baudet (FvD)",0.971299653319925,0.76829398568529,0
"<anonymized_userid>",1,73406,7193,"Thierry Baudet (FvD)",0.971312885383862,0.768400811879073,0
"<anonymized_userid>",1,73407,7194,"Thierry Baudet (FvD)",0.9713261174478,0.768507638072855,0
"<anonymized_userid>",1,73408,7195,"Thierry Baudet (FvD)",0.971339349511737,0.768614464266638,0
"<anonymized_userid>",1,73409,7196,"Thierry Baudet (FvD)",0.971352581575674,0.768721290460421,0
"<anonymized_userid>",1,73410,7197,"Thierry Baudet (FvD)",0.971365813639611,0.768828116654204,0
"<anonymized_userid>",1,73411,7198,"Thierry Baudet (FvD)",0.971379045703549,0.768934942847986,0
"<anonymized_userid>",1,73412,7199,"Thierry Baudet (FvD)",0.971392277767486,0.769041769041769,0
"<anonymized_userid>",1,73413,7200,"Thierry Baudet (FvD)",0.971405509831423,0.769148595235552,0
"<anonymized_userid>",1,73414,7201,"Thierry Baudet (FvD)",0.971418741895361,0.769255421429334,0
"<anonymized_userid>",1,73415,7202,"Thierry Baudet (FvD)",0.971431973959298,0.769362247623117,0
"<anonymized_userid>",1,73416,7203,"Thierry Baudet (FvD)",0.971445206023235,0.7694690738169,0
"<anonymized_userid>",1,73417,7204,"Thierry Baudet (FvD)",0.971458438087173,0.769575900010683,0
"<anonymized_userid>",1,73418,7205,"Thierry Baudet (FvD)",0.97147167015111,0.769682726204465,0
"<anonymized_userid>",1,73419,7206,"Thierry Baudet (FvD)",0.971484902215047,0.769789552398248,0
"<anonymized_userid>",1,73420,7207,"Thierry Baudet (FvD)",0.971498134278985,0.769896378592031,0
"<anonymized_userid>",1,73421,7208,"Thierry Baudet (FvD)",0.971511366342922,0.770003204785814,0
"<anonymized_userid>",1,73422,7209,"Thierry Baudet (FvD)",0.971524598406859,0.770110030979596,0
"<anonymized_userid>",1,73423,7210,"Thierry Baudet (FvD)",0.971537830470797,0.770216857173379,0
"<anonymized_userid>",1,73424,7211,"Thierry Baudet (FvD)",0.971551062534734,0.770323683367162,0
"<anonymized_userid>",1,73425,7212,"Thierry Baudet (FvD)",0.971564294598672,0.770430509560944,0
"<anonymized_userid>",1,73426,7213,"Thierry Baudet (FvD)",0.971577526662609,0.770537335754727,0
"<anonymized_userid>",1,73427,7214,"Thierry Baudet (FvD)",0.971590758726546,0.77064416194851,0
"<anonymized_userid>",1,73428,7215,"Thierry Baudet (FvD)",0.971603990790484,0.770750988142292,0
"<anonymized_userid>",1,73429,7216,"Thierry Baudet (FvD)",0.971617222854421,0.770857814336075,0
"<anonymized_userid>",1,73430,7217,"Thierry Baudet (FvD)",0.971630454918358,0.770964640529858,0
"<anonymized_userid>",1,73431,7218,"Thierry Baudet (FvD)",0.971643686982296,0.771071466723641,0
"<anonymized_userid>",1,73432,7219,"Thierry Baudet (FvD)",0.971656919046233,0.771178292917423,0
"<anonymized_userid>",1,73433,7220,"Thierry Baudet (FvD)",0.97167015111017,0.771285119111206,0
"<anonymized_userid>",1,73434,7221,"Thierry Baudet (FvD)",0.971683383174108,0.771391945304989,0
"<anonymized_userid>",1,73435,7222,"Thierry Baudet (FvD)",0.971696615238045,0.771498771498772,0
"<anonymized_userid>",1,73436,7223,"Thierry Baudet (FvD)",0.971709847301982,0.771605597692554,0
"<anonymized_userid>",1,73437,7224,"Thierry Baudet (FvD)",0.97172307936592,0.771712423886337,0
"<anonymized_userid>",1,73438,7225,"Thierry Baudet (FvD)",0.971736311429857,0.77181925008012,0
"<anonymized_userid>",1,73439,7226,"Thierry Baudet (FvD)",0.971749543493794,0.771926076273902,0
"<anonymized_userid>",1,73440,7227,"Thierry Baudet (FvD)",0.971762775557731,0.772032902467685,0
"<anonymized_userid>",1,73441,7228,"Thierry Baudet (FvD)",0.971776007621669,0.772139728661468,0
"<anonymized_userid>",1,73442,7229,"Thierry Baudet (FvD)",0.971789239685606,0.772246554855251,0
"<anonymized_userid>",1,73443,7230,"Thierry Baudet (FvD)",0.971802471749543,0.772353381049033,0
"<anonymized_userid>",1,73444,7231,"Thierry Baudet (FvD)",0.971815703813481,0.772460207242816,0
"<anonymized_userid>",1,73445,7232,"Thierry Baudet (FvD)",0.971828935877418,0.772567033436599,0
"<anonymized_userid>",1,73446,7233,"Thierry Baudet (FvD)",0.971842167941355,0.772673859630381,0
"<anonymized_userid>",1,73447,7234,"Thierry Baudet (FvD)",0.971855400005293,0.772780685824164,0
"<anonymized_userid>",1,73448,7235,"Thierry Baudet (FvD)",0.97186863206923,0.772887512017947,0
"<anonymized_userid>",1,73449,7236,"Thierry Baudet (FvD)",0.971881864133167,0.772994338211729,0
"<anonymized_userid>",1,73450,7237,"Thierry Baudet (FvD)",0.971895096197105,0.773101164405512,0
"<anonymized_userid>",1,73451,7238,"Thierry Baudet (FvD)",0.971908328261042,0.773207990599295,0
"<anonymized_userid>",1,73452,7239,"Thierry Baudet (FvD)",0.971921560324979,0.773314816793078,0
"<anonymized_userid>",1,73453,7240,"Thierry Baudet (FvD)",0.971934792388917,0.77342164298686,0
"<anonymized_userid>",1,73454,7241,"Thierry Baudet (FvD)",0.971948024452854,0.773528469180643,0
"<anonymized_userid>",1,73455,7242,"Thierry Baudet (FvD)",0.971961256516791,0.773635295374426,0
"<anonymized_userid>",1,73456,7243,"Thierry Baudet (FvD)",0.971974488580729,0.773742121568209,0
"<anonymized_userid>",1,73457,7244,"Thierry Baudet (FvD)",0.971987720644666,0.773848947761991,0
"<anonymized_userid>",1,73458,7245,"Thierry Baudet (FvD)",0.972000952708604,0.773955773955774,0
"<anonymized_userid>",1,73459,7246,"Thierry Baudet (FvD)",0.972014184772541,0.774062600149557,0
"<anonymized_userid>",1,73460,7247,"Thierry Baudet (FvD)",0.972027416836478,0.774169426343339,0
"<anonymized_userid>",1,73461,7248,"Thierry Baudet (FvD)",0.972040648900416,0.774276252537122,0
"<anonymized_userid>",1,73462,7249,"Thierry Baudet (FvD)",0.972053880964353,0.774383078730905,0
"<anonymized_userid>",1,73463,7250,"Thierry Baudet (FvD)",0.97206711302829,0.774489904924688,0
"<anonymized_userid>",1,73464,7251,"Thierry Baudet (FvD)",0.972080345092228,0.77459673111847,0
"<anonymized_userid>",1,73465,7252,"Thierry Baudet (FvD)",0.972093577156165,0.774703557312253,0
"<anonymized_userid>",1,73466,7253,"Thierry Baudet (FvD)",0.972106809220102,0.774810383506036,0
"<anonymized_userid>",1,73467,7254,"Thierry Baudet (FvD)",0.97212004128404,0.774917209699818,0
"<anonymized_userid>",1,73468,7255,"Thierry Baudet (FvD)",0.972133273347977,0.775024035893601,0
"<anonymized_userid>",1,73469,7256,"Thierry Baudet (FvD)",0.972146505411914,0.775130862087384,0
"<anonymized_userid>",1,73470,7257,"Thierry Baudet (FvD)",0.972159737475851,0.775237688281167,0
"<anonymized_userid>",1,73471,7258,"Thierry Baudet (FvD)",0.972172969539789,0.775344514474949,0
"<anonymized_userid>",1,73472,7259,"Thierry Baudet (FvD)",0.972186201603726,0.775451340668732,0
"<anonymized_userid>",1,73473,7260,"Thierry Baudet (FvD)",0.972199433667663,0.775558166862515,0
"<anonymized_userid>",1,73474,7261,"Thierry Baudet (FvD)",0.972212665731601,0.775664993056297,0
"<anonymized_userid>",1,73475,7262,"Thierry Baudet (FvD)",0.972225897795538,0.77577181925008,0
"<anonymized_userid>",1,73476,7263,"Thierry Baudet (FvD)",0.972239129859475,0.775878645443863,0
"<anonymized_userid>",1,73477,7264,"Thierry Baudet (FvD)",0.972252361923413,0.775985471637646,0
"<anonymized_userid>",1,73478,7265,"Thierry Baudet (FvD)",0.97226559398735,0.776092297831428,0
"<anonymized_userid>",1,73479,7266,"Thierry Baudet (FvD)",0.972278826051287,0.776199124025211,0
"<anonymized_userid>",1,73480,7267,"Thierry Baudet (FvD)",0.972292058115225,0.776305950218994,0
"<anonymized_userid>",1,73481,7268,"Thierry Baudet (FvD)",0.972305290179162,0.776412776412776,0
"<anonymized_userid>",1,73482,7269,"Thierry Baudet (FvD)",0.972318522243099,0.776519602606559,0
"<anonymized_userid>",1,73483,7270,"Thierry Baudet (FvD)",0.972331754307037,0.776626428800342,0
"<anonymized_userid>",1,73484,7271,"Thierry Baudet (FvD)",0.972344986370974,0.776733254994125,0
"<anonymized_userid>",1,73485,7272,"Thierry Baudet (FvD)",0.972358218434911,0.776840081187907,0
"<anonymized_userid>",1,73486,7273,"Thierry Baudet (FvD)",0.972371450498849,0.77694690738169,0
"<anonymized_userid>",1,73487,7274,"Thierry Baudet (FvD)",0.972384682562786,0.777053733575473,0
"<anonymized_userid>",1,73488,7275,"Thierry Baudet (FvD)",0.972397914626723,0.777160559769255,0
"<anonymized_userid>",1,73489,7276,"Thierry Baudet (FvD)",0.972411146690661,0.777267385963038,0
"<anonymized_userid>",1,73490,7277,"Thierry Baudet (FvD)",0.972424378754598,0.777374212156821,0
"<anonymized_userid>",1,73491,7278,"Thierry Baudet (FvD)",0.972437610818536,0.777481038350604,0
"<anonymized_userid>",1,73492,7279,"Thierry Baudet (FvD)",0.972450842882473,0.777587864544386,0
"<anonymized_userid>",1,73493,7280,"Thierry Baudet (FvD)",0.97246407494641,0.777694690738169,0
"<anonymized_userid>",1,73494,7281,"Thierry Baudet (FvD)",0.972477307010348,0.777801516931952,0
"<anonymized_userid>",1,73495,7282,"Thierry Baudet (FvD)",0.972490539074285,0.777908343125734,0
"<anonymized_userid>",1,73496,7283,"Thierry Baudet (FvD)",0.972503771138222,0.778015169319517,0
"<anonymized_userid>",1,73497,7284,"Thierry Baudet (FvD)",0.97251700320216,0.7781219955133,0
"<anonymized_userid>",1,73498,7285,"Thierry Baudet (FvD)",0.972530235266097,0.778228821707083,0
"<anonymized_userid>",1,73499,7286,"Thierry Baudet (FvD)",0.972543467330034,0.778335647900865,0
"<anonymized_userid>",1,73500,7287,"Thierry Baudet (FvD)",0.972556699393971,0.778442474094648,0
"<anonymized_userid>",1,73501,7288,"Thierry Baudet (FvD)",0.972569931457909,0.778549300288431,0
"<anonymized_userid>",1,73502,7289,"Thierry Baudet (FvD)",0.972583163521846,0.778656126482213,0
"<anonymized_userid>",1,73503,7290,"Thierry Baudet (FvD)",0.972596395585783,0.778762952675996,0
"<anonymized_userid>",1,73504,7291,"Thierry Baudet (FvD)",0.972609627649721,0.778869778869779,0
"<anonymized_userid>",1,73505,7292,"Thierry Baudet (FvD)",0.972622859713658,0.778976605063562,0
"<anonymized_userid>",1,73506,7293,"Thierry Baudet (FvD)",0.972636091777595,0.779083431257344,0
"<anonymized_userid>",1,73507,7294,"Thierry Baudet (FvD)",0.972649323841533,0.779190257451127,0
"<anonymized_userid>",1,73508,7295,"Thierry Baudet (FvD)",0.97266255590547,0.77929708364491,0
"<anonymized_userid>",1,73509,7296,"Thierry Baudet (FvD)",0.972675787969407,0.779403909838692,0
"<anonymized_userid>",1,73510,7297,"Thierry Baudet (FvD)",0.972689020033345,0.779510736032475,0
"<anonymized_userid>",1,73511,7298,"Thierry Baudet (FvD)",0.972702252097282,0.779617562226258,0
"<anonymized_userid>",1,73512,7299,"Thierry Baudet (FvD)",0.972715484161219,0.779724388420041,0
"<anonymized_userid>",1,73513,7300,"Thierry Baudet (FvD)",0.972728716225157,0.779831214613823,0
"<anonymized_userid>",1,73514,7301,"Thierry Baudet (FvD)",0.972741948289094,0.779938040807606,0
"<anonymized_userid>",1,73515,7302,"Thierry Baudet (FvD)",0.972755180353031,0.780044867001389,0
"<anonymized_userid>",1,73516,7303,"Thierry Baudet (FvD)",0.972768412416969,0.780151693195171,0
"<anonymized_userid>",1,73517,7304,"Thierry Baudet (FvD)",0.972781644480906,0.780258519388954,0
"<anonymized_userid>",1,73518,7305,"Thierry Baudet (FvD)",0.972794876544843,0.780365345582737,0
"<anonymized_userid>",1,73519,7306,"Thierry Baudet (FvD)",0.972808108608781,0.78047217177652,0
"<anonymized_userid>",1,73520,7307,"Thierry Baudet (FvD)",0.972821340672718,0.780578997970302,0
"<anonymized_userid>",1,73521,7308,"Thierry Baudet (FvD)",0.972834572736655,0.780685824164085,0
"<anonymized_userid>",1,73522,7309,"Thierry Baudet (FvD)",0.972847804800593,0.780792650357868,0
"<anonymized_userid>",1,73523,7310,"Thierry Baudet (FvD)",0.97286103686453,0.78089947655165,0
"<anonymized_userid>",1,73524,7311,"Thierry Baudet (FvD)",0.972874268928468,0.781006302745433,0
"<anonymized_userid>",1,73525,7312,"Thierry Baudet (FvD)",0.972887500992405,0.781113128939216,0
"<anonymized_userid>",1,73526,7313,"Thierry Baudet (FvD)",0.972900733056342,0.781219955132999,0
"<anonymized_userid>",1,73527,7314,"Thierry Baudet (FvD)",0.97291396512028,0.781326781326781,0
"<anonymized_userid>",1,73528,7315,"Thierry Baudet (FvD)",0.972927197184217,0.781433607520564,0
"<anonymized_userid>",1,73529,7316,"Thierry Baudet (FvD)",0.972940429248154,0.781540433714347,0
"<anonymized_userid>",1,73530,7317,"Thierry Baudet (FvD)",0.972953661312091,0.781647259908129,0
"<anonymized_userid>",1,73531,7318,"Thierry Baudet (FvD)",0.972966893376029,0.781754086101912,0
"<anonymized_userid>",1,73532,7319,"Thierry Baudet (FvD)",0.972980125439966,0.781860912295695,0
"<anonymized_userid>",1,73533,7320,"Thierry Baudet (FvD)",0.972993357503903,0.781967738489478,0
"<anonymized_userid>",1,73534,7321,"Thierry Baudet (FvD)",0.973006589567841,0.78207456468326,0
"<anonymized_userid>",1,73535,7322,"Thierry Baudet (FvD)",0.973019821631778,0.782181390877043,0
"<anonymized_userid>",1,73536,7323,"Thierry Baudet (FvD)",0.973033053695715,0.782288217070826,0
"<anonymized_userid>",1,73537,7324,"Thierry Baudet (FvD)",0.973046285759653,0.782395043264609,0
"<anonymized_userid>",1,73538,7325,"Thierry Baudet (FvD)",0.97305951782359,0.782501869458391,0
"<anonymized_userid>",1,73539,7326,"Thierry Baudet (FvD)",0.973072749887527,0.782608695652174,0
"<anonymized_userid>",1,73540,7327,"Thierry Baudet (FvD)",0.973085981951465,0.782715521845957,0
"<anonymized_userid>",1,73541,7328,"Thierry Baudet (FvD)",0.973099214015402,0.782822348039739,0
"<anonymized_userid>",1,73542,7329,"Thierry Baudet (FvD)",0.973112446079339,0.782929174233522,0
"<anonymized_userid>",1,73543,7330,"Thierry Baudet (FvD)",0.973125678143277,0.783036000427305,0
"<anonymized_userid>",1,73544,7331,"Thierry Baudet (FvD)",0.973138910207214,0.783142826621087,0
"<anonymized_userid>",1,73545,7332,"Thierry Baudet (FvD)",0.973152142271151,0.78324965281487,0
"<anonymized_userid>",1,73546,7333,"Thierry Baudet (FvD)",0.973165374335089,0.783356479008653,0
"<anonymized_userid>",1,73547,7334,"Thierry Baudet (FvD)",0.973178606399026,0.783463305202436,0
"<anonymized_userid>",1,73548,7335,"Thierry Baudet (FvD)",0.973191838462963,0.783570131396218,0
"<anonymized_userid>",1,73549,7336,"Thierry Baudet (FvD)",0.973205070526901,0.783676957590001,0
"<anonymized_userid>",1,73550,7337,"Thierry Baudet (FvD)",0.973218302590838,0.783783783783784,0
"<anonymized_userid>",1,73551,7338,"Thierry Baudet (FvD)",0.973231534654775,0.783890609977567,0
"<anonymized_userid>",1,73552,7339,"Thierry Baudet (FvD)",0.973244766718713,0.783997436171349,0
"<anonymized_userid>",1,73553,7340,"Thierry Baudet (FvD)",0.97325799878265,0.784104262365132,0
"<anonymized_userid>",1,73554,7341,"Thierry Baudet (FvD)",0.973271230846587,0.784211088558915,0
"<anonymized_userid>",1,73555,7342,"Thierry Baudet (FvD)",0.973284462910525,0.784317914752697,0
"<anonymized_userid>",1,73556,7343,"Thierry Baudet (FvD)",0.973297694974462,0.78442474094648,0
"<anonymized_userid>",1,73557,7344,"Thierry Baudet (FvD)",0.973310927038399,0.784531567140263,0
"<anonymized_userid>",1,73558,7345,"Thierry Baudet (FvD)",0.973324159102337,0.784638393334046,0
"<anonymized_userid>",1,73559,7346,"Thierry Baudet (FvD)",0.973337391166274,0.784745219527828,0
"<anonymized_userid>",1,73560,7347,"Thierry Baudet (FvD)",0.973350623230211,0.784852045721611,0
"<anonymized_userid>",1,73561,7348,"Thierry Baudet (FvD)",0.973363855294149,0.784958871915394,0
"<anonymized_userid>",1,73562,7349,"Thierry Baudet (FvD)",0.973377087358086,0.785065698109176,0
"<anonymized_userid>",1,73563,7350,"Thierry Baudet (FvD)",0.973390319422023,0.785172524302959,0
"<anonymized_userid>",1,73564,7351,"Thierry Baudet (FvD)",0.973403551485961,0.785279350496742,0
"<anonymized_userid>",1,73565,7352,"Thierry Baudet (FvD)",0.973416783549898,0.785386176690524,0
"<anonymized_userid>",1,73566,7353,"Thierry Baudet (FvD)",0.973430015613835,0.785493002884307,0
"<anonymized_userid>",1,73567,7354,"Thierry Baudet (FvD)",0.973443247677773,0.78559982907809,0
"<anonymized_userid>",1,73568,7355,"Thierry Baudet (FvD)",0.97345647974171,0.785706655271873,0
"<anonymized_userid>",1,73569,7356,"Thierry Baudet (FvD)",0.973469711805647,0.785813481465655,0
"<anonymized_userid>",1,73570,7357,"Thierry Baudet (FvD)",0.973482943869585,0.785920307659438,0
"<anonymized_userid>",1,73571,7358,"Thierry Baudet (FvD)",0.973496175933522,0.786027133853221,0
"<anonymized_userid>",1,73572,7359,"Thierry Baudet (FvD)",0.973509407997459,0.786133960047004,0
"<anonymized_userid>",1,73573,7360,"Thierry Baudet (FvD)",0.973522640061397,0.786240786240786,0
"<anonymized_userid>",1,73574,7361,"Thierry Baudet (FvD)",0.973535872125334,0.786347612434569,0
"<anonymized_userid>",1,73575,7362,"Thierry Baudet (FvD)",0.973549104189271,0.786454438628352,0
"<anonymized_userid>",1,73576,7363,"Thierry Baudet (FvD)",0.973562336253209,0.786561264822134,0
"<anonymized_userid>",1,73577,7364,"Thierry Baudet (FvD)",0.973575568317146,0.786668091015917,0
"<anonymized_userid>",1,73578,7365,"Thierry Baudet (FvD)",0.973588800381083,0.7867749172097,0
"<anonymized_userid>",1,73579,7366,"Thierry Baudet (FvD)",0.973602032445021,0.786881743403482,0
"<anonymized_userid>",1,73580,7367,"Thierry Baudet (FvD)",0.973615264508958,0.786988569597265,0
"<anonymized_userid>",1,73581,7368,"Thierry Baudet (FvD)",0.973628496572895,0.787095395791048,0
"<anonymized_userid>",1,73582,7369,"Thierry Baudet (FvD)",0.973641728636833,0.787202221984831,0
"<anonymized_userid>",1,73583,7370,"Thierry Baudet (FvD)",0.97365496070077,0.787309048178613,0
"<anonymized_userid>",1,73584,7371,"Thierry Baudet (FvD)",0.973668192764707,0.787415874372396,0
"<anonymized_userid>",1,73585,7372,"Thierry Baudet (FvD)",0.973681424828645,0.787522700566179,0
"<anonymized_userid>",1,73586,7373,"Thierry Baudet (FvD)",0.973694656892582,0.787629526759962,0
"<anonymized_userid>",1,73587,7374,"Thierry Baudet (FvD)",0.973707888956519,0.787736352953744,0
"<anonymized_userid>",1,73588,7375,"Thierry Baudet (FvD)",0.973721121020457,0.787843179147527,0
"<anonymized_userid>",1,73589,7376,"Thierry Baudet (FvD)",0.973734353084394,0.78795000534131,0
"<anonymized_userid>",1,73590,7377,"Thierry Baudet (FvD)",0.973747585148331,0.788056831535092,0
"<anonymized_userid>",1,73591,7378,"Thierry Baudet (FvD)",0.973760817212269,0.788163657728875,0
"<anonymized_userid>",1,73592,7379,"Thierry Baudet (FvD)",0.973774049276206,0.788270483922658,0
"<anonymized_userid>",1,73593,7380,"Thierry Baudet (FvD)",0.973787281340143,0.788377310116441,0
"<anonymized_userid>",1,73594,7381,"Thierry Baudet (FvD)",0.973800513404081,0.788484136310223,0
"<anonymized_userid>",1,73595,7382,"Thierry Baudet (FvD)",0.973813745468018,0.788590962504006,0
"<anonymized_userid>",1,73596,7383,"Thierry Baudet (FvD)",0.973826977531955,0.788697788697789,0
"<anonymized_userid>",1,73597,7384,"Thierry Baudet (FvD)",0.973840209595893,0.788804614891571,0
"<anonymized_userid>",1,73598,7385,"Thierry Baudet (FvD)",0.97385344165983,0.788911441085354,0
"<anonymized_userid>",1,73599,7386,"Thierry Baudet (FvD)",0.973866673723767,0.789018267279137,0
"<anonymized_userid>",1,73600,7387,"Thierry Baudet (FvD)",0.973879905787705,0.78912509347292,0
"<anonymized_userid>",1,73601,7388,"Thierry Baudet (FvD)",0.973893137851642,0.789231919666702,0
"<anonymized_userid>",1,73602,7389,"Thierry Baudet (FvD)",0.973906369915579,0.789338745860485,0
"<anonymized_userid>",1,73603,7390,"Thierry Baudet (FvD)",0.973919601979517,0.789445572054268,0
"<anonymized_userid>",1,73604,7391,"Thierry Baudet (FvD)",0.973932834043454,0.78955239824805,0
"<anonymized_userid>",1,73605,7392,"Thierry Baudet (FvD)",0.973946066107391,0.789659224441833,0
"<anonymized_userid>",1,73606,7393,"Thierry Baudet (FvD)",0.973959298171329,0.789766050635616,0
"<anonymized_userid>",1,73607,7394,"Thierry Baudet (FvD)",0.973972530235266,0.789872876829399,0
"<anonymized_userid>",1,73608,7395,"Thierry Baudet (FvD)",0.973985762299203,0.789979703023181,0
"<anonymized_userid>",1,73609,7396,"Thierry Baudet (FvD)",0.973998994363141,0.790086529216964,0
"<anonymized_userid>",1,73610,7397,"Thierry Baudet (FvD)",0.974012226427078,0.790193355410747,0
"<anonymized_userid>",1,73611,7398,"Thierry Baudet (FvD)",0.974025458491015,0.790300181604529,0
"<anonymized_userid>",1,73612,7399,"Thierry Baudet (FvD)",0.974038690554953,0.790407007798312,0
"<anonymized_userid>",1,73613,7400,"Thierry Baudet (FvD)",0.97405192261889,0.790513833992095,0
"<anonymized_userid>",1,73614,7401,"Thierry Baudet (FvD)",0.974065154682827,0.790620660185878,0
"<anonymized_userid>",1,73615,7402,"Thierry Baudet (FvD)",0.974078386746765,0.79072748637966,0
"<anonymized_userid>",1,73616,7403,"Thierry Baudet (FvD)",0.974091618810702,0.790834312573443,0
"<anonymized_userid>",1,73617,7404,"Thierry Baudet (FvD)",0.974104850874639,0.790941138767226,0
"<anonymized_userid>",1,73618,7405,"Thierry Baudet (FvD)",0.974118082938577,0.791047964961008,0
"<anonymized_userid>",1,73619,7406,"Thierry Baudet (FvD)",0.974131315002514,0.791154791154791,0
"<anonymized_userid>",1,73620,7407,"Thierry Baudet (FvD)",0.974144547066451,0.791261617348574,0
"<anonymized_userid>",1,73621,7408,"Thierry Baudet (FvD)",0.974157779130389,0.791368443542357,0
"<anonymized_userid>",1,73622,7409,"Thierry Baudet (FvD)",0.974171011194326,0.791475269736139,0
"<anonymized_userid>",1,73623,7410,"Thierry Baudet (FvD)",0.974184243258263,0.791582095929922,0
"<anonymized_userid>",1,73624,7411,"Thierry Baudet (FvD)",0.974197475322201,0.791688922123705,0
"<anonymized_userid>",1,73625,7412,"Thierry Baudet (FvD)",0.974210707386138,0.791795748317487,0
"<anonymized_userid>",1,73626,7413,"Thierry Baudet (FvD)",0.974223939450075,0.79190257451127,0
"<anonymized_userid>",1,73627,7414,"Thierry Baudet (FvD)",0.974237171514013,0.792009400705053,0
"<anonymized_userid>",1,73628,7415,"Thierry Baudet (FvD)",0.97425040357795,0.792116226898836,0
"<anonymized_userid>",1,73629,7416,"Thierry Baudet (FvD)",0.974263635641887,0.792223053092618,0
"<anonymized_userid>",1,73630,7417,"Thierry Baudet (FvD)",0.974276867705825,0.792329879286401,0
"<anonymized_userid>",1,73631,7418,"Thierry Baudet (FvD)",0.974290099769762,0.792436705480184,0
"<anonymized_userid>",1,73632,7419,"Thierry Baudet (FvD)",0.974303331833699,0.792543531673966,0
"<anonymized_userid>",1,73633,7420,"Thierry Baudet (FvD)",0.974316563897637,0.792650357867749,0
"<anonymized_userid>",1,73634,7421,"Thierry Baudet (FvD)",0.974329795961574,0.792757184061532,0
"<anonymized_userid>",1,73635,7422,"Thierry Baudet (FvD)",0.974343028025511,0.792864010255315,0
"<anonymized_userid>",1,73636,7423,"Thierry Baudet (FvD)",0.974356260089449,0.792970836449097,0
"<anonymized_userid>",1,73637,7424,"Thierry Baudet (FvD)",0.974369492153386,0.79307766264288,0
"<anonymized_userid>",1,73638,7425,"Thierry Baudet (FvD)",0.974382724217323,0.793184488836663,0
"<anonymized_userid>",1,73639,7426,"Thierry Baudet (FvD)",0.974395956281261,0.793291315030445,0
"<anonymized_userid>",1,73640,7427,"Thierry Baudet (FvD)",0.974409188345198,0.793398141224228,0
"<anonymized_userid>",1,73641,7428,"Thierry Baudet (FvD)",0.974422420409135,0.793504967418011,0
"<anonymized_userid>",1,73642,7429,"Thierry Baudet (FvD)",0.974435652473073,0.793611793611794,0
"<anonymized_userid>",1,73643,7430,"Thierry Baudet (FvD)",0.97444888453701,0.793718619805576,0
"<anonymized_userid>",1,73644,7431,"Thierry Baudet (FvD)",0.974462116600947,0.793825445999359,0
"<anonymized_userid>",1,73645,7432,"Thierry Baudet (FvD)",0.974475348664885,0.793932272193142,0
"<anonymized_userid>",1,73646,7433,"Thierry Baudet (FvD)",0.974488580728822,0.794039098386924,0
"<anonymized_userid>",1,73647,7434,"Thierry Baudet (FvD)",0.974501812792759,0.794145924580707,0
"<anonymized_userid>",1,73648,7435,"Thierry Baudet (FvD)",0.974515044856697,0.79425275077449,0
"<anonymized_userid>",1,73649,7436,"Thierry Baudet (FvD)",0.974528276920634,0.794359576968273,0
"<anonymized_userid>",1,73650,7437,"Thierry Baudet (FvD)",0.974541508984571,0.794466403162055,0
"<anonymized_userid>",1,73651,7438,"Thierry Baudet (FvD)",0.974554741048509,0.794573229355838,0
"<anonymized_userid>",1,73652,7439,"Thierry Baudet (FvD)",0.974567973112446,0.794680055549621,0
"<anonymized_userid>",1,73653,7440,"Thierry Baudet (FvD)",0.974581205176383,0.794786881743404,0
"<anonymized_userid>",1,73654,7441,"Thierry Baudet (FvD)",0.974594437240321,0.794893707937186,0
"<anonymized_userid>",1,73655,7442,"Thierry Baudet (FvD)",0.974607669304258,0.795000534130969,0
"<anonymized_userid>",1,73656,7443,"Thierry Baudet (FvD)",0.974620901368195,0.795107360324752,0
"<anonymized_userid>",1,73657,7444,"Thierry Baudet (FvD)",0.974634133432133,0.795214186518534,0
"<anonymized_userid>",1,73658,7445,"Thierry Baudet (FvD)",0.97464736549607,0.795321012712317,0
"<anonymized_userid>",1,73659,7446,"Thierry Baudet (FvD)",0.974660597560007,0.7954278389061,0
"<anonymized_userid>",1,73660,7447,"Thierry Baudet (FvD)",0.974673829623945,0.795534665099882,0
"<anonymized_userid>",1,73661,7448,"Thierry Baudet (FvD)",0.974687061687882,0.795641491293665,0
"<anonymized_userid>",1,73662,7449,"Thierry Baudet (FvD)",0.974700293751819,0.795748317487448,0
"<anonymized_userid>",1,73663,7450,"Thierry Baudet (FvD)",0.974713525815757,0.795855143681231,0
"<anonymized_userid>",1,73664,7451,"Thierry Baudet (FvD)",0.974726757879694,0.795961969875013,0
"<anonymized_userid>",1,73665,7452,"Thierry Baudet (FvD)",0.974739989943631,0.796068796068796,0
"<anonymized_userid>",1,73666,7453,"Thierry Baudet (FvD)",0.974753222007569,0.796175622262579,0
"<anonymized_userid>",1,73667,7454,"Thierry Baudet (FvD)",0.974766454071506,0.796282448456362,0
"<anonymized_userid>",1,73668,7455,"Thierry Baudet (FvD)",0.974779686135443,0.796389274650144,0
"<anonymized_userid>",1,73669,7456,"Thierry Baudet (FvD)",0.974792918199381,0.796496100843927,0
"<anonymized_userid>",1,73670,7457,"Thierry Baudet (FvD)",0.974806150263318,0.79660292703771,0
"<anonymized_userid>",1,73671,7458,"Thierry Baudet (FvD)",0.974819382327255,0.796709753231492,0
"<anonymized_userid>",1,73672,7459,"Thierry Baudet (FvD)",0.974832614391193,0.796816579425275,0
"<anonymized_userid>",1,73673,7460,"Thierry Baudet (FvD)",0.97484584645513,0.796923405619058,0
"<anonymized_userid>",1,73674,7461,"Thierry Baudet (FvD)",0.974859078519067,0.79703023181284,0
"<anonymized_userid>",1,73675,7462,"Thierry Baudet (FvD)",0.974872310583005,0.797137058006623,0
"<anonymized_userid>",1,73676,7463,"Thierry Baudet (FvD)",0.974885542646942,0.797243884200406,0
"<anonymized_userid>",1,73677,7464,"Thierry Baudet (FvD)",0.974898774710879,0.797350710394189,0
"<anonymized_userid>",1,73678,7465,"Thierry Baudet (FvD)",0.974912006774817,0.797457536587971,0
"<anonymized_userid>",1,73679,7466,"Thierry Baudet (FvD)",0.974925238838754,0.797564362781754,0
"<anonymized_userid>",1,73680,7467,"Thierry Baudet (FvD)",0.974938470902691,0.797671188975537,0
"<anonymized_userid>",1,73681,7468,"Thierry Baudet (FvD)",0.974951702966629,0.79777801516932,0
"<anonymized_userid>",1,73682,7469,"Thierry Baudet (FvD)",0.974964935030566,0.797884841363102,0
"<anonymized_userid>",1,73683,7470,"Thierry Baudet (FvD)",0.974978167094503,0.797991667556885,0
"<anonymized_userid>",1,73684,7471,"Thierry Baudet (FvD)",0.974991399158441,0.798098493750668,0
"<anonymized_userid>",1,73685,7472,"Thierry Baudet (FvD)",0.975004631222378,0.79820531994445,0
"<anonymized_userid>",1,73686,7473,"Thierry Baudet (FvD)",0.975017863286315,0.798312146138233,0
"<anonymized_userid>",1,73687,7474,"Thierry Baudet (FvD)",0.975031095350253,0.798418972332016,0
"<anonymized_userid>",1,73688,7475,"Thierry Baudet (FvD)",0.97504432741419,0.798525798525799,0
"<anonymized_userid>",1,73689,7476,"Thierry Baudet (FvD)",0.975057559478127,0.798632624719581,0
"<anonymized_userid>",1,73690,7477,"Thierry Baudet (FvD)",0.975070791542065,0.798739450913364,0
"<anonymized_userid>",1,73691,7478,"Thierry Baudet (FvD)",0.975084023606002,0.798846277107147,0
"<anonymized_userid>",1,73692,7479,"Thierry Baudet (FvD)",0.975097255669939,0.798953103300929,0
"<anonymized_userid>",1,73693,7480,"Thierry Baudet (FvD)",0.975110487733877,0.799059929494712,0
"<anonymized_userid>",1,73694,7481,"Thierry Baudet (FvD)",0.975123719797814,0.799166755688495,0
"<anonymized_userid>",1,73695,7482,"Thierry Baudet (FvD)",0.975136951861751,0.799273581882277,0
"<anonymized_userid>",1,73696,7483,"Thierry Baudet (FvD)",0.975150183925689,0.79938040807606,0
"<anonymized_userid>",1,73697,7484,"Thierry Baudet (FvD)",0.975163415989626,0.799487234269843,0
"<anonymized_userid>",1,73698,7485,"Thierry Baudet (FvD)",0.975176648053563,0.799594060463626,0
"<anonymized_userid>",1,73699,7486,"Thierry Baudet (FvD)",0.975189880117501,0.799700886657408,0
"<anonymized_userid>",1,73700,7487,"Thierry Baudet (FvD)",0.975203112181438,0.799807712851191,0
"<anonymized_userid>",1,73701,7488,"Thierry Baudet (FvD)",0.975216344245375,0.799914539044974,0
"<anonymized_userid>",1,73702,7489,"Thierry Baudet (FvD)",0.975229576309313,0.800021365238757,0
"<anonymized_userid>",1,73703,7490,"Thierry Baudet (FvD)",0.97524280837325,0.800128191432539,0
"<anonymized_userid>",1,73704,7491,"Thierry Baudet (FvD)",0.975256040437187,0.800235017626322,0
"<anonymized_userid>",1,73705,7492,"Thierry Baudet (FvD)",0.975269272501125,0.800341843820105,0
"<anonymized_userid>",1,73706,7493,"Thierry Baudet (FvD)",0.975282504565062,0.800448670013887,0
"<anonymized_userid>",1,73707,7494,"Thierry Baudet (FvD)",0.975295736628999,0.80055549620767,0
"<anonymized_userid>",1,73708,7495,"Thierry Baudet (FvD)",0.975308968692937,0.800662322401453,0
"<anonymized_userid>",1,73709,7496,"Thierry Baudet (FvD)",0.975322200756874,0.800769148595236,0
"<anonymized_userid>",1,73710,7497,"Thierry Baudet (FvD)",0.975335432820811,0.800875974789018,0
"<anonymized_userid>",1,73711,7498,"Thierry Baudet (FvD)",0.975348664884749,0.800982800982801,0
"<anonymized_userid>",1,73712,7499,"Thierry Baudet (FvD)",0.975361896948686,0.801089627176584,0
"<anonymized_userid>",1,73713,7500,"Thierry Baudet (FvD)",0.975375129012623,0.801196453370366,0
"<anonymized_userid>",1,73714,7501,"Thierry Baudet (FvD)",0.975388361076561,0.801303279564149,0
"<anonymized_userid>",1,73715,7502,"Thierry Baudet (FvD)",0.975401593140498,0.801410105757932,0
"<anonymized_userid>",1,73716,7503,"Thierry Baudet (FvD)",0.975414825204435,0.801516931951715,0
"<anonymized_userid>",1,73717,7504,"Thierry Baudet (FvD)",0.975428057268373,0.801623758145497,0
"<anonymized_userid>",1,73718,7505,"Thierry Baudet (FvD)",0.97544128933231,0.80173058433928,0
"<anonymized_userid>",1,73719,7506,"Thierry Baudet (FvD)",0.975454521396247,0.801837410533063,0
"<anonymized_userid>",1,73720,7507,"Thierry Baudet (FvD)",0.975467753460185,0.801944236726845,0
"<anonymized_userid>",1,73721,7508,"Thierry Baudet (FvD)",0.975480985524122,0.802051062920628,0
"<anonymized_userid>",1,73722,7509,"Thierry Baudet (FvD)",0.975494217588059,0.802157889114411,0
"<anonymized_userid>",1,73723,7510,"Thierry Baudet (FvD)",0.975507449651997,0.802264715308194,0
"<anonymized_userid>",1,73724,7511,"Thierry Baudet (FvD)",0.975520681715934,0.802371541501976,0
"<anonymized_userid>",1,73725,7512,"Thierry Baudet (FvD)",0.975533913779871,0.802478367695759,0
"<anonymized_userid>",1,73726,7513,"Thierry Baudet (FvD)",0.975547145843809,0.802585193889542,0
"<anonymized_userid>",1,73727,7514,"Thierry Baudet (FvD)",0.975560377907746,0.802692020083324,0
"<anonymized_userid>",1,73728,7515,"Thierry Baudet (FvD)",0.975573609971683,0.802798846277107,0
"<anonymized_userid>",1,73729,7516,"Thierry Baudet (FvD)",0.975586842035621,0.80290567247089,0
"<anonymized_userid>",1,73730,7517,"Thierry Baudet (FvD)",0.975600074099558,0.803012498664673,0
"<anonymized_userid>",1,73731,7518,"Thierry Baudet (FvD)",0.975613306163495,0.803119324858455,0
"<anonymized_userid>",1,73732,7519,"Thierry Baudet (FvD)",0.975626538227433,0.803226151052238,0
"<anonymized_userid>",1,73733,7520,"Thierry Baudet (FvD)",0.97563977029137,0.803332977246021,0
"<anonymized_userid>",1,73734,7521,"Thierry Baudet (FvD)",0.975653002355307,0.803439803439803,0
"<anonymized_userid>",1,73735,7522,"Thierry Baudet (FvD)",0.975666234419245,0.803546629633586,0
"<anonymized_userid>",1,73736,7523,"Thierry Baudet (FvD)",0.975679466483182,0.803653455827369,0
"<anonymized_userid>",1,73737,7524,"Thierry Baudet (FvD)",0.975692698547119,0.803760282021152,0
"<anonymized_userid>",1,73738,7525,"Thierry Baudet (FvD)",0.975705930611057,0.803867108214934,0
"<anonymized_userid>",1,73739,7526,"Thierry Baudet (FvD)",0.975719162674994,0.803973934408717,0
"<anonymized_userid>",1,73740,7527,"Thierry Baudet (FvD)",0.975732394738931,0.8040807606025,0
"<anonymized_userid>",1,73741,7528,"Thierry Baudet (FvD)",0.975745626802869,0.804187586796282,0
"<anonymized_userid>",1,73742,7529,"Thierry Baudet (FvD)",0.975758858866806,0.804294412990065,0
"<anonymized_userid>",1,73743,7530,"Thierry Baudet (FvD)",0.975772090930743,0.804401239183848,0
"<anonymized_userid>",1,73744,7531,"Thierry Baudet (FvD)",0.975785322994681,0.804508065377631,0
"<anonymized_userid>",1,73745,7532,"Thierry Baudet (FvD)",0.975798555058618,0.804614891571413,0
"<anonymized_userid>",1,73746,7533,"Thierry Baudet (FvD)",0.975811787122555,0.804721717765196,0
"<anonymized_userid>",1,73747,7534,"Thierry Baudet (FvD)",0.975825019186493,0.804828543958979,0
"<anonymized_userid>",1,73748,7535,"Thierry Baudet (FvD)",0.97583825125043,0.804935370152762,0
"<anonymized_userid>",1,73749,7536,"Thierry Baudet (FvD)",0.975851483314367,0.805042196346544,0
"<anonymized_userid>",1,73750,7537,"Thierry Baudet (FvD)",0.975864715378305,0.805149022540327,0
"<anonymized_userid>",1,73751,7538,"Thierry Baudet (FvD)",0.975877947442242,0.80525584873411,0
"<anonymized_userid>",1,73752,7539,"Thierry Baudet (FvD)",0.975891179506179,0.805362674927892,0
"<anonymized_userid>",1,73753,7540,"Thierry Baudet (FvD)",0.975904411570117,0.805469501121675,0
"<anonymized_userid>",1,73754,7541,"Thierry Baudet (FvD)",0.975917643634054,0.805576327315458,0
"<anonymized_userid>",1,73755,7542,"Thierry Baudet (FvD)",0.975930875697991,0.80568315350924,0
"<anonymized_userid>",1,73756,7543,"Thierry Baudet (FvD)",0.975944107761929,0.805789979703023,0
"<anonymized_userid>",1,73757,7544,"Thierry Baudet (FvD)",0.975957339825866,0.805896805896806,0
"<anonymized_userid>",1,73758,7545,"Thierry Baudet (FvD)",0.975970571889803,0.806003632090589,0
"<anonymized_userid>",1,73759,7546,"Thierry Baudet (FvD)",0.975983803953741,0.806110458284371,0
"<anonymized_userid>",1,73760,7547,"Thierry Baudet (FvD)",0.975997036017678,0.806217284478154,0
"<anonymized_userid>",1,73761,7548,"Thierry Baudet (FvD)",0.976010268081615,0.806324110671937,0
"<anonymized_userid>",1,73762,7549,"Thierry Baudet (FvD)",0.976023500145553,0.806430936865719,0
"<anonymized_userid>",1,73763,7550,"Thierry Baudet (FvD)",0.97603673220949,0.806537763059502,0
"<anonymized_userid>",1,73764,7551,"Thierry Baudet (FvD)",0.976049964273427,0.806644589253285,0
"<anonymized_userid>",1,73765,7552,"Thierry Baudet (FvD)",0.976063196337365,0.806751415447068,0
"<anonymized_userid>",1,73766,7553,"Thierry Baudet (FvD)",0.976076428401302,0.80685824164085,0
"<anonymized_userid>",1,73767,7554,"Thierry Baudet (FvD)",0.976089660465239,0.806965067834633,0
"<anonymized_userid>",1,73768,7555,"Thierry Baudet (FvD)",0.976102892529177,0.807071894028416,0
"<anonymized_userid>",1,73769,7556,"Thierry Baudet (FvD)",0.976116124593114,0.807178720222198,0
"<anonymized_userid>",1,73770,7557,"Thierry Baudet (FvD)",0.976129356657051,0.807285546415981,0
"<anonymized_userid>",1,73771,7558,"Thierry Baudet (FvD)",0.976142588720989,0.807392372609764,0
"<anonymized_userid>",1,73772,7559,"Thierry Baudet (FvD)",0.976155820784926,0.807499198803547,0
"<anonymized_userid>",1,73773,7560,"Thierry Baudet (FvD)",0.976169052848863,0.807606024997329,0
"<anonymized_userid>",1,73774,7561,"Thierry Baudet (FvD)",0.976182284912801,0.807712851191112,0
"<anonymized_userid>",1,73775,7562,"Thierry Baudet (FvD)",0.976195516976738,0.807819677384895,0
"<anonymized_userid>",1,73776,7563,"Thierry Baudet (FvD)",0.976208749040675,0.807926503578677,0
"<anonymized_userid>",1,73777,7564,"Thierry Baudet (FvD)",0.976221981104613,0.80803332977246,0
"<anonymized_userid>",1,73778,7565,"Thierry Baudet (FvD)",0.97623521316855,0.808140155966243,0
"<anonymized_userid>",1,73779,7566,"Thierry Baudet (FvD)",0.976248445232487,0.808246982160026,0
"<anonymized_userid>",1,73780,7567,"Thierry Baudet (FvD)",0.976261677296425,0.808353808353808,0
"<anonymized_userid>",1,73781,7568,"Thierry Baudet (FvD)",0.976274909360362,0.808460634547591,0
"<anonymized_userid>",1,73782,7569,"Thierry Baudet (FvD)",0.976288141424299,0.808567460741374,0
"<anonymized_userid>",1,73783,7570,"Thierry Baudet (FvD)",0.976301373488237,0.808674286935157,0
"<anonymized_userid>",1,73784,7571,"Thierry Baudet (FvD)",0.976314605552174,0.808781113128939,0
"<anonymized_userid>",1,73785,7572,"Thierry Baudet (FvD)",0.976327837616111,0.808887939322722,0
"<anonymized_userid>",1,73786,7573,"Thierry Baudet (FvD)",0.976341069680049,0.808994765516505,0
"<anonymized_userid>",1,73787,7574,"Thierry Baudet (FvD)",0.976354301743986,0.809101591710287,0
"<anonymized_userid>",1,73788,7575,"Thierry Baudet (FvD)",0.976367533807923,0.80920841790407,0
"<anonymized_userid>",1,73789,7576,"Thierry Baudet (FvD)",0.976380765871861,0.809315244097853,0
"<anonymized_userid>",1,73790,7577,"Thierry Baudet (FvD)",0.976393997935798,0.809422070291635,0
"<anonymized_userid>",1,73791,7578,"Thierry Baudet (FvD)",0.976407229999735,0.809528896485418,0
"<anonymized_userid>",1,73792,7579,"Thierry Baudet (FvD)",0.976420462063673,0.809635722679201,0
"<anonymized_userid>",1,73793,7580,"Thierry Baudet (FvD)",0.97643369412761,0.809742548872984,0
"<anonymized_userid>",1,73794,7581,"Thierry Baudet (FvD)",0.976446926191547,0.809849375066766,0
"<anonymized_userid>",1,73795,7582,"Thierry Baudet (FvD)",0.976460158255485,0.809956201260549,0
"<anonymized_userid>",1,73796,7583,"Thierry Baudet (FvD)",0.976473390319422,0.810063027454332,0
"<anonymized_userid>",1,73797,7584,"Thierry Baudet (FvD)",0.976486622383359,0.810169853648115,0
"<anonymized_userid>",1,73798,7585,"Thierry Baudet (FvD)",0.976499854447297,0.810276679841897,0
"<anonymized_userid>",1,73799,7586,"Thierry Baudet (FvD)",0.976513086511234,0.81038350603568,0
"<anonymized_userid>",1,73800,7587,"Thierry Baudet (FvD)",0.976526318575171,0.810490332229463,0
"<anonymized_userid>",1,73801,7588,"Thierry Baudet (FvD)",0.976539550639109,0.810597158423245,0
"<anonymized_userid>",1,73802,7589,"Thierry Baudet (FvD)",0.976552782703046,0.810703984617028,0
"<anonymized_userid>",1,73803,7590,"Thierry Baudet (FvD)",0.976566014766983,0.810810810810811,0
"<anonymized_userid>",1,73804,7591,"Thierry Baudet (FvD)",0.976579246830921,0.810917637004594,0
"<anonymized_userid>",1,73805,7592,"Thierry Baudet (FvD)",0.976592478894858,0.811024463198376,0
"<anonymized_userid>",1,73806,7593,"Thierry Baudet (FvD)",0.976605710958795,0.811131289392159,0
"<anonymized_userid>",1,73807,7594,"Thierry Baudet (FvD)",0.976618943022733,0.811238115585942,0
"<anonymized_userid>",1,73808,7595,"Thierry Baudet (FvD)",0.97663217508667,0.811344941779724,0
"<anonymized_userid>",1,73809,7596,"Thierry Baudet (FvD)",0.976645407150607,0.811451767973507,0
"<anonymized_userid>",1,73810,7597,"Thierry Baudet (FvD)",0.976658639214545,0.81155859416729,0
"<anonymized_userid>",1,73811,7598,"Thierry Baudet (FvD)",0.976671871278482,0.811665420361073,0
"<anonymized_userid>",1,73812,7599,"Thierry Baudet (FvD)",0.976685103342419,0.811772246554855,0
"<anonymized_userid>",1,73813,7600,"Thierry Baudet (FvD)",0.976698335406357,0.811879072748638,0
"<anonymized_userid>",1,73814,7601,"Thierry Baudet (FvD)",0.976711567470294,0.811985898942421,0
"<anonymized_userid>",1,73815,7602,"Thierry Baudet (FvD)",0.976724799534231,0.812092725136203,0
"<anonymized_userid>",1,73816,7603,"Thierry Baudet (FvD)",0.976738031598169,0.812199551329986,0
"<anonymized_userid>",1,73817,7604,"Thierry Baudet (FvD)",0.976751263662106,0.812306377523769,0
"<anonymized_userid>",1,73818,7605,"Thierry Baudet (FvD)",0.976764495726043,0.812413203717552,0
"<anonymized_userid>",1,73819,7606,"Thierry Baudet (FvD)",0.976777727789981,0.812520029911334,0
"<anonymized_userid>",1,73820,7607,"Thierry Baudet (FvD)",0.976790959853918,0.812626856105117,0
"<anonymized_userid>",1,73821,7608,"Thierry Baudet (FvD)",0.976804191917855,0.8127336822989,0
"<anonymized_userid>",1,73822,7609,"Thierry Baudet (FvD)",0.976817423981793,0.812840508492682,0
"<anonymized_userid>",1,73823,7610,"Thierry Baudet (FvD)",0.97683065604573,0.812947334686465,0
"<anonymized_userid>",1,73824,7611,"Thierry Baudet (FvD)",0.976843888109667,0.813054160880248,0
"<anonymized_userid>",1,73825,7612,"Thierry Baudet (FvD)",0.976857120173605,0.813160987074031,0
"<anonymized_userid>",1,73826,7613,"Thierry Baudet (FvD)",0.976870352237542,0.813267813267813,0
"<anonymized_userid>",1,73827,7614,"Thierry Baudet (FvD)",0.976883584301479,0.813374639461596,0
"<anonymized_userid>",1,73828,7615,"Thierry Baudet (FvD)",0.976896816365417,0.813481465655379,0
"<anonymized_userid>",1,73829,7616,"Thierry Baudet (FvD)",0.976910048429354,0.813588291849161,0
"<anonymized_userid>",1,73830,7617,"Thierry Baudet (FvD)",0.976923280493291,0.813695118042944,0
"<anonymized_userid>",1,73831,7618,"Thierry Baudet (FvD)",0.976936512557229,0.813801944236727,0
"<anonymized_userid>",1,73832,7619,"Thierry Baudet (FvD)",0.976949744621166,0.81390877043051,0
"<anonymized_userid>",1,73833,7620,"Thierry Baudet (FvD)",0.976962976685103,0.814015596624292,0
"<anonymized_userid>",1,73834,7621,"Thierry Baudet (FvD)",0.976976208749041,0.814122422818075,0
"<anonymized_userid>",1,73835,7622,"Thierry Baudet (FvD)",0.976989440812978,0.814229249011858,0
"<anonymized_userid>",1,73836,7623,"Thierry Baudet (FvD)",0.977002672876915,0.81433607520564,0
"<anonymized_userid>",1,73837,7624,"Thierry Baudet (FvD)",0.977015904940853,0.814442901399423,0
"<anonymized_userid>",1,73838,7625,"Thierry Baudet (FvD)",0.97702913700479,0.814549727593206,0
"<anonymized_userid>",1,73839,7626,"Thierry Baudet (FvD)",0.977042369068727,0.814656553786989,0
"<anonymized_userid>",1,73840,7627,"Thierry Baudet (FvD)",0.977055601132665,0.814763379980771,0
"<anonymized_userid>",1,73841,7628,"Thierry Baudet (FvD)",0.977068833196602,0.814870206174554,0
"<anonymized_userid>",1,73842,7629,"Thierry Baudet (FvD)",0.977082065260539,0.814977032368337,0
"<anonymized_userid>",1,73843,7630,"Thierry Baudet (FvD)",0.977095297324477,0.815083858562119,0
"<anonymized_userid>",1,73844,7631,"Thierry Baudet (FvD)",0.977108529388414,0.815190684755902,0
"<anonymized_userid>",1,73845,7632,"Thierry Baudet (FvD)",0.977121761452351,0.815297510949685,0
"<anonymized_userid>",1,73846,7633,"Thierry Baudet (FvD)",0.977134993516289,0.815404337143468,0
"<anonymized_userid>",1,73847,7634,"Thierry Baudet (FvD)",0.977148225580226,0.81551116333725,0
"<anonymized_userid>",1,73848,7635,"Thierry Baudet (FvD)",0.977161457644163,0.815617989531033,0
"<anonymized_userid>",1,73849,7636,"Thierry Baudet (FvD)",0.977174689708101,0.815724815724816,0
"<anonymized_userid>",1,73850,7637,"Thierry Baudet (FvD)",0.977187921772038,0.815831641918598,0
"<anonymized_userid>",1,73851,7638,"Thierry Baudet (FvD)",0.977201153835975,0.815938468112381,0
"<anonymized_userid>",1,73852,7639,"Thierry Baudet (FvD)",0.977214385899913,0.816045294306164,0
"<anonymized_userid>",1,73853,7640,"Thierry Baudet (FvD)",0.97722761796385,0.816152120499947,0
"<anonymized_userid>",1,73854,7641,"Thierry Baudet (FvD)",0.977240850027787,0.816258946693729,0
"<anonymized_userid>",1,73855,7642,"Thierry Baudet (FvD)",0.977254082091725,0.816365772887512,0
"<anonymized_userid>",1,73856,7643,"Thierry Baudet (FvD)",0.977267314155662,0.816472599081295,0
"<anonymized_userid>",1,73857,7644,"Thierry Baudet (FvD)",0.977280546219599,0.816579425275077,0
"<anonymized_userid>",1,73858,7645,"Thierry Baudet (FvD)",0.977293778283537,0.81668625146886,0
"<anonymized_userid>",1,73859,7646,"Thierry Baudet (FvD)",0.977307010347474,0.816793077662643,0
"<anonymized_userid>",1,73860,7647,"Thierry Baudet (FvD)",0.977320242411411,0.816899903856426,0
"<anonymized_userid>",1,73861,7648,"Thierry Baudet (FvD)",0.977333474475349,0.817006730050208,0
"<anonymized_userid>",1,73862,7649,"Thierry Baudet (FvD)",0.977346706539286,0.817113556243991,0
"<anonymized_userid>",1,73863,7650,"Thierry Baudet (FvD)",0.977359938603223,0.817220382437774,0
"<anonymized_userid>",1,73864,7651,"Thierry Baudet (FvD)",0.977373170667161,0.817327208631557,0
"<anonymized_userid>",1,73865,7652,"Thierry Baudet (FvD)",0.977386402731098,0.817434034825339,0
"<anonymized_userid>",1,73866,7653,"Thierry Baudet (FvD)",0.977399634795035,0.817540861019122,0
"<anonymized_userid>",1,73867,7654,"Thierry Baudet (FvD)",0.977412866858973,0.817647687212905,0
"<anonymized_userid>",1,73868,7655,"Thierry Baudet (FvD)",0.97742609892291,0.817754513406687,0
"<anonymized_userid>",1,73869,7656,"Thierry Baudet (FvD)",0.977439330986847,0.81786133960047,0
"<anonymized_userid>",1,73870,7657,"Thierry Baudet (FvD)",0.977452563050785,0.817968165794253,0
"<anonymized_userid>",1,73871,7658,"Thierry Baudet (FvD)",0.977465795114722,0.818074991988035,0
"<anonymized_userid>",1,73872,7659,"Thierry Baudet (FvD)",0.977479027178659,0.818181818181818,0
"<anonymized_userid>",1,73873,7660,"Thierry Baudet (FvD)",0.977492259242597,0.818288644375601,0
"<anonymized_userid>",1,73874,7661,"Thierry Baudet (FvD)",0.977505491306534,0.818395470569384,0
"<anonymized_userid>",1,73875,7662,"Thierry Baudet (FvD)",0.977518723370471,0.818502296763166,0
"<anonymized_userid>",1,73876,7663,"Thierry Baudet (FvD)",0.977531955434409,0.818609122956949,0
"<anonymized_userid>",1,73877,7664,"Thierry Baudet (FvD)",0.977545187498346,0.818715949150732,0
"<anonymized_userid>",1,73878,7665,"Thierry Baudet (FvD)",0.977558419562283,0.818822775344514,0
"<anonymized_userid>",1,73879,7666,"Thierry Baudet (FvD)",0.977571651626221,0.818929601538297,0
"<anonymized_userid>",1,73880,7667,"Thierry Baudet (FvD)",0.977584883690158,0.81903642773208,0
"<anonymized_userid>",1,73881,7668,"Thierry Baudet (FvD)",0.977598115754095,0.819143253925863,0
"<anonymized_userid>",1,73882,7669,"Thierry Baudet (FvD)",0.977611347818033,0.819250080119645,0
"<anonymized_userid>",1,73883,7670,"Thierry Baudet (FvD)",0.97762457988197,0.819356906313428,0
"<anonymized_userid>",1,73884,7671,"Thierry Baudet (FvD)",0.977637811945907,0.819463732507211,0
"<anonymized_userid>",1,73885,7672,"Thierry Baudet (FvD)",0.977651044009845,0.819570558700993,0
"<anonymized_userid>",1,73886,7673,"Thierry Baudet (FvD)",0.977664276073782,0.819677384894776,0
"<anonymized_userid>",1,73887,7674,"Thierry Baudet (FvD)",0.977677508137719,0.819784211088559,0
"<anonymized_userid>",1,73888,7675,"Thierry Baudet (FvD)",0.977690740201657,0.819891037282342,0
"<anonymized_userid>",1,73889,7676,"Thierry Baudet (FvD)",0.977703972265594,0.819997863476124,0
"<anonymized_userid>",1,73890,7677,"Thierry Baudet (FvD)",0.977717204329531,0.820104689669907,0
"<anonymized_userid>",1,73891,7678,"Thierry Baudet (FvD)",0.977730436393469,0.82021151586369,0
"<anonymized_userid>",1,73892,7679,"Thierry Baudet (FvD)",0.977743668457406,0.820318342057472,0
"<anonymized_userid>",1,73893,7680,"Thierry Baudet (FvD)",0.977756900521343,0.820425168251255,0
"<anonymized_userid>",1,73894,7681,"Thierry Baudet (FvD)",0.977770132585281,0.820531994445038,0
"<anonymized_userid>",1,73895,7682,"Thierry Baudet (FvD)",0.977783364649218,0.820638820638821,0
"<anonymized_userid>",1,73896,7683,"Thierry Baudet (FvD)",0.977796596713155,0.820745646832603,0
"<anonymized_userid>",1,73897,7684,"Thierry Baudet (FvD)",0.977809828777093,0.820852473026386,0
"<anonymized_userid>",1,73898,7685,"Thierry Baudet (FvD)",0.97782306084103,0.820959299220169,0
"<anonymized_userid>",1,73899,7686,"Thierry Baudet (FvD)",0.977836292904967,0.821066125413952,0
"<anonymized_userid>",1,73900,7687,"Thierry Baudet (FvD)",0.977849524968905,0.821172951607734,0
"<anonymized_userid>",1,73901,7688,"Thierry Baudet (FvD)",0.977862757032842,0.821279777801517,0
"<anonymized_userid>",1,73902,7689,"Thierry Baudet (FvD)",0.977875989096779,0.8213866039953,0
"<anonymized_userid>",1,73903,7690,"Thierry Baudet (FvD)",0.977889221160717,0.821493430189082,0
"<anonymized_userid>",1,73904,7691,"Thierry Baudet (FvD)",0.977902453224654,0.821600256382865,0
"<anonymized_userid>",1,73905,7692,"Thierry Baudet (FvD)",0.977915685288591,0.821707082576648,0
"<anonymized_userid>",1,73906,7693,"Thierry Baudet (FvD)",0.977928917352529,0.82181390877043,0
"<anonymized_userid>",1,73907,7694,"Thierry Baudet (FvD)",0.977942149416466,0.821920734964213,0
"<anonymized_userid>",1,73908,7695,"Thierry Baudet (FvD)",0.977955381480403,0.822027561157996,0
"<anonymized_userid>",1,73909,7696,"Thierry Baudet (FvD)",0.977968613544341,0.822134387351779,0
"<anonymized_userid>",1,73910,7697,"Thierry Baudet (FvD)",0.977981845608278,0.822241213545561,0
"<anonymized_userid>",1,73911,7698,"Thierry Baudet (FvD)",0.977995077672215,0.822348039739344,0
"<anonymized_userid>",1,73912,7699,"Thierry Baudet (FvD)",0.978008309736153,0.822454865933127,0
"<anonymized_userid>",1,73913,7700,"Thierry Baudet (FvD)",0.97802154180009,0.82256169212691,0
"<anonymized_userid>",1,73914,7701,"Thierry Baudet (FvD)",0.978034773864027,0.822668518320692,0
"<anonymized_userid>",1,73915,7702,"Thierry Baudet (FvD)",0.978048005927965,0.822775344514475,0
"<anonymized_userid>",1,73916,7703,"Thierry Baudet (FvD)",0.978061237991902,0.822882170708258,0
"<anonymized_userid>",1,73917,7704,"Thierry Baudet (FvD)",0.978074470055839,0.82298899690204,0
"<anonymized_userid>",1,73918,7705,"Thierry Baudet (FvD)",0.978087702119777,0.823095823095823,0
"<anonymized_userid>",1,73919,7706,"Thierry Baudet (FvD)",0.978100934183714,0.823202649289606,0
"<anonymized_userid>",1,73920,7707,"Thierry Baudet (FvD)",0.978114166247651,0.823309475483389,0
"<anonymized_userid>",1,73921,7708,"Thierry Baudet (FvD)",0.978127398311589,0.823416301677171,0
"<anonymized_userid>",1,73922,7709,"Thierry Baudet (FvD)",0.978140630375526,0.823523127870954,0
"<anonymized_userid>",1,73923,7710,"Thierry Baudet (FvD)",0.978153862439463,0.823629954064737,0
"<anonymized_userid>",1,73924,7711,"Thierry Baudet (FvD)",0.978167094503401,0.823736780258519,0
"<anonymized_userid>",1,73925,7712,"Thierry Baudet (FvD)",0.978180326567338,0.823843606452302,0
"<anonymized_userid>",1,73926,7713,"Thierry Baudet (FvD)",0.978193558631275,0.823950432646085,0
"<anonymized_userid>",1,73927,7714,"Thierry Baudet (FvD)",0.978206790695213,0.824057258839868,0
"<anonymized_userid>",1,73928,7715,"Thierry Baudet (FvD)",0.97822002275915,0.82416408503365,0
"<anonymized_userid>",1,73929,7716,"Thierry Baudet (FvD)",0.978233254823087,0.824270911227433,0
"<anonymized_userid>",1,73930,7717,"Thierry Baudet (FvD)",0.978246486887025,0.824377737421216,0
"<anonymized_userid>",1,73931,7718,"Thierry Baudet (FvD)",0.978259718950962,0.824484563614998,0
"<anonymized_userid>",1,73932,7719,"Thierry Baudet (FvD)",0.978272951014899,0.824591389808781,0
"<anonymized_userid>",1,73933,7720,"Thierry Baudet (FvD)",0.978286183078837,0.824698216002564,0
"<anonymized_userid>",1,73934,7721,"Thierry Baudet (FvD)",0.978299415142774,0.824805042196347,0
"<anonymized_userid>",1,73935,7722,"Thierry Baudet (FvD)",0.978312647206711,0.824911868390129,0
"<anonymized_userid>",1,73936,7723,"Thierry Baudet (FvD)",0.978325879270649,0.825018694583912,0
"<anonymized_userid>",1,73937,7724,"Thierry Baudet (FvD)",0.978339111334586,0.825125520777695,0
"<anonymized_userid>",1,73938,7725,"Thierry Baudet (FvD)",0.978352343398523,0.825232346971477,0
"<anonymized_userid>",1,73939,7726,"Thierry Baudet (FvD)",0.978365575462461,0.82533917316526,0
"<anonymized_userid>",1,73940,7727,"Thierry Baudet (FvD)",0.978378807526398,0.825445999359043,0
"<anonymized_userid>",1,73941,7728,"Thierry Baudet (FvD)",0.978392039590335,0.825552825552825,0
"<anonymized_userid>",1,73942,7729,"Thierry Baudet (FvD)",0.978405271654273,0.825659651746608,0
"<anonymized_userid>",1,73943,7730,"Thierry Baudet (FvD)",0.97841850371821,0.825766477940391,0
"<anonymized_userid>",1,73944,7731,"Thierry Baudet (FvD)",0.978431735782147,0.825873304134174,0
"<anonymized_userid>",1,73945,7732,"Thierry Baudet (FvD)",0.978444967846085,0.825980130327956,0
"<anonymized_userid>",1,73946,7733,"Thierry Baudet (FvD)",0.978458199910022,0.826086956521739,0
"<anonymized_userid>",1,73947,7734,"Thierry Baudet (FvD)",0.978471431973959,0.826193782715522,0
"<anonymized_userid>",1,73948,7735,"Thierry Baudet (FvD)",0.978484664037897,0.826300608909305,0
"<anonymized_userid>",1,73949,7736,"Thierry Baudet (FvD)",0.978497896101834,0.826407435103087,0
"<anonymized_userid>",1,73950,7737,"Thierry Baudet (FvD)",0.978511128165771,0.82651426129687,0
"<anonymized_userid>",1,73951,7738,"Thierry Baudet (FvD)",0.978524360229709,0.826621087490653,0
"<anonymized_userid>",1,73952,7739,"Thierry Baudet (FvD)",0.978537592293646,0.826727913684435,0
"<anonymized_userid>",1,73953,7740,"Thierry Baudet (FvD)",0.978550824357583,0.826834739878218,0
"<anonymized_userid>",1,73954,7741,"Thierry Baudet (FvD)",0.978564056421521,0.826941566072001,0
"<anonymized_userid>",1,73955,7742,"Thierry Baudet (FvD)",0.978577288485458,0.827048392265784,0
"<anonymized_userid>",1,73956,7743,"Thierry Baudet (FvD)",0.978590520549395,0.827155218459566,0
"<anonymized_userid>",1,73957,7744,"Thierry Baudet (FvD)",0.978603752613333,0.827262044653349,0
"<anonymized_userid>",1,73958,7745,"Thierry Baudet (FvD)",0.97861698467727,0.827368870847132,0
"<anonymized_userid>",1,73959,7746,"Thierry Baudet (FvD)",0.978630216741207,0.827475697040914,0
"<anonymized_userid>",1,73960,7747,"Thierry Baudet (FvD)",0.978643448805145,0.827582523234697,0
"<anonymized_userid>",1,73961,7748,"Thierry Baudet (FvD)",0.978656680869082,0.82768934942848,0
"<anonymized_userid>",1,73962,7749,"Thierry Baudet (FvD)",0.978669912933019,0.827796175622263,0
"<anonymized_userid>",1,73963,7750,"Thierry Baudet (FvD)",0.978683144996957,0.827903001816045,0
"<anonymized_userid>",1,73964,7751,"Thierry Baudet (FvD)",0.978696377060894,0.828009828009828,0
"<anonymized_userid>",1,73965,7752,"Thierry Baudet (FvD)",0.978709609124831,0.828116654203611,0
"<anonymized_userid>",1,73966,7753,"Thierry Baudet (FvD)",0.978722841188769,0.828223480397393,0
"<anonymized_userid>",1,73967,7754,"Thierry Baudet (FvD)",0.978736073252706,0.828330306591176,0
"<anonymized_userid>",1,73968,7755,"Thierry Baudet (FvD)",0.978749305316643,0.828437132784959,0
"<anonymized_userid>",1,73969,7756,"Thierry Baudet (FvD)",0.978762537380581,0.828543958978742,0
"<anonymized_userid>",1,73970,7757,"Thierry Baudet (FvD)",0.978775769444518,0.828650785172524,0
"<anonymized_userid>",1,73971,7758,"Thierry Baudet (FvD)",0.978789001508455,0.828757611366307,0
"<anonymized_userid>",1,73972,7759,"Thierry Baudet (FvD)",0.978802233572393,0.82886443756009,0
"<anonymized_userid>",1,73973,7760,"Thierry Baudet (FvD)",0.97881546563633,0.828971263753872,0
"<anonymized_userid>",1,73974,7761,"Thierry Baudet (FvD)",0.978828697700267,0.829078089947655,0
"<anonymized_userid>",1,73975,7762,"Thierry Baudet (FvD)",0.978841929764205,0.829184916141438,0
"<anonymized_userid>",1,73976,7763,"Thierry Baudet (FvD)",0.978855161828142,0.829291742335221,0
"<anonymized_userid>",1,73977,7764,"Thierry Baudet (FvD)",0.978868393892079,0.829398568529003,0
"<anonymized_userid>",1,73978,7765,"Thierry Baudet (FvD)",0.978881625956017,0.829505394722786,0
"<anonymized_userid>",1,73979,7766,"Thierry Baudet (FvD)",0.978894858019954,0.829612220916569,0
"<anonymized_userid>",1,73980,7767,"Thierry Baudet (FvD)",0.978908090083891,0.829719047110351,0
"<anonymized_userid>",1,73981,7768,"Thierry Baudet (FvD)",0.978921322147829,0.829825873304134,0
"<anonymized_userid>",1,73982,7769,"Thierry Baudet (FvD)",0.978934554211766,0.829932699497917,0
"<anonymized_userid>",1,73983,7770,"Thierry Baudet (FvD)",0.978947786275703,0.8300395256917,0
"<anonymized_userid>",1,73984,7771,"Thierry Baudet (FvD)",0.978961018339641,0.830146351885482,0
"<anonymized_userid>",1,73985,7772,"Thierry Baudet (FvD)",0.978974250403578,0.830253178079265,0
"<anonymized_userid>",1,73986,7773,"Thierry Baudet (FvD)",0.978987482467515,0.830360004273048,0
"<anonymized_userid>",1,73987,7774,"Thierry Baudet (FvD)",0.979000714531453,0.83046683046683,0
"<anonymized_userid>",1,73988,7775,"Thierry Baudet (FvD)",0.97901394659539,0.830573656660613,0
"<anonymized_userid>",1,73989,7776,"Thierry Baudet (FvD)",0.979027178659327,0.830680482854396,0
"<anonymized_userid>",1,73990,7777,"Thierry Baudet (FvD)",0.979040410723265,0.830787309048179,0
"<anonymized_userid>",1,73991,7778,"Thierry Baudet (FvD)",0.979053642787202,0.830894135241961,0
"<anonymized_userid>",1,73992,7779,"Thierry Baudet (FvD)",0.979066874851139,0.831000961435744,0
"<anonymized_userid>",1,73993,7780,"Thierry Baudet (FvD)",0.979080106915077,0.831107787629527,0
"<anonymized_userid>",1,73994,7781,"Thierry Baudet (FvD)",0.979093338979014,0.83121461382331,0
"<anonymized_userid>",1,73995,7782,"Thierry Baudet (FvD)",0.979106571042951,0.831321440017092,0
"<anonymized_userid>",1,73996,7783,"Thierry Baudet (FvD)",0.979119803106889,0.831428266210875,0
"<anonymized_userid>",1,73997,7784,"Thierry Baudet (FvD)",0.979133035170826,0.831535092404658,0
"<anonymized_userid>",1,73998,7785,"Thierry Baudet (FvD)",0.979146267234763,0.83164191859844,0
"<anonymized_userid>",1,73999,7786,"Thierry Baudet (FvD)",0.979159499298701,0.831748744792223,0
"<anonymized_userid>",1,74000,7787,"Thierry Baudet (FvD)",0.979172731362638,0.831855570986006,0
"<anonymized_userid>",1,74001,7788,"Thierry Baudet (FvD)",0.979185963426575,0.831962397179788,0
"<anonymized_userid>",1,74002,7789,"Thierry Baudet (FvD)",0.979199195490513,0.832069223373571,0
"<anonymized_userid>",1,74003,7790,"Thierry Baudet (FvD)",0.97921242755445,0.832176049567354,0
"<anonymized_userid>",1,74004,7791,"Thierry Baudet (FvD)",0.979225659618387,0.832282875761137,0
"<anonymized_userid>",1,74005,7792,"Thierry Baudet (FvD)",0.979238891682325,0.832389701954919,0
"<anonymized_userid>",1,74006,7793,"Thierry Baudet (FvD)",0.979252123746262,0.832496528148702,0
"<anonymized_userid>",1,74007,7794,"Thierry Baudet (FvD)",0.979265355810199,0.832603354342485,0
"<anonymized_userid>",1,74008,7795,"Thierry Baudet (FvD)",0.979278587874137,0.832710180536267,0
"<anonymized_userid>",1,74009,7796,"Thierry Baudet (FvD)",0.979291819938074,0.83281700673005,0
"<anonymized_userid>",1,74010,7797,"Thierry Baudet (FvD)",0.979305052002011,0.832923832923833,0
"<anonymized_userid>",1,74011,7798,"Thierry Baudet (FvD)",0.979318284065949,0.833030659117616,0
"<anonymized_userid>",1,74012,7799,"Thierry Baudet (FvD)",0.979331516129886,0.833137485311398,0
"<anonymized_userid>",1,74013,7800,"Thierry Baudet (FvD)",0.979344748193823,0.833244311505181,0
"<anonymized_userid>",1,74014,7801,"Thierry Baudet (FvD)",0.979357980257761,0.833351137698964,0
"<anonymized_userid>",1,74015,7802,"Thierry Baudet (FvD)",0.979371212321698,0.833457963892747,0
"<anonymized_userid>",1,74016,7803,"Thierry Baudet (FvD)",0.979384444385635,0.833564790086529,0
"<anonymized_userid>",1,74017,7804,"Thierry Baudet (FvD)",0.979397676449573,0.833671616280312,0
"<anonymized_userid>",1,74018,7805,"Thierry Baudet (FvD)",0.97941090851351,0.833778442474095,0
"<anonymized_userid>",1,74019,7806,"Thierry Baudet (FvD)",0.979424140577447,0.833885268667877,0
"<anonymized_userid>",1,74020,7807,"Thierry Baudet (FvD)",0.979437372641385,0.83399209486166,0
"<anonymized_userid>",1,74021,7808,"Thierry Baudet (FvD)",0.979450604705322,0.834098921055443,0
"<anonymized_userid>",1,74022,7809,"Thierry Baudet (FvD)",0.979463836769259,0.834205747249225,0
"<anonymized_userid>",1,74023,7810,"Thierry Baudet (FvD)",0.979477068833197,0.834312573443008,0
"<anonymized_userid>",1,74024,7811,"Thierry Baudet (FvD)",0.979490300897134,0.834419399636791,0
"<anonymized_userid>",1,74025,7812,"Thierry Baudet (FvD)",0.979503532961071,0.834526225830574,0
"<anonymized_userid>",1,74026,7813,"Thierry Baudet (FvD)",0.979516765025009,0.834633052024356,0
"<anonymized_userid>",1,74027,7814,"Thierry Baudet (FvD)",0.979529997088946,0.834739878218139,0
"<anonymized_userid>",1,74028,7815,"Thierry Baudet (FvD)",0.979543229152883,0.834846704411922,0
"<anonymized_userid>",1,74029,7816,"Thierry Baudet (FvD)",0.979556461216821,0.834953530605705,0
"<anonymized_userid>",1,74030,7817,"Thierry Baudet (FvD)",0.979569693280758,0.835060356799487,0
"<anonymized_userid>",1,74031,7818,"Thierry Baudet (FvD)",0.979582925344695,0.83516718299327,0
"<anonymized_userid>",1,74032,7819,"Thierry Baudet (FvD)",0.979596157408633,0.835274009187053,0
"<anonymized_userid>",1,74033,7820,"Thierry Baudet (FvD)",0.97960938947257,0.835380835380835,0
"<anonymized_userid>",1,74034,7821,"Thierry Baudet (FvD)",0.979622621536507,0.835487661574618,0
"<anonymized_userid>",1,74035,7822,"Thierry Baudet (FvD)",0.979635853600445,0.835594487768401,0
"<anonymized_userid>",1,74036,7823,"Thierry Baudet (FvD)",0.979649085664382,0.835701313962184,0
"<anonymized_userid>",1,74037,7824,"Thierry Baudet (FvD)",0.979662317728319,0.835808140155966,0
"<anonymized_userid>",1,74038,7825,"Thierry Baudet (FvD)",0.979675549792257,0.835914966349749,0
"<anonymized_userid>",1,74039,7826,"Thierry Baudet (FvD)",0.979688781856194,0.836021792543532,0
"<anonymized_userid>",1,74040,7827,"Thierry Baudet (FvD)",0.979702013920131,0.836128618737314,0
"<anonymized_userid>",1,74041,7828,"Thierry Baudet (FvD)",0.979715245984069,0.836235444931097,0
"<anonymized_userid>",1,74042,7829,"Thierry Baudet (FvD)",0.979728478048006,0.83634227112488,0
"<anonymized_userid>",1,74043,7830,"Thierry Baudet (FvD)",0.979741710111943,0.836449097318663,0
"<anonymized_userid>",1,74044,7831,"Thierry Baudet (FvD)",0.979754942175881,0.836555923512445,0
"<anonymized_userid>",1,74045,7832,"Thierry Baudet (FvD)",0.979768174239818,0.836662749706228,0
"<anonymized_userid>",1,74046,7833,"Thierry Baudet (FvD)",0.979781406303755,0.836769575900011,0
"<anonymized_userid>",1,74047,7834,"Thierry Baudet (FvD)",0.979794638367693,0.836876402093793,0
"<anonymized_userid>",1,74048,7835,"Thierry Baudet (FvD)",0.97980787043163,0.836983228287576,0
"<anonymized_userid>",1,74049,7836,"Thierry Baudet (FvD)",0.979821102495567,0.837090054481359,0
"<anonymized_userid>",1,74050,7837,"Thierry Baudet (FvD)",0.979834334559505,0.837196880675142,0
"<anonymized_userid>",1,74051,7838,"Thierry Baudet (FvD)",0.979847566623442,0.837303706868924,0
"<anonymized_userid>",1,74052,7839,"Thierry Baudet (FvD)",0.979860798687379,0.837410533062707,0
"<anonymized_userid>",1,74053,7840,"Thierry Baudet (FvD)",0.979874030751317,0.83751735925649,0
"<anonymized_userid>",1,74054,7841,"Thierry Baudet (FvD)",0.979887262815254,0.837624185450272,0
"<anonymized_userid>",1,74055,7842,"Thierry Baudet (FvD)",0.979900494879191,0.837731011644055,0
"<anonymized_userid>",1,74056,7843,"Thierry Baudet (FvD)",0.979913726943129,0.837837837837838,0
"<anonymized_userid>",1,74057,7844,"Thierry Baudet (FvD)",0.979926959007066,0.837944664031621,0
"<anonymized_userid>",1,74058,7845,"Thierry Baudet (FvD)",0.979940191071003,0.838051490225403,0
"<anonymized_userid>",1,74059,7846,"Thierry Baudet (FvD)",0.979953423134941,0.838158316419186,0
"<anonymized_userid>",1,74060,7847,"Thierry Baudet (FvD)",0.979966655198878,0.838265142612969,0
"<anonymized_userid>",1,74061,7848,"Thierry Baudet (FvD)",0.979979887262815,0.838371968806751,0
"<anonymized_userid>",1,74062,7849,"Thierry Baudet (FvD)",0.979993119326753,0.838478795000534,0
"<anonymized_userid>",1,74063,7850,"Thierry Baudet (FvD)",0.98000635139069,0.838585621194317,0
"<anonymized_userid>",1,74064,7851,"Thierry Baudet (FvD)",0.980019583454627,0.8386924473881,0
"<anonymized_userid>",1,74065,7852,"Thierry Baudet (FvD)",0.980032815518565,0.838799273581882,0
"<anonymized_userid>",1,74066,7853,"Thierry Baudet (FvD)",0.980046047582502,0.838906099775665,0
"<anonymized_userid>",1,74067,7854,"Thierry Baudet (FvD)",0.980059279646439,0.839012925969448,0
"<anonymized_userid>",1,74068,7855,"Thierry Baudet (FvD)",0.980072511710377,0.83911975216323,0
"<anonymized_userid>",1,74069,7856,"Thierry Baudet (FvD)",0.980085743774314,0.839226578357013,0
"<anonymized_userid>",1,74070,7857,"Thierry Baudet (FvD)",0.980098975838251,0.839333404550796,0
"<anonymized_userid>",1,74071,7858,"Thierry Baudet (FvD)",0.980112207902189,0.839440230744579,0
"<anonymized_userid>",1,74072,7859,"Thierry Baudet (FvD)",0.980125439966126,0.839547056938361,0
"<anonymized_userid>",1,74073,7860,"Thierry Baudet (FvD)",0.980138672030063,0.839653883132144,0
"<anonymized_userid>",1,74074,7861,"Thierry Baudet (FvD)",0.980151904094001,0.839760709325927,0
"<anonymized_userid>",1,74075,7862,"Thierry Baudet (FvD)",0.980165136157938,0.839867535519709,0
"<anonymized_userid>",1,74076,7863,"Thierry Baudet (FvD)",0.980178368221875,0.839974361713492,0
"<anonymized_userid>",1,74077,7864,"Thierry Baudet (FvD)",0.980191600285813,0.840081187907275,0
"<anonymized_userid>",1,74078,7865,"Thierry Baudet (FvD)",0.98020483234975,0.840188014101058,0
"<anonymized_userid>",1,74079,7866,"Thierry Baudet (FvD)",0.980218064413687,0.84029484029484,0
"<anonymized_userid>",1,74080,7867,"Thierry Baudet (FvD)",0.980231296477625,0.840401666488623,0
"<anonymized_userid>",1,74081,7868,"Thierry Baudet (FvD)",0.980244528541562,0.840508492682406,0
"<anonymized_userid>",1,74082,7869,"Thierry Baudet (FvD)",0.980257760605499,0.840615318876188,0
"<anonymized_userid>",1,74083,7870,"Thierry Baudet (FvD)",0.980270992669437,0.840722145069971,0
"<anonymized_userid>",1,74084,7871,"Thierry Baudet (FvD)",0.980284224733374,0.840828971263754,0
"<anonymized_userid>",1,74085,7872,"Thierry Baudet (FvD)",0.980297456797311,0.840935797457537,0
"<anonymized_userid>",1,74086,7873,"Thierry Baudet (FvD)",0.980310688861249,0.841042623651319,0
"<anonymized_userid>",1,74087,7874,"Thierry Baudet (FvD)",0.980323920925186,0.841149449845102,0
"<anonymized_userid>",1,74088,7875,"Thierry Baudet (FvD)",0.980337152989123,0.841256276038885,0
"<anonymized_userid>",1,74089,7876,"Thierry Baudet (FvD)",0.980350385053061,0.841363102232667,0
"<anonymized_userid>",1,74090,7877,"Thierry Baudet (FvD)",0.980363617116998,0.84146992842645,0
"<anonymized_userid>",1,74091,7878,"Thierry Baudet (FvD)",0.980376849180935,0.841576754620233,0
"<anonymized_userid>",1,74092,7879,"Thierry Baudet (FvD)",0.980390081244873,0.841683580814016,0
"<anonymized_userid>",1,74093,7880,"Thierry Baudet (FvD)",0.98040331330881,0.841790407007798,0
"<anonymized_userid>",1,74094,7881,"Thierry Baudet (FvD)",0.980416545372747,0.841897233201581,0
"<anonymized_userid>",1,74095,7882,"Thierry Baudet (FvD)",0.980429777436685,0.842004059395364,0
"<anonymized_userid>",1,74096,7883,"Thierry Baudet (FvD)",0.980443009500622,0.842110885589146,0
"<anonymized_userid>",1,74097,7884,"Thierry Baudet (FvD)",0.980456241564559,0.842217711782929,0
"<anonymized_userid>",1,74098,7885,"Thierry Baudet (FvD)",0.980469473628497,0.842324537976712,0
"<anonymized_userid>",1,74099,7886,"Thierry Baudet (FvD)",0.980482705692434,0.842431364170495,0
"<anonymized_userid>",1,74100,7887,"Thierry Baudet (FvD)",0.980495937756371,0.842538190364277,0
"<anonymized_userid>",1,74101,7888,"Thierry Baudet (FvD)",0.980509169820309,0.84264501655806,0
"<anonymized_userid>",1,74102,7889,"Thierry Baudet (FvD)",0.980522401884246,0.842751842751843,0
"<anonymized_userid>",1,74103,7890,"Thierry Baudet (FvD)",0.980535633948183,0.842858668945625,0
"<anonymized_userid>",1,74104,7891,"Thierry Baudet (FvD)",0.980548866012121,0.842965495139408,0
"<anonymized_userid>",1,74105,7892,"Thierry Baudet (FvD)",0.980562098076058,0.843072321333191,0
"<anonymized_userid>",1,74106,7893,"Thierry Baudet (FvD)",0.980575330139995,0.843179147526974,0
"<anonymized_userid>",1,74107,7894,"Thierry Baudet (FvD)",0.980588562203933,0.843285973720756,0
"<anonymized_userid>",1,74108,7895,"Thierry Baudet (FvD)",0.98060179426787,0.843392799914539,0
"<anonymized_userid>",1,74109,7896,"Thierry Baudet (FvD)",0.980615026331807,0.843499626108322,0
"<anonymized_userid>",1,74110,7897,"Thierry Baudet (FvD)",0.980628258395745,0.843606452302105,0
"<anonymized_userid>",1,74111,7898,"Thierry Baudet (FvD)",0.980641490459682,0.843713278495887,0
"<anonymized_userid>",1,74112,7899,"Thierry Baudet (FvD)",0.980654722523619,0.84382010468967,0
"<anonymized_userid>",1,74113,7900,"Thierry Baudet (FvD)",0.980667954587557,0.843926930883453,0
"<anonymized_userid>",1,74114,7901,"Thierry Baudet (FvD)",0.980681186651494,0.844033757077235,0
"<anonymized_userid>",1,74115,7902,"Thierry Baudet (FvD)",0.980694418715431,0.844140583271018,0
"<anonymized_userid>",1,74116,7903,"Thierry Baudet (FvD)",0.980707650779369,0.844247409464801,0
"<anonymized_userid>",1,74117,7904,"Thierry Baudet (FvD)",0.980720882843306,0.844354235658583,0
"<anonymized_userid>",1,74118,7905,"Thierry Baudet (FvD)",0.980734114907243,0.844461061852366,0
"<anonymized_userid>",1,74119,7906,"Thierry Baudet (FvD)",0.980747346971181,0.844567888046149,0
"<anonymized_userid>",1,74120,7907,"Thierry Baudet (FvD)",0.980760579035118,0.844674714239932,0
"<anonymized_userid>",1,74121,7908,"Thierry Baudet (FvD)",0.980773811099055,0.844781540433714,0
"<anonymized_userid>",1,74122,7909,"Thierry Baudet (FvD)",0.980787043162993,0.844888366627497,0
"<anonymized_userid>",1,74123,7910,"Thierry Baudet (FvD)",0.98080027522693,0.84499519282128,0
"<anonymized_userid>",1,74124,7911,"Thierry Baudet (FvD)",0.980813507290867,0.845102019015063,0
"<anonymized_userid>",1,74125,7912,"Thierry Baudet (FvD)",0.980826739354805,0.845208845208845,0
"<anonymized_userid>",1,74126,7913,"Thierry Baudet (FvD)",0.980839971418742,0.845315671402628,0
"<anonymized_userid>",1,74127,7914,"Thierry Baudet (FvD)",0.980853203482679,0.845422497596411,0
"<anonymized_userid>",1,74128,7915,"Thierry Baudet (FvD)",0.980866435546617,0.845529323790193,0
"<anonymized_userid>",1,74129,7916,"Thierry Baudet (FvD)",0.980879667610554,0.845636149983976,0
"<anonymized_userid>",1,74130,7917,"Thierry Baudet (FvD)",0.980892899674491,0.845742976177759,0
"<anonymized_userid>",1,74131,7918,"Thierry Baudet (FvD)",0.980906131738429,0.845849802371542,0
"<anonymized_userid>",1,74132,7919,"Thierry Baudet (FvD)",0.980919363802366,0.845956628565324,0
"<anonymized_userid>",1,74133,7920,"Thierry Baudet (FvD)",0.980932595866303,0.846063454759107,0
"<anonymized_userid>",1,74134,7921,"Thierry Baudet (FvD)",0.980945827930241,0.84617028095289,0
"<anonymized_userid>",1,74135,7922,"Thierry Baudet (FvD)",0.980959059994178,0.846277107146672,0
"<anonymized_userid>",1,74136,7923,"Thierry Baudet (FvD)",0.980972292058115,0.846383933340455,0
"<anonymized_userid>",1,74137,7924,"Thierry Baudet (FvD)",0.980985524122053,0.846490759534238,0
"<anonymized_userid>",1,74138,7925,"Thierry Baudet (FvD)",0.98099875618599,0.84659758572802,0
"<anonymized_userid>",1,74139,7926,"Thierry Baudet (FvD)",0.981011988249927,0.846704411921803,0
"<anonymized_userid>",1,74140,7927,"Thierry Baudet (FvD)",0.981025220313865,0.846811238115586,0
"<anonymized_userid>",1,74141,7928,"Thierry Baudet (FvD)",0.981038452377802,0.846918064309369,0
"<anonymized_userid>",1,74142,7929,"Thierry Baudet (FvD)",0.981051684441739,0.847024890503151,0
"<anonymized_userid>",1,74143,7930,"Thierry Baudet (FvD)",0.981064916505677,0.847131716696934,0
"<anonymized_userid>",1,74144,7931,"Thierry Baudet (FvD)",0.981078148569614,0.847238542890717,0
"<anonymized_userid>",1,74145,7932,"Thierry Baudet (FvD)",0.981091380633551,0.8473453690845,0
"<anonymized_userid>",1,74146,7933,"Thierry Baudet (FvD)",0.981104612697489,0.847452195278282,0
"<anonymized_userid>",1,74147,7934,"Thierry Baudet (FvD)",0.981117844761426,0.847559021472065,0
"<anonymized_userid>",1,74148,7935,"Thierry Baudet (FvD)",0.981131076825363,0.847665847665848,0
"<anonymized_userid>",1,74149,7936,"Thierry Baudet (FvD)",0.981144308889301,0.84777267385963,0
"<anonymized_userid>",1,74150,7937,"Thierry Baudet (FvD)",0.981157540953238,0.847879500053413,0
"<anonymized_userid>",1,74151,7938,"Thierry Baudet (FvD)",0.981170773017175,0.847986326247196,0
"<anonymized_userid>",1,74152,7939,"Thierry Baudet (FvD)",0.981184005081113,0.848093152440978,0
"<anonymized_userid>",1,74153,7940,"Thierry Baudet (FvD)",0.98119723714505,0.848199978634761,0
"<anonymized_userid>",1,74154,7941,"Thierry Baudet (FvD)",0.981210469208987,0.848306804828544,0
"<anonymized_userid>",1,74155,7942,"Thierry Baudet (FvD)",0.981223701272925,0.848413631022327,0
"<anonymized_userid>",1,74156,7943,"Thierry Baudet (FvD)",0.981236933336862,0.848520457216109,0
"<anonymized_userid>",1,74157,7944,"Thierry Baudet (FvD)",0.981250165400799,0.848627283409892,0
"<anonymized_userid>",1,74158,7945,"Thierry Baudet (FvD)",0.981263397464737,0.848734109603675,0
"<anonymized_userid>",1,74159,7946,"Thierry Baudet (FvD)",0.981276629528674,0.848840935797458,0
"<anonymized_userid>",1,74160,7947,"Thierry Baudet (FvD)",0.981289861592611,0.84894776199124,0
"<anonymized_userid>",1,74161,7948,"Thierry Baudet (FvD)",0.981303093656549,0.849054588185023,0
"<anonymized_userid>",1,74162,7949,"Thierry Baudet (FvD)",0.981316325720486,0.849161414378806,0
"<anonymized_userid>",1,74163,7950,"Thierry Baudet (FvD)",0.981329557784423,0.849268240572588,0
"<anonymized_userid>",1,74164,7951,"Thierry Baudet (FvD)",0.981342789848361,0.849375066766371,0
"<anonymized_userid>",1,74165,7952,"Thierry Baudet (FvD)",0.981356021912298,0.849481892960154,0
"<anonymized_userid>",1,74166,7953,"Thierry Baudet (FvD)",0.981369253976235,0.849588719153937,0
"<anonymized_userid>",1,74167,7954,"Thierry Baudet (FvD)",0.981382486040173,0.849695545347719,0
"<anonymized_userid>",1,74168,7955,"Thierry Baudet (FvD)",0.98139571810411,0.849802371541502,0
"<anonymized_userid>",1,74169,7956,"Thierry Baudet (FvD)",0.981408950168047,0.849909197735285,0
"<anonymized_userid>",1,74170,7957,"Thierry Baudet (FvD)",0.981422182231985,0.850016023929067,0
"<anonymized_userid>",1,74171,7958,"Thierry Baudet (FvD)",0.981435414295922,0.85012285012285,0
"<anonymized_userid>",1,74172,7959,"Thierry Baudet (FvD)",0.981448646359859,0.850229676316633,0
"<anonymized_userid>",1,74173,7960,"Thierry Baudet (FvD)",0.981461878423797,0.850336502510416,0
"<anonymized_userid>",1,74174,7961,"Thierry Baudet (FvD)",0.981475110487734,0.850443328704198,0
"<anonymized_userid>",1,74175,7962,"Thierry Baudet (FvD)",0.981488342551671,0.850550154897981,0
"<anonymized_userid>",1,74176,7963,"Thierry Baudet (FvD)",0.981501574615608,0.850656981091764,0
"<anonymized_userid>",1,74177,7964,"Thierry Baudet (FvD)",0.981514806679546,0.850763807285546,0
"<anonymized_userid>",1,74178,7965,"Thierry Baudet (FvD)",0.981528038743483,0.850870633479329,0
"<anonymized_userid>",1,74179,7966,"Thierry Baudet (FvD)",0.981541270807421,0.850977459673112,0
"<anonymized_userid>",1,74180,7967,"Thierry Baudet (FvD)",0.981554502871358,0.851084285866895,0
"<anonymized_userid>",1,74181,7968,"Thierry Baudet (FvD)",0.981567734935295,0.851191112060677,0
"<anonymized_userid>",1,74182,7969,"Thierry Baudet (FvD)",0.981580966999233,0.85129793825446,0
"<anonymized_userid>",1,74183,7970,"Thierry Baudet (FvD)",0.98159419906317,0.851404764448243,0
"<anonymized_userid>",1,74184,7971,"Thierry Baudet (FvD)",0.981607431127107,0.851511590642025,0
"<anonymized_userid>",1,74185,7972,"Thierry Baudet (FvD)",0.981620663191045,0.851618416835808,0
"<anonymized_userid>",1,74186,7973,"Thierry Baudet (FvD)",0.981633895254982,0.851725243029591,0
"<anonymized_userid>",1,74187,7974,"Thierry Baudet (FvD)",0.981647127318919,0.851832069223374,0
"<anonymized_userid>",1,74188,7975,"Thierry Baudet (FvD)",0.981660359382857,0.851938895417156,0
"<anonymized_userid>",1,74189,7976,"Thierry Baudet (FvD)",0.981673591446794,0.852045721610939,0
"<anonymized_userid>",1,74190,7977,"Thierry Baudet (FvD)",0.981686823510731,0.852152547804722,0
"<anonymized_userid>",1,74191,7978,"Thierry Baudet (FvD)",0.981700055574669,0.852259373998504,0
"<anonymized_userid>",1,74192,7979,"Thierry Baudet (FvD)",0.981713287638606,0.852366200192287,0
"<anonymized_userid>",1,74193,7980,"Thierry Baudet (FvD)",0.981726519702543,0.85247302638607,0
"<anonymized_userid>",1,74194,7981,"Thierry Baudet (FvD)",0.981739751766481,0.852579852579853,0
"<anonymized_userid>",1,74195,7982,"Thierry Baudet (FvD)",0.981752983830418,0.852686678773635,0
"<anonymized_userid>",1,74196,7983,"Thierry Baudet (FvD)",0.981766215894355,0.852793504967418,0
"<anonymized_userid>",1,74197,7984,"Thierry Baudet (FvD)",0.981779447958293,0.852900331161201,0
"<anonymized_userid>",1,74198,7985,"Thierry Baudet (FvD)",0.98179268002223,0.853007157354983,0
"<anonymized_userid>",1,74199,7986,"Thierry Baudet (FvD)",0.981805912086167,0.853113983548766,0
"<anonymized_userid>",1,74200,7987,"Thierry Baudet (FvD)",0.981819144150105,0.853220809742549,0
"<anonymized_userid>",1,74201,7988,"Thierry Baudet (FvD)",0.981832376214042,0.853327635936332,0
"<anonymized_userid>",1,74202,7989,"Thierry Baudet (FvD)",0.981845608277979,0.853434462130114,0
"<anonymized_userid>",1,74203,7990,"Thierry Baudet (FvD)",0.981858840341917,0.853541288323897,0
"<anonymized_userid>",1,74204,7991,"Thierry Baudet (FvD)",0.981872072405854,0.85364811451768,0
"<anonymized_userid>",1,74205,7992,"Thierry Baudet (FvD)",0.981885304469791,0.853754940711462,0
"<anonymized_userid>",1,74206,7993,"Thierry Baudet (FvD)",0.981898536533728,0.853861766905245,0
"<anonymized_userid>",1,74207,7994,"Thierry Baudet (FvD)",0.981911768597666,0.853968593099028,0
"<anonymized_userid>",1,74208,7995,"Thierry Baudet (FvD)",0.981925000661603,0.854075419292811,0
"<anonymized_userid>",1,74209,7996,"Thierry Baudet (FvD)",0.98193823272554,0.854182245486593,0
"<anonymized_userid>",1,74210,7997,"Thierry Baudet (FvD)",0.981951464789478,0.854289071680376,0
"<anonymized_userid>",1,74211,7998,"Thierry Baudet (FvD)",0.981964696853415,0.854395897874159,0
"<anonymized_userid>",1,74212,7999,"Thierry Baudet (FvD)",0.981977928917353,0.854502724067941,0
"<anonymized_userid>",1,74213,8000,"Thierry Baudet (FvD)",0.98199116098129,0.854609550261724,0
"<anonymized_userid>",1,74214,8001,"Thierry Baudet (FvD)",0.982004393045227,0.854716376455507,0
"<anonymized_userid>",1,74215,8002,"Thierry Baudet (FvD)",0.982017625109165,0.85482320264929,0
"<anonymized_userid>",1,74216,8003,"Thierry Baudet (FvD)",0.982030857173102,0.854930028843072,0
"<anonymized_userid>",1,74217,8004,"Thierry Baudet (FvD)",0.982044089237039,0.855036855036855,0
"<anonymized_userid>",1,74218,8005,"Thierry Baudet (FvD)",0.982057321300977,0.855143681230638,0
"<anonymized_userid>",1,74219,8006,"Thierry Baudet (FvD)",0.982070553364914,0.85525050742442,0
"<anonymized_userid>",1,74220,8007,"Thierry Baudet (FvD)",0.982083785428851,0.855357333618203,0
"<anonymized_userid>",1,74221,8008,"Thierry Baudet (FvD)",0.982097017492789,0.855464159811986,0
"<anonymized_userid>",1,74222,8009,"Thierry Baudet (FvD)",0.982110249556726,0.855570986005769,0
"<anonymized_userid>",1,74223,8010,"Thierry Baudet (FvD)",0.982123481620663,0.855677812199551,0
"<anonymized_userid>",1,74224,8011,"Thierry Baudet (FvD)",0.982136713684601,0.855784638393334,0
"<anonymized_userid>",1,74225,8012,"Thierry Baudet (FvD)",0.982149945748538,0.855891464587117,0
"<anonymized_userid>",1,74226,8013,"Thierry Baudet (FvD)",0.982163177812475,0.8559982907809,0
"<anonymized_userid>",1,74227,8014,"Thierry Baudet (FvD)",0.982176409876413,0.856105116974682,0
"<anonymized_userid>",1,74228,8015,"Thierry Baudet (FvD)",0.98218964194035,0.856211943168465,0
"<anonymized_userid>",1,74229,8016,"Thierry Baudet (FvD)",0.982202874004287,0.856318769362248,0
"<anonymized_userid>",1,74230,8017,"Thierry Baudet (FvD)",0.982216106068225,0.85642559555603,0
"<anonymized_userid>",1,74231,8018,"Thierry Baudet (FvD)",0.982229338132162,0.856532421749813,0
"<anonymized_userid>",1,74232,8019,"Thierry Baudet (FvD)",0.982242570196099,0.856639247943596,0
"<anonymized_userid>",1,74233,8020,"Thierry Baudet (FvD)",0.982255802260037,0.856746074137378,0
"<anonymized_userid>",1,74234,8021,"Thierry Baudet (FvD)",0.982269034323974,0.856852900331161,0
"<anonymized_userid>",1,74235,8022,"Thierry Baudet (FvD)",0.982282266387911,0.856959726524944,0
"<anonymized_userid>",1,74236,8023,"Thierry Baudet (FvD)",0.982295498451848,0.857066552718727,0
"<anonymized_userid>",1,74237,8024,"Thierry Baudet (FvD)",0.982308730515786,0.857173378912509,0
"<anonymized_userid>",1,74238,8025,"Thierry Baudet (FvD)",0.982321962579723,0.857280205106292,0
"<anonymized_userid>",1,74239,8026,"Thierry Baudet (FvD)",0.98233519464366,0.857387031300075,0
"<anonymized_userid>",1,74240,8027,"Thierry Baudet (FvD)",0.982348426707598,0.857493857493858,0
"<anonymized_userid>",1,74241,8028,"Thierry Baudet (FvD)",0.982361658771535,0.85760068368764,0
"<anonymized_userid>",1,74242,8029,"Thierry Baudet (FvD)",0.982374890835472,0.857707509881423,0
"<anonymized_userid>",1,74243,8030,"Thierry Baudet (FvD)",0.98238812289941,0.857814336075206,0
"<anonymized_userid>",1,74244,8031,"Thierry Baudet (FvD)",0.982401354963347,0.857921162268988,0
"<anonymized_userid>",1,74245,8032,"Thierry Baudet (FvD)",0.982414587027285,0.858027988462771,0
"<anonymized_userid>",1,74246,8033,"Thierry Baudet (FvD)",0.982427819091222,0.858134814656554,0
"<anonymized_userid>",1,74247,8034,"Thierry Baudet (FvD)",0.982441051155159,0.858241640850336,0
"<anonymized_userid>",1,74248,8035,"Thierry Baudet (FvD)",0.982454283219097,0.858348467044119,0
"<anonymized_userid>",1,74249,8036,"Thierry Baudet (FvD)",0.982467515283034,0.858455293237902,0
"<anonymized_userid>",1,74250,8037,"Thierry Baudet (FvD)",0.982480747346971,0.858562119431685,0
"<anonymized_userid>",1,74251,8038,"Thierry Baudet (FvD)",0.982493979410909,0.858668945625467,0
"<anonymized_userid>",1,74252,8039,"Thierry Baudet (FvD)",0.982507211474846,0.85877577181925,0
"<anonymized_userid>",1,74253,8040,"Thierry Baudet (FvD)",0.982520443538783,0.858882598013033,0
"<anonymized_userid>",1,74254,8041,"Thierry Baudet (FvD)",0.982533675602721,0.858989424206816,0
"<anonymized_userid>",1,74255,8042,"Thierry Baudet (FvD)",0.982546907666658,0.859096250400598,0
"<anonymized_userid>",1,74256,8043,"Thierry Baudet (FvD)",0.982560139730595,0.859203076594381,0
"<anonymized_userid>",1,74257,8044,"Thierry Baudet (FvD)",0.982573371794533,0.859309902788164,0
"<anonymized_userid>",1,74258,8045,"Thierry Baudet (FvD)",0.98258660385847,0.859416728981946,0
"<anonymized_userid>",1,74259,8046,"Thierry Baudet (FvD)",0.982599835922407,0.859523555175729,0
"<anonymized_userid>",1,74260,8047,"Thierry Baudet (FvD)",0.982613067986345,0.859630381369512,0
"<anonymized_userid>",1,74261,8048,"Thierry Baudet (FvD)",0.982626300050282,0.859737207563295,0
"<anonymized_userid>",1,74262,8049,"Thierry Baudet (FvD)",0.982639532114219,0.859844033757077,0
"<anonymized_userid>",1,74263,8050,"Thierry Baudet (FvD)",0.982652764178157,0.85995085995086,0
"<anonymized_userid>",1,74264,8051,"Thierry Baudet (FvD)",0.982665996242094,0.860057686144643,0
"<anonymized_userid>",1,74265,8052,"Thierry Baudet (FvD)",0.982679228306031,0.860164512338425,0
"<anonymized_userid>",1,74266,8053,"Thierry Baudet (FvD)",0.982692460369968,0.860271338532208,0
"<anonymized_userid>",1,74267,8054,"Thierry Baudet (FvD)",0.982705692433906,0.860378164725991,0
"<anonymized_userid>",1,74268,8055,"Thierry Baudet (FvD)",0.982718924497843,0.860484990919773,0
"<anonymized_userid>",1,74269,8056,"Thierry Baudet (FvD)",0.98273215656178,0.860591817113556,0
"<anonymized_userid>",1,74270,8057,"Thierry Baudet (FvD)",0.982745388625718,0.860698643307339,0
"<anonymized_userid>",1,74271,8058,"Thierry Baudet (FvD)",0.982758620689655,0.860805469501122,0
"<anonymized_userid>",1,74272,8059,"Thierry Baudet (FvD)",0.982771852753592,0.860912295694904,0
"<anonymized_userid>",1,74273,8060,"Thierry Baudet (FvD)",0.98278508481753,0.861019121888687,0
"<anonymized_userid>",1,74274,8061,"Thierry Baudet (FvD)",0.982798316881467,0.86112594808247,0
"<anonymized_userid>",1,74275,8062,"Thierry Baudet (FvD)",0.982811548945404,0.861232774276253,0
"<anonymized_userid>",1,74276,8063,"Thierry Baudet (FvD)",0.982824781009342,0.861339600470035,0
"<anonymized_userid>",1,74277,8064,"Thierry Baudet (FvD)",0.982838013073279,0.861446426663818,0
"<anonymized_userid>",1,74278,8065,"Thierry Baudet (FvD)",0.982851245137217,0.861553252857601,0
"<anonymized_userid>",1,74279,8066,"Thierry Baudet (FvD)",0.982864477201154,0.861660079051383,0
"<anonymized_userid>",1,74280,8067,"Thierry Baudet (FvD)",0.982877709265091,0.861766905245166,0
"<anonymized_userid>",1,74281,8068,"Thierry Baudet (FvD)",0.982890941329029,0.861873731438949,0
"<anonymized_userid>",1,74282,8069,"Thierry Baudet (FvD)",0.982904173392966,0.861980557632732,0
"<anonymized_userid>",1,74283,8070,"Thierry Baudet (FvD)",0.982917405456903,0.862087383826514,0
"<anonymized_userid>",1,74284,8071,"Thierry Baudet (FvD)",0.982930637520841,0.862194210020297,0
"<anonymized_userid>",1,74285,8072,"Thierry Baudet (FvD)",0.982943869584778,0.86230103621408,0
"<anonymized_userid>",1,74286,8073,"Thierry Baudet (FvD)",0.982957101648715,0.862407862407862,0
"<anonymized_userid>",1,74287,8074,"Thierry Baudet (FvD)",0.982970333712653,0.862514688601645,0
"<anonymized_userid>",1,74288,8075,"Thierry Baudet (FvD)",0.98298356577659,0.862621514795428,0
"<anonymized_userid>",1,74289,8076,"Thierry Baudet (FvD)",0.982996797840527,0.862728340989211,0
"<anonymized_userid>",1,74290,8077,"Thierry Baudet (FvD)",0.983010029904465,0.862835167182993,0
"<anonymized_userid>",1,74291,8078,"Thierry Baudet (FvD)",0.983023261968402,0.862941993376776,0
"<anonymized_userid>",1,74292,8079,"Thierry Baudet (FvD)",0.983036494032339,0.863048819570559,0
"<anonymized_userid>",1,74293,8080,"Thierry Baudet (FvD)",0.983049726096276,0.863155645764341,0
"<anonymized_userid>",1,74294,8081,"Thierry Baudet (FvD)",0.983062958160214,0.863262471958124,0
"<anonymized_userid>",1,74295,8082,"Thierry Baudet (FvD)",0.983076190224151,0.863369298151907,0
"<anonymized_userid>",1,74296,8083,"Thierry Baudet (FvD)",0.983089422288088,0.86347612434569,0
"<anonymized_userid>",1,74297,8084,"Thierry Baudet (FvD)",0.983102654352026,0.863582950539472,0
"<anonymized_userid>",1,74298,8085,"Thierry Baudet (FvD)",0.983115886415963,0.863689776733255,0
"<anonymized_userid>",1,74299,8086,"Thierry Baudet (FvD)",0.9831291184799,0.863796602927038,0
"<anonymized_userid>",1,74300,8087,"Thierry Baudet (FvD)",0.983142350543838,0.86390342912082,0
"<anonymized_userid>",1,74301,8088,"Thierry Baudet (FvD)",0.983155582607775,0.864010255314603,0
"<anonymized_userid>",1,74302,8089,"Thierry Baudet (FvD)",0.983168814671712,0.864117081508386,0
"<anonymized_userid>",1,74303,8090,"Thierry Baudet (FvD)",0.98318204673565,0.864223907702169,0
"<anonymized_userid>",1,74304,8091,"Thierry Baudet (FvD)",0.983195278799587,0.864330733895951,0
"<anonymized_userid>",1,74305,8092,"Thierry Baudet (FvD)",0.983208510863524,0.864437560089734,0
"<anonymized_userid>",1,74306,8093,"Thierry Baudet (FvD)",0.983221742927462,0.864544386283517,0
"<anonymized_userid>",1,74307,8094,"Thierry Baudet (FvD)",0.983234974991399,0.864651212477299,0
"<anonymized_userid>",1,74308,8095,"Thierry Baudet (FvD)",0.983248207055336,0.864758038671082,0
"<anonymized_userid>",1,74309,8096,"Thierry Baudet (FvD)",0.983261439119274,0.864864864864865,0
"<anonymized_userid>",1,74310,8097,"Thierry Baudet (FvD)",0.983274671183211,0.864971691058648,0
"<anonymized_userid>",1,74311,8098,"Thierry Baudet (FvD)",0.983287903247149,0.86507851725243,0
"<anonymized_userid>",1,74312,8099,"Thierry Baudet (FvD)",0.983301135311086,0.865185343446213,0
"<anonymized_userid>",1,74313,8100,"Thierry Baudet (FvD)",0.983314367375023,0.865292169639996,0
"<anonymized_userid>",1,74314,8101,"Thierry Baudet (FvD)",0.983327599438961,0.865398995833778,0
"<anonymized_userid>",1,74315,8102,"Thierry Baudet (FvD)",0.983340831502898,0.865505822027561,0
"<anonymized_userid>",1,74316,8103,"Thierry Baudet (FvD)",0.983354063566835,0.865612648221344,0
"<anonymized_userid>",1,74317,8104,"Thierry Baudet (FvD)",0.983367295630773,0.865719474415127,0
"<anonymized_userid>",1,74318,8105,"Thierry Baudet (FvD)",0.98338052769471,0.865826300608909,0
"<anonymized_userid>",1,74319,8106,"Thierry Baudet (FvD)",0.983393759758647,0.865933126802692,0
"<anonymized_userid>",1,74320,8107,"Thierry Baudet (FvD)",0.983406991822585,0.866039952996475,0
"<anonymized_userid>",1,74321,8108,"Thierry Baudet (FvD)",0.983420223886522,0.866146779190257,0
"<anonymized_userid>",1,74322,8109,"Thierry Baudet (FvD)",0.983433455950459,0.86625360538404,0
"<anonymized_userid>",1,74323,8110,"Thierry Baudet (FvD)",0.983446688014396,0.866360431577823,0
"<anonymized_userid>",1,74324,8111,"Thierry Baudet (FvD)",0.983459920078334,0.866467257771606,0
"<anonymized_userid>",1,74325,8112,"Thierry Baudet (FvD)",0.983473152142271,0.866574083965388,0
"<anonymized_userid>",1,74326,8113,"Thierry Baudet (FvD)",0.983486384206208,0.866680910159171,0
"<anonymized_userid>",1,74327,8114,"Thierry Baudet (FvD)",0.983499616270146,0.866787736352954,0
"<anonymized_userid>",1,74328,8115,"Thierry Baudet (FvD)",0.983512848334083,0.866894562546736,0
"<anonymized_userid>",1,74329,8116,"Thierry Baudet (FvD)",0.98352608039802,0.867001388740519,0
"<anonymized_userid>",1,74330,8117,"Thierry Baudet (FvD)",0.983539312461958,0.867108214934302,0
"<anonymized_userid>",1,74331,8118,"Thierry Baudet (FvD)",0.983552544525895,0.867215041128085,0
"<anonymized_userid>",1,74332,8119,"Thierry Baudet (FvD)",0.983565776589832,0.867321867321867,0
"<anonymized_userid>",1,74333,8120,"Thierry Baudet (FvD)",0.98357900865377,0.86742869351565,0
"<anonymized_userid>",1,74334,8121,"Thierry Baudet (FvD)",0.983592240717707,0.867535519709433,0
"<anonymized_userid>",1,74335,8122,"Thierry Baudet (FvD)",0.983605472781644,0.867642345903215,0
"<anonymized_userid>",1,74336,8123,"Thierry Baudet (FvD)",0.983618704845582,0.867749172096998,0
"<anonymized_userid>",1,74337,8124,"Thierry Baudet (FvD)",0.983631936909519,0.867855998290781,0
"<anonymized_userid>",1,74338,8125,"Thierry Baudet (FvD)",0.983645168973456,0.867962824484564,0
"<anonymized_userid>",1,74339,8126,"Thierry Baudet (FvD)",0.983658401037394,0.868069650678346,0
"<anonymized_userid>",1,74340,8127,"Thierry Baudet (FvD)",0.983671633101331,0.868176476872129,0
"<anonymized_userid>",1,74341,8128,"Thierry Baudet (FvD)",0.983684865165268,0.868283303065912,0
"<anonymized_userid>",1,74342,8129,"Thierry Baudet (FvD)",0.983698097229206,0.868390129259694,0
"<anonymized_userid>",1,74343,8130,"Thierry Baudet (FvD)",0.983711329293143,0.868496955453477,0
"<anonymized_userid>",1,74344,8131,"Thierry Baudet (FvD)",0.983724561357081,0.86860378164726,0
"<anonymized_userid>",1,74345,8132,"Thierry Baudet (FvD)",0.983737793421018,0.868710607841043,0
"<anonymized_userid>",1,74346,8133,"Thierry Baudet (FvD)",0.983751025484955,0.868817434034825,0
"<anonymized_userid>",1,74347,8134,"Thierry Baudet (FvD)",0.983764257548893,0.868924260228608,0
"<anonymized_userid>",1,74348,8135,"Thierry Baudet (FvD)",0.98377748961283,0.869031086422391,0
"<anonymized_userid>",1,74349,8136,"Thierry Baudet (FvD)",0.983790721676767,0.869137912616173,0
"<anonymized_userid>",1,74350,8137,"Thierry Baudet (FvD)",0.983803953740705,0.869244738809956,0
"<anonymized_userid>",1,74351,8138,"Thierry Baudet (FvD)",0.983817185804642,0.869351565003739,0
"<anonymized_userid>",1,74352,8139,"Thierry Baudet (FvD)",0.983830417868579,0.869458391197522,0
"<anonymized_userid>",1,74353,8140,"Thierry Baudet (FvD)",0.983843649932516,0.869565217391304,0
"<anonymized_userid>",1,74354,8141,"Thierry Baudet (FvD)",0.983856881996454,0.869672043585087,0
"<anonymized_userid>",1,74355,8142,"Thierry Baudet (FvD)",0.983870114060391,0.86977886977887,0
"<anonymized_userid>",1,74356,8143,"Thierry Baudet (FvD)",0.983883346124328,0.869885695972653,0
"<anonymized_userid>",1,74357,8144,"Thierry Baudet (FvD)",0.983896578188266,0.869992522166435,0
"<anonymized_userid>",1,74358,8145,"Thierry Baudet (FvD)",0.983909810252203,0.870099348360218,0
"<anonymized_userid>",1,74359,8146,"Thierry Baudet (FvD)",0.98392304231614,0.870206174554001,0
"<anonymized_userid>",1,74360,8147,"Thierry Baudet (FvD)",0.983936274380078,0.870313000747783,0
"<anonymized_userid>",1,74361,8148,"Thierry Baudet (FvD)",0.983949506444015,0.870419826941566,0
"<anonymized_userid>",1,74362,8149,"Thierry Baudet (FvD)",0.983962738507952,0.870526653135349,0
"<anonymized_userid>",1,74363,8150,"Thierry Baudet (FvD)",0.98397597057189,0.870633479329131,0
"<anonymized_userid>",1,74364,8151,"Thierry Baudet (FvD)",0.983989202635827,0.870740305522914,0
"<anonymized_userid>",1,74365,8152,"Thierry Baudet (FvD)",0.984002434699764,0.870847131716697,0
"<anonymized_userid>",1,74366,8153,"Thierry Baudet (FvD)",0.984015666763702,0.87095395791048,0
"<anonymized_userid>",1,74367,8154,"Thierry Baudet (FvD)",0.984028898827639,0.871060784104262,0
"<anonymized_userid>",1,74368,8155,"Thierry Baudet (FvD)",0.984042130891576,0.871167610298045,0
"<anonymized_userid>",1,74369,8156,"Thierry Baudet (FvD)",0.984055362955514,0.871274436491828,0
"<anonymized_userid>",1,74370,8157,"Thierry Baudet (FvD)",0.984068595019451,0.871381262685611,0
"<anonymized_userid>",1,74371,8158,"Thierry Baudet (FvD)",0.984081827083388,0.871488088879393,0
"<anonymized_userid>",1,74372,8159,"Thierry Baudet (FvD)",0.984095059147326,0.871594915073176,0
"<anonymized_userid>",1,74373,8160,"Thierry Baudet (FvD)",0.984108291211263,0.871701741266959,0
"<anonymized_userid>",1,74374,8161,"Thierry Baudet (FvD)",0.9841215232752,0.871808567460741,0
"<anonymized_userid>",1,74375,8162,"Thierry Baudet (FvD)",0.984134755339138,0.871915393654524,0
"<anonymized_userid>",1,74376,8163,"Thierry Baudet (FvD)",0.984147987403075,0.872022219848307,0
"<anonymized_userid>",1,74377,8164,"Thierry Baudet (FvD)",0.984161219467013,0.87212904604209,0
"<anonymized_userid>",1,74378,8165,"Thierry Baudet (FvD)",0.98417445153095,0.872235872235872,0
"<anonymized_userid>",1,74379,8166,"Thierry Baudet (FvD)",0.984187683594887,0.872342698429655,0
"<anonymized_userid>",1,74380,8167,"Thierry Baudet (FvD)",0.984200915658825,0.872449524623438,0
"<anonymized_userid>",1,74381,8168,"Thierry Baudet (FvD)",0.984214147722762,0.87255635081722,0
"<anonymized_userid>",1,74382,8169,"Thierry Baudet (FvD)",0.984227379786699,0.872663177011003,0
"<anonymized_userid>",1,74383,8170,"Thierry Baudet (FvD)",0.984240611850636,0.872770003204786,0
"<anonymized_userid>",1,74384,8171,"Thierry Baudet (FvD)",0.984253843914574,0.872876829398568,0
"<anonymized_userid>",1,74385,8172,"Thierry Baudet (FvD)",0.984267075978511,0.872983655592351,0
"<anonymized_userid>",1,74386,8173,"Thierry Baudet (FvD)",0.984280308042448,0.873090481786134,0
"<anonymized_userid>",1,74387,8174,"Thierry Baudet (FvD)",0.984293540106386,0.873197307979917,0
"<anonymized_userid>",1,74388,8175,"Thierry Baudet (FvD)",0.984306772170323,0.873304134173699,0
"<anonymized_userid>",1,74389,8176,"Thierry Baudet (FvD)",0.98432000423426,0.873410960367482,0
"<anonymized_userid>",1,74390,8177,"Thierry Baudet (FvD)",0.984333236298198,0.873517786561265,0
"<anonymized_userid>",1,74391,8178,"Thierry Baudet (FvD)",0.984346468362135,0.873624612755048,0
"<anonymized_userid>",1,74392,8179,"Thierry Baudet (FvD)",0.984359700426072,0.87373143894883,0
"<anonymized_userid>",1,74393,8180,"Thierry Baudet (FvD)",0.98437293249001,0.873838265142613,0
"<anonymized_userid>",1,74394,8181,"Thierry Baudet (FvD)",0.984386164553947,0.873945091336396,0
"<anonymized_userid>",1,74395,8182,"Thierry Baudet (FvD)",0.984399396617884,0.874051917530178,0
"<anonymized_userid>",1,74396,8183,"Thierry Baudet (FvD)",0.984412628681822,0.874158743723961,0
"<anonymized_userid>",1,74397,8184,"Thierry Baudet (FvD)",0.984425860745759,0.874265569917744,0
"<anonymized_userid>",1,74398,8185,"Thierry Baudet (FvD)",0.984439092809696,0.874372396111527,0
"<anonymized_userid>",1,74399,8186,"Thierry Baudet (FvD)",0.984452324873634,0.874479222305309,0
"<anonymized_userid>",1,74400,8187,"Thierry Baudet (FvD)",0.984465556937571,0.874586048499092,0
"<anonymized_userid>",1,74401,8188,"Thierry Baudet (FvD)",0.984478789001508,0.874692874692875,0
"<anonymized_userid>",1,74402,8189,"Thierry Baudet (FvD)",0.984492021065446,0.874799700886657,0
"<anonymized_userid>",1,74403,8190,"Thierry Baudet (FvD)",0.984505253129383,0.87490652708044,0
"<anonymized_userid>",1,74404,8191,"Thierry Baudet (FvD)",0.98451848519332,0.875013353274223,0
"<anonymized_userid>",1,74405,8192,"Thierry Baudet (FvD)",0.984531717257258,0.875120179468006,0
"<anonymized_userid>",1,74406,8193,"Thierry Baudet (FvD)",0.984544949321195,0.875227005661788,0
"<anonymized_userid>",1,74407,8194,"Thierry Baudet (FvD)",0.984558181385132,0.875333831855571,0
"<anonymized_userid>",1,74408,8195,"Thierry Baudet (FvD)",0.98457141344907,0.875440658049354,0
"<anonymized_userid>",1,74409,8196,"Thierry Baudet (FvD)",0.984584645513007,0.875547484243136,0
"<anonymized_userid>",1,74410,8197,"Thierry Baudet (FvD)",0.984597877576945,0.875654310436919,0
"<anonymized_userid>",1,74411,8198,"Thierry Baudet (FvD)",0.984611109640882,0.875761136630702,0
"<anonymized_userid>",1,74412,8199,"Thierry Baudet (FvD)",0.984624341704819,0.875867962824485,0
"<anonymized_userid>",1,74413,8200,"Thierry Baudet (FvD)",0.984637573768756,0.875974789018267,0
"<anonymized_userid>",1,74414,8201,"Thierry Baudet (FvD)",0.984650805832694,0.87608161521205,0
"<anonymized_userid>",1,74415,8202,"Thierry Baudet (FvD)",0.984664037896631,0.876188441405833,0
"<anonymized_userid>",1,74416,8203,"Thierry Baudet (FvD)",0.984677269960568,0.876295267599615,0
"<anonymized_userid>",1,74417,8204,"Thierry Baudet (FvD)",0.984690502024506,0.876402093793398,0
"<anonymized_userid>",1,74418,8205,"Thierry Baudet (FvD)",0.984703734088443,0.876508919987181,0
"<anonymized_userid>",1,74419,8206,"Thierry Baudet (FvD)",0.98471696615238,0.876615746180964,0
"<anonymized_userid>",1,74420,8207,"Thierry Baudet (FvD)",0.984730198216318,0.876722572374746,0
"<anonymized_userid>",1,74421,8208,"Thierry Baudet (FvD)",0.984743430280255,0.876829398568529,0
"<anonymized_userid>",1,74422,8209,"Thierry Baudet (FvD)",0.984756662344192,0.876936224762312,0
"<anonymized_userid>",1,74423,8210,"Thierry Baudet (FvD)",0.98476989440813,0.877043050956094,0
"<anonymized_userid>",1,74424,8211,"Thierry Baudet (FvD)",0.984783126472067,0.877149877149877,0
"<anonymized_userid>",1,74425,8212,"Thierry Baudet (FvD)",0.984796358536004,0.87725670334366,0
"<anonymized_userid>",1,74426,8213,"Thierry Baudet (FvD)",0.984809590599942,0.877363529537443,0
"<anonymized_userid>",1,74427,8214,"Thierry Baudet (FvD)",0.984822822663879,0.877470355731225,0
"<anonymized_userid>",1,74428,8215,"Thierry Baudet (FvD)",0.984836054727816,0.877577181925008,0
"<anonymized_userid>",1,74429,8216,"Thierry Baudet (FvD)",0.984849286791754,0.877684008118791,0
"<anonymized_userid>",1,74430,8217,"Thierry Baudet (FvD)",0.984862518855691,0.877790834312573,0
"<anonymized_userid>",1,74431,8218,"Thierry Baudet (FvD)",0.984875750919628,0.877897660506356,0
"<anonymized_userid>",1,74432,8219,"Thierry Baudet (FvD)",0.984888982983566,0.878004486700139,0
"<anonymized_userid>",1,74433,8220,"Thierry Baudet (FvD)",0.984902215047503,0.878111312893922,0
"<anonymized_userid>",1,74434,8221,"Thierry Baudet (FvD)",0.98491544711144,0.878218139087704,0
"<anonymized_userid>",1,74435,8222,"Thierry Baudet (FvD)",0.984928679175378,0.878324965281487,0
"<anonymized_userid>",1,74436,8223,"Thierry Baudet (FvD)",0.984941911239315,0.87843179147527,0
"<anonymized_userid>",1,74437,8224,"Thierry Baudet (FvD)",0.984955143303252,0.878538617669053,0
"<anonymized_userid>",1,74438,8225,"Thierry Baudet (FvD)",0.98496837536719,0.878645443862835,0
"<anonymized_userid>",1,74439,8226,"Thierry Baudet (FvD)",0.984981607431127,0.878752270056618,0
"<anonymized_userid>",1,74440,8227,"Thierry Baudet (FvD)",0.984994839495064,0.878859096250401,0
"<anonymized_userid>",1,74441,8228,"Thierry Baudet (FvD)",0.985008071559002,0.878965922444183,0
"<anonymized_userid>",1,74442,8229,"Thierry Baudet (FvD)",0.985021303622939,0.879072748637966,0
"<anonymized_userid>",1,74443,8230,"Thierry Baudet (FvD)",0.985034535686876,0.879179574831749,0
"<anonymized_userid>",1,74444,8231,"Thierry Baudet (FvD)",0.985047767750814,0.879286401025531,0
"<anonymized_userid>",1,74445,8232,"Thierry Baudet (FvD)",0.985060999814751,0.879393227219314,0
"<anonymized_userid>",1,74446,8233,"Thierry Baudet (FvD)",0.985074231878688,0.879500053413097,0
"<anonymized_userid>",1,74447,8234,"Thierry Baudet (FvD)",0.985087463942626,0.87960687960688,0
"<anonymized_userid>",1,74448,8235,"Thierry Baudet (FvD)",0.985100696006563,0.879713705800662,0
"<anonymized_userid>",1,74449,8236,"Thierry Baudet (FvD)",0.9851139280705,0.879820531994445,0
"<anonymized_userid>",1,74450,8237,"Thierry Baudet (FvD)",0.985127160134438,0.879927358188228,0
"<anonymized_userid>",1,74451,8238,"Thierry Baudet (FvD)",0.985140392198375,0.88003418438201,0
"<anonymized_userid>",1,74452,8239,"Thierry Baudet (FvD)",0.985153624262312,0.880141010575793,0
"<anonymized_userid>",1,74453,8240,"Thierry Baudet (FvD)",0.98516685632625,0.880247836769576,0
"<anonymized_userid>",1,74454,8241,"Thierry Baudet (FvD)",0.985180088390187,0.880354662963359,0
"<anonymized_userid>",1,74455,8242,"Thierry Baudet (FvD)",0.985193320454124,0.880461489157141,0
"<anonymized_userid>",1,74456,8243,"Thierry Baudet (FvD)",0.985206552518062,0.880568315350924,0
"<anonymized_userid>",1,74457,8244,"Thierry Baudet (FvD)",0.985219784581999,0.880675141544707,0
"<anonymized_userid>",1,74458,8245,"Thierry Baudet (FvD)",0.985233016645936,0.880781967738489,0
"<anonymized_userid>",1,74459,8246,"Thierry Baudet (FvD)",0.985246248709874,0.880888793932272,0
"<anonymized_userid>",1,74460,8247,"Thierry Baudet (FvD)",0.985259480773811,0.880995620126055,0
"<anonymized_userid>",1,74461,8248,"Thierry Baudet (FvD)",0.985272712837748,0.881102446319838,0
"<anonymized_userid>",1,74462,8249,"Thierry Baudet (FvD)",0.985285944901686,0.88120927251362,0
"<anonymized_userid>",1,74463,8250,"Thierry Baudet (FvD)",0.985299176965623,0.881316098707403,0
"<anonymized_userid>",1,74464,8251,"Thierry Baudet (FvD)",0.98531240902956,0.881422924901186,0
"<anonymized_userid>",1,74465,8252,"Thierry Baudet (FvD)",0.985325641093498,0.881529751094968,0
"<anonymized_userid>",1,74466,8253,"Thierry Baudet (FvD)",0.985338873157435,0.881636577288751,0
"<anonymized_userid>",1,74467,8254,"Thierry Baudet (FvD)",0.985352105221372,0.881743403482534,0
"<anonymized_userid>",1,74468,8255,"Thierry Baudet (FvD)",0.98536533728531,0.881850229676317,0
"<anonymized_userid>",1,74469,8256,"Thierry Baudet (FvD)",0.985378569349247,0.881957055870099,0
"<anonymized_userid>",1,74470,8257,"Thierry Baudet (FvD)",0.985391801413184,0.882063882063882,0
"<anonymized_userid>",1,74471,8258,"Thierry Baudet (FvD)",0.985405033477122,0.882170708257665,0
"<anonymized_userid>",1,74472,8259,"Thierry Baudet (FvD)",0.985418265541059,0.882277534451448,0
"<anonymized_userid>",1,74473,8260,"Thierry Baudet (FvD)",0.985431497604996,0.88238436064523,0
"<anonymized_userid>",1,74474,8261,"Thierry Baudet (FvD)",0.985444729668934,0.882491186839013,0
"<anonymized_userid>",1,74475,8262,"Thierry Baudet (FvD)",0.985457961732871,0.882598013032796,0
"<anonymized_userid>",1,74476,8263,"Thierry Baudet (FvD)",0.985471193796808,0.882704839226578,0
"<anonymized_userid>",1,74477,8264,"Thierry Baudet (FvD)",0.985484425860746,0.882811665420361,0
"<anonymized_userid>",1,74478,8265,"Thierry Baudet (FvD)",0.985497657924683,0.882918491614144,0
"<anonymized_userid>",1,74479,8266,"Thierry Baudet (FvD)",0.98551088998862,0.883025317807926,0
"<anonymized_userid>",1,74480,8267,"Thierry Baudet (FvD)",0.985524122052558,0.883132144001709,0
"<anonymized_userid>",1,74481,8268,"Thierry Baudet (FvD)",0.985537354116495,0.883238970195492,0
"<anonymized_userid>",1,74482,8269,"Thierry Baudet (FvD)",0.985550586180432,0.883345796389275,0
"<anonymized_userid>",1,74483,8270,"Thierry Baudet (FvD)",0.98556381824437,0.883452622583057,0
"<anonymized_userid>",1,74484,8271,"Thierry Baudet (FvD)",0.985577050308307,0.88355944877684,0
"<anonymized_userid>",1,74485,8272,"Thierry Baudet (FvD)",0.985590282372244,0.883666274970623,0
"<anonymized_userid>",1,74486,8273,"Thierry Baudet (FvD)",0.985603514436182,0.883773101164406,0
"<anonymized_userid>",1,74487,8274,"Thierry Baudet (FvD)",0.985616746500119,0.883879927358188,0
"<anonymized_userid>",1,74488,8275,"Thierry Baudet (FvD)",0.985629978564056,0.883986753551971,0
"<anonymized_userid>",1,74489,8276,"Thierry Baudet (FvD)",0.985643210627994,0.884093579745754,0
"<anonymized_userid>",1,74490,8277,"Thierry Baudet (FvD)",0.985656442691931,0.884200405939536,0
"<anonymized_userid>",1,74491,8278,"Thierry Baudet (FvD)",0.985669674755868,0.884307232133319,0
"<anonymized_userid>",1,74492,8279,"Thierry Baudet (FvD)",0.985682906819806,0.884414058327102,0
"<anonymized_userid>",1,74493,8280,"Thierry Baudet (FvD)",0.985696138883743,0.884520884520885,0
"<anonymized_userid>",1,74494,8281,"Thierry Baudet (FvD)",0.98570937094768,0.884627710714667,0
"<anonymized_userid>",1,74495,8282,"Thierry Baudet (FvD)",0.985722603011618,0.88473453690845,0
"<anonymized_userid>",1,74496,8283,"Thierry Baudet (FvD)",0.985735835075555,0.884841363102233,0
"<anonymized_userid>",1,74497,8284,"Thierry Baudet (FvD)",0.985749067139492,0.884948189296015,0
"<anonymized_userid>",1,74498,8285,"Thierry Baudet (FvD)",0.98576229920343,0.885055015489798,0
"<anonymized_userid>",1,74499,8286,"Thierry Baudet (FvD)",0.985775531267367,0.885161841683581,0
"<anonymized_userid>",1,74500,8287,"Thierry Baudet (FvD)",0.985788763331304,0.885268667877364,0
"<anonymized_userid>",1,74501,8288,"Thierry Baudet (FvD)",0.985801995395242,0.885375494071146,0
"<anonymized_userid>",1,74502,8289,"Thierry Baudet (FvD)",0.985815227459179,0.885482320264929,0
"<anonymized_userid>",1,74503,8290,"Thierry Baudet (FvD)",0.985828459523116,0.885589146458712,0
"<anonymized_userid>",1,74504,8291,"Thierry Baudet (FvD)",0.985841691587054,0.885695972652494,0
"<anonymized_userid>",1,74505,8292,"Thierry Baudet (FvD)",0.985854923650991,0.885802798846277,0
"<anonymized_userid>",1,74506,8293,"Thierry Baudet (FvD)",0.985868155714928,0.88590962504006,0
"<anonymized_userid>",1,74507,8294,"Thierry Baudet (FvD)",0.985881387778866,0.886016451233843,0
"<anonymized_userid>",1,74508,8295,"Thierry Baudet (FvD)",0.985894619842803,0.886123277427625,0
"<anonymized_userid>",1,74509,8296,"Thierry Baudet (FvD)",0.98590785190674,0.886230103621408,0
"<anonymized_userid>",1,74510,8297,"Thierry Baudet (FvD)",0.985921083970678,0.886336929815191,0
"<anonymized_userid>",1,74511,8298,"Thierry Baudet (FvD)",0.985934316034615,0.886443756008973,0
"<anonymized_userid>",1,74512,8299,"Thierry Baudet (FvD)",0.985947548098552,0.886550582202756,0
"<anonymized_userid>",1,74513,8300,"Thierry Baudet (FvD)",0.98596078016249,0.886657408396539,0
"<anonymized_userid>",1,74514,8301,"Thierry Baudet (FvD)",0.985974012226427,0.886764234590321,0
"<anonymized_userid>",1,74515,8302,"Thierry Baudet (FvD)",0.985987244290364,0.886871060784104,0
"<anonymized_userid>",1,74516,8303,"Thierry Baudet (FvD)",0.986000476354302,0.886977886977887,0
"<anonymized_userid>",1,74517,8304,"Thierry Baudet (FvD)",0.986013708418239,0.88708471317167,0
"<anonymized_userid>",1,74518,8305,"Thierry Baudet (FvD)",0.986026940482176,0.887191539365452,0
"<anonymized_userid>",1,74519,8306,"Thierry Baudet (FvD)",0.986040172546114,0.887298365559235,0
"<anonymized_userid>",1,74520,8307,"Thierry Baudet (FvD)",0.986053404610051,0.887405191753018,0
"<anonymized_userid>",1,74521,8308,"Thierry Baudet (FvD)",0.986066636673988,0.887512017946801,0
"<anonymized_userid>",1,74522,8309,"Thierry Baudet (FvD)",0.986079868737926,0.887618844140583,0
"<anonymized_userid>",1,74523,8310,"Thierry Baudet (FvD)",0.986093100801863,0.887725670334366,0
"<anonymized_userid>",1,74524,8311,"Thierry Baudet (FvD)",0.9861063328658,0.887832496528149,0
"<anonymized_userid>",1,74525,8312,"Thierry Baudet (FvD)",0.986119564929738,0.887939322721931,0
"<anonymized_userid>",1,74526,8313,"Thierry Baudet (FvD)",0.986132796993675,0.888046148915714,0
"<anonymized_userid>",1,74527,8314,"Thierry Baudet (FvD)",0.986146029057612,0.888152975109497,0
"<anonymized_userid>",1,74528,8315,"Thierry Baudet (FvD)",0.98615926112155,0.88825980130328,0
"<anonymized_userid>",1,74529,8316,"Thierry Baudet (FvD)",0.986172493185487,0.888366627497062,0
"<anonymized_userid>",1,74530,8317,"Thierry Baudet (FvD)",0.986185725249424,0.888473453690845,0
"<anonymized_userid>",1,74531,8318,"Thierry Baudet (FvD)",0.986198957313362,0.888580279884628,0
"<anonymized_userid>",1,74532,8319,"Thierry Baudet (FvD)",0.986212189377299,0.88868710607841,0
"<anonymized_userid>",1,74533,8320,"Thierry Baudet (FvD)",0.986225421441236,0.888793932272193,0
"<anonymized_userid>",1,74534,8321,"Thierry Baudet (FvD)",0.986238653505174,0.888900758465976,0
"<anonymized_userid>",1,74535,8322,"Thierry Baudet (FvD)",0.986251885569111,0.889007584659759,0
"<anonymized_userid>",1,74536,8323,"Thierry Baudet (FvD)",0.986265117633048,0.889114410853541,0
"<anonymized_userid>",1,74537,8324,"Thierry Baudet (FvD)",0.986278349696986,0.889221237047324,0
"<anonymized_userid>",1,74538,8325,"Thierry Baudet (FvD)",0.986291581760923,0.889328063241107,0
"<anonymized_userid>",1,74539,8326,"Thierry Baudet (FvD)",0.98630481382486,0.889434889434889,0
"<anonymized_userid>",1,74540,8327,"Thierry Baudet (FvD)",0.986318045888798,0.889541715628672,0
"<anonymized_userid>",1,74541,8328,"Thierry Baudet (FvD)",0.986331277952735,0.889648541822455,0
"<anonymized_userid>",1,74542,8329,"Thierry Baudet (FvD)",0.986344510016672,0.889755368016238,0
"<anonymized_userid>",1,74543,8330,"Thierry Baudet (FvD)",0.98635774208061,0.88986219421002,0
"<anonymized_userid>",1,74544,8331,"Thierry Baudet (FvD)",0.986370974144547,0.889969020403803,0
"<anonymized_userid>",1,74545,8332,"Thierry Baudet (FvD)",0.986384206208484,0.890075846597586,0
"<anonymized_userid>",1,74546,8333,"Thierry Baudet (FvD)",0.986397438272422,0.890182672791368,0
"<anonymized_userid>",1,74547,8334,"Thierry Baudet (FvD)",0.986410670336359,0.890289498985151,0
"<anonymized_userid>",1,74548,8335,"Thierry Baudet (FvD)",0.986423902400296,0.890396325178934,0
"<anonymized_userid>",1,74549,8336,"Thierry Baudet (FvD)",0.986437134464234,0.890503151372717,0
"<anonymized_userid>",1,74550,8337,"Thierry Baudet (FvD)",0.986450366528171,0.890609977566499,0
"<anonymized_userid>",1,74551,8338,"Thierry Baudet (FvD)",0.986463598592108,0.890716803760282,0
"<anonymized_userid>",1,74552,8339,"Thierry Baudet (FvD)",0.986476830656046,0.890823629954065,0
"<anonymized_userid>",1,74553,8340,"Thierry Baudet (FvD)",0.986490062719983,0.890930456147847,0
"<anonymized_userid>",1,74554,8341,"Thierry Baudet (FvD)",0.98650329478392,0.89103728234163,0
"<anonymized_userid>",1,74555,8342,"Thierry Baudet (FvD)",0.986516526847858,0.891144108535413,0
"<anonymized_userid>",1,74556,8343,"Thierry Baudet (FvD)",0.986529758911795,0.891250934729196,0
"<anonymized_userid>",1,74557,8344,"Thierry Baudet (FvD)",0.986542990975732,0.891357760922978,0
"<anonymized_userid>",1,74558,8345,"Thierry Baudet (FvD)",0.98655622303967,0.891464587116761,0
"<anonymized_userid>",1,74559,8346,"Thierry Baudet (FvD)",0.986569455103607,0.891571413310544,0
"<anonymized_userid>",1,74560,8347,"Thierry Baudet (FvD)",0.986582687167544,0.891678239504326,0
"<anonymized_userid>",1,74561,8348,"Thierry Baudet (FvD)",0.986595919231482,0.891785065698109,0
"<anonymized_userid>",1,74562,8349,"Thierry Baudet (FvD)",0.986609151295419,0.891891891891892,0
"<anonymized_userid>",1,74563,8350,"Thierry Baudet (FvD)",0.986622383359356,0.891998718085675,0
"<anonymized_userid>",1,74564,8351,"Thierry Baudet (FvD)",0.986635615423294,0.892105544279457,0
"<anonymized_userid>",1,74565,8352,"Thierry Baudet (FvD)",0.986648847487231,0.89221237047324,0
"<anonymized_userid>",1,74566,8353,"Thierry Baudet (FvD)",0.986662079551168,0.892319196667023,0
"<anonymized_userid>",1,74567,8354,"Thierry Baudet (FvD)",0.986675311615106,0.892426022860806,0
"<anonymized_userid>",1,74568,8355,"Thierry Baudet (FvD)",0.986688543679043,0.892532849054588,0
"<anonymized_userid>",1,74569,8356,"Thierry Baudet (FvD)",0.98670177574298,0.892639675248371,0
"<anonymized_userid>",1,74570,8357,"Thierry Baudet (FvD)",0.986715007806918,0.892746501442154,0
"<anonymized_userid>",1,74571,8358,"Thierry Baudet (FvD)",0.986728239870855,0.892853327635936,0
"<anonymized_userid>",1,74572,8359,"Thierry Baudet (FvD)",0.986741471934792,0.892960153829719,0
"<anonymized_userid>",1,74573,8360,"Thierry Baudet (FvD)",0.98675470399873,0.893066980023502,0
"<anonymized_userid>",1,74574,8361,"Thierry Baudet (FvD)",0.986767936062667,0.893173806217284,0
"<anonymized_userid>",1,74575,8362,"Thierry Baudet (FvD)",0.986781168126604,0.893280632411067,0
"<anonymized_userid>",1,74576,8363,"Thierry Baudet (FvD)",0.986794400190542,0.89338745860485,0
"<anonymized_userid>",1,74577,8364,"Thierry Baudet (FvD)",0.986807632254479,0.893494284798633,0
"<anonymized_userid>",1,74578,8365,"Thierry Baudet (FvD)",0.986820864318416,0.893601110992415,0
"<anonymized_userid>",1,74579,8366,"Thierry Baudet (FvD)",0.986834096382354,0.893707937186198,0
"<anonymized_userid>",1,74580,8367,"Thierry Baudet (FvD)",0.986847328446291,0.893814763379981,0
"<anonymized_userid>",1,74581,8368,"Thierry Baudet (FvD)",0.986860560510228,0.893921589573763,0
"<anonymized_userid>",1,74582,8369,"Thierry Baudet (FvD)",0.986873792574166,0.894028415767546,0
"<anonymized_userid>",1,74583,8370,"Thierry Baudet (FvD)",0.986887024638103,0.894135241961329,0
"<anonymized_userid>",1,74584,8371,"Thierry Baudet (FvD)",0.98690025670204,0.894242068155112,0
"<anonymized_userid>",1,74585,8372,"Thierry Baudet (FvD)",0.986913488765978,0.894348894348894,0
"<anonymized_userid>",1,74586,8373,"Thierry Baudet (FvD)",0.986926720829915,0.894455720542677,0
"<anonymized_userid>",1,74587,8374,"Thierry Baudet (FvD)",0.986939952893852,0.89456254673646,0
"<anonymized_userid>",1,74588,8375,"Thierry Baudet (FvD)",0.98695318495779,0.894669372930243,0
"<anonymized_userid>",1,74589,8376,"Thierry Baudet (FvD)",0.986966417021727,0.894776199124025,0
"<anonymized_userid>",1,74590,8377,"Thierry Baudet (FvD)",0.986979649085664,0.894883025317808,0
"<anonymized_userid>",1,74591,8378,"Thierry Baudet (FvD)",0.986992881149602,0.894989851511591,0
"<anonymized_userid>",1,74592,8379,"Thierry Baudet (FvD)",0.987006113213539,0.895096677705373,0
"<anonymized_userid>",1,74593,8380,"Thierry Baudet (FvD)",0.987019345277476,0.895203503899156,0
"<anonymized_userid>",1,74594,8381,"Thierry Baudet (FvD)",0.987032577341414,0.895310330092939,0
"<anonymized_userid>",1,74595,8382,"Thierry Baudet (FvD)",0.987045809405351,0.895417156286721,0
"<anonymized_userid>",1,74596,8383,"Thierry Baudet (FvD)",0.987059041469288,0.895523982480504,0
"<anonymized_userid>",1,74597,8384,"Thierry Baudet (FvD)",0.987072273533226,0.895630808674287,0
"<anonymized_userid>",1,74598,8385,"Thierry Baudet (FvD)",0.987085505597163,0.89573763486807,0
"<anonymized_userid>",1,74599,8386,"Thierry Baudet (FvD)",0.9870987376611,0.895844461061852,0
"<anonymized_userid>",1,74600,8387,"Thierry Baudet (FvD)",0.987111969725038,0.895951287255635,0
"<anonymized_userid>",1,74601,8388,"Thierry Baudet (FvD)",0.987125201788975,0.896058113449418,0
"<anonymized_userid>",1,74602,8389,"Thierry Baudet (FvD)",0.987138433852912,0.896164939643201,0
"<anonymized_userid>",1,74603,8390,"Thierry Baudet (FvD)",0.98715166591685,0.896271765836983,0
"<anonymized_userid>",1,74604,8391,"Thierry Baudet (FvD)",0.987164897980787,0.896378592030766,0
"<anonymized_userid>",1,74605,8392,"Thierry Baudet (FvD)",0.987178130044724,0.896485418224549,0
"<anonymized_userid>",1,74606,8393,"Thierry Baudet (FvD)",0.987191362108662,0.896592244418331,0
"<anonymized_userid>",1,74607,8394,"Thierry Baudet (FvD)",0.987204594172599,0.896699070612114,0
"<anonymized_userid>",1,74608,8395,"Thierry Baudet (FvD)",0.987217826236536,0.896805896805897,0
"<anonymized_userid>",1,74609,8396,"Thierry Baudet (FvD)",0.987231058300474,0.89691272299968,0
"<anonymized_userid>",1,74610,8397,"Thierry Baudet (FvD)",0.987244290364411,0.897019549193462,0
"<anonymized_userid>",1,74611,8398,"Thierry Baudet (FvD)",0.987257522428348,0.897126375387245,0
"<anonymized_userid>",1,74612,8399,"Thierry Baudet (FvD)",0.987270754492286,0.897233201581028,0
"<anonymized_userid>",1,74613,8400,"Thierry Baudet (FvD)",0.987283986556223,0.89734002777481,0
"<anonymized_userid>",1,74614,8401,"Thierry Baudet (FvD)",0.98729721862016,0.897446853968593,0
"<anonymized_userid>",1,74615,8402,"Thierry Baudet (FvD)",0.987310450684098,0.897553680162376,0
"<anonymized_userid>",1,74616,8403,"Thierry Baudet (FvD)",0.987323682748035,0.897660506356159,0
"<anonymized_userid>",1,74617,8404,"Thierry Baudet (FvD)",0.987336914811972,0.897767332549941,0
"<anonymized_userid>",1,74618,8405,"Thierry Baudet (FvD)",0.98735014687591,0.897874158743724,0
"<anonymized_userid>",1,74619,8406,"Thierry Baudet (FvD)",0.987363378939847,0.897980984937507,0
"<anonymized_userid>",1,74620,8407,"Thierry Baudet (FvD)",0.987376611003784,0.898087811131289,0
"<anonymized_userid>",1,74621,8408,"Thierry Baudet (FvD)",0.987389843067722,0.898194637325072,0
"<anonymized_userid>",1,74622,8409,"Thierry Baudet (FvD)",0.987403075131659,0.898301463518855,0
"<anonymized_userid>",1,74623,8410,"Thierry Baudet (FvD)",0.987416307195596,0.898408289712638,0
"<anonymized_userid>",1,74624,8411,"Thierry Baudet (FvD)",0.987429539259534,0.89851511590642,0
"<anonymized_userid>",1,74625,8412,"Thierry Baudet (FvD)",0.987442771323471,0.898621942100203,0
"<anonymized_userid>",1,74626,8413,"Thierry Baudet (FvD)",0.987456003387408,0.898728768293986,0
"<anonymized_userid>",1,74627,8414,"Thierry Baudet (FvD)",0.987469235451346,0.898835594487768,0
"<anonymized_userid>",1,74628,8415,"Thierry Baudet (FvD)",0.987482467515283,0.898942420681551,0
"<anonymized_userid>",1,74629,8416,"Thierry Baudet (FvD)",0.98749569957922,0.899049246875334,0
"<anonymized_userid>",1,74630,8417,"Thierry Baudet (FvD)",0.987508931643158,0.899156073069117,0
"<anonymized_userid>",1,74631,8418,"Thierry Baudet (FvD)",0.987522163707095,0.899262899262899,0
"<anonymized_userid>",1,74632,8419,"Thierry Baudet (FvD)",0.987535395771032,0.899369725456682,0
"<anonymized_userid>",1,74633,8420,"Thierry Baudet (FvD)",0.98754862783497,0.899476551650465,0
"<anonymized_userid>",1,74634,8421,"Thierry Baudet (FvD)",0.987561859898907,0.899583377844247,0
"<anonymized_userid>",1,74635,8422,"Thierry Baudet (FvD)",0.987575091962844,0.89969020403803,0
"<anonymized_userid>",1,74636,8423,"Thierry Baudet (FvD)",0.987588324026782,0.899797030231813,0
"<anonymized_userid>",1,74637,8424,"Thierry Baudet (FvD)",0.987601556090719,0.899903856425596,0
"<anonymized_userid>",1,74638,8425,"Thierry Baudet (FvD)",0.987614788154656,0.900010682619378,0
"<anonymized_userid>",1,74639,8426,"Thierry Baudet (FvD)",0.987628020218594,0.900117508813161,0
"<anonymized_userid>",1,74640,8427,"Thierry Baudet (FvD)",0.987641252282531,0.900224335006944,0
"<anonymized_userid>",1,74641,8428,"Thierry Baudet (FvD)",0.987654484346468,0.900331161200726,0
"<anonymized_userid>",1,74642,8429,"Thierry Baudet (FvD)",0.987667716410406,0.900437987394509,0
"<anonymized_userid>",1,74643,8430,"Thierry Baudet (FvD)",0.987680948474343,0.900544813588292,0
"<anonymized_userid>",1,74644,8431,"Thierry Baudet (FvD)",0.98769418053828,0.900651639782075,0
"<anonymized_userid>",1,74645,8432,"Thierry Baudet (FvD)",0.987707412602218,0.900758465975857,0
"<anonymized_userid>",1,74646,8433,"Thierry Baudet (FvD)",0.987720644666155,0.90086529216964,0
"<anonymized_userid>",1,74647,8434,"Thierry Baudet (FvD)",0.987733876730092,0.900972118363423,0
"<anonymized_userid>",1,74648,8435,"Thierry Baudet (FvD)",0.98774710879403,0.901078944557205,0
"<anonymized_userid>",1,74649,8436,"Thierry Baudet (FvD)",0.987760340857967,0.901185770750988,0
"<anonymized_userid>",1,74650,8437,"Thierry Baudet (FvD)",0.987773572921904,0.901292596944771,0
"<anonymized_userid>",1,74651,8438,"Thierry Baudet (FvD)",0.987786804985842,0.901399423138554,0
"<anonymized_userid>",1,74652,8439,"Thierry Baudet (FvD)",0.987800037049779,0.901506249332336,0
"<anonymized_userid>",1,74653,8440,"Thierry Baudet (FvD)",0.987813269113716,0.901613075526119,0
"<anonymized_userid>",1,74654,8441,"Thierry Baudet (FvD)",0.987826501177654,0.901719901719902,0
"<anonymized_userid>",1,74655,8442,"Thierry Baudet (FvD)",0.987839733241591,0.901826727913684,0
"<anonymized_userid>",1,74656,8443,"Thierry Baudet (FvD)",0.987852965305528,0.901933554107467,0
"<anonymized_userid>",1,74657,8444,"Thierry Baudet (FvD)",0.987866197369466,0.90204038030125,0
"<anonymized_userid>",1,74658,8445,"Thierry Baudet (FvD)",0.987879429433403,0.902147206495033,0
"<anonymized_userid>",1,74659,8446,"Thierry Baudet (FvD)",0.98789266149734,0.902254032688815,0
"<anonymized_userid>",1,74660,8447,"Thierry Baudet (FvD)",0.987905893561278,0.902360858882598,0
"<anonymized_userid>",1,74661,8448,"Thierry Baudet (FvD)",0.987919125625215,0.902467685076381,0
"<anonymized_userid>",1,74662,8449,"Thierry Baudet (FvD)",0.987932357689152,0.902574511270163,0
"<anonymized_userid>",1,74663,8450,"Thierry Baudet (FvD)",0.98794558975309,0.902681337463946,0
"<anonymized_userid>",1,74664,8451,"Thierry Baudet (FvD)",0.987958821817027,0.902788163657729,0
"<anonymized_userid>",1,74665,8452,"Thierry Baudet (FvD)",0.987972053880964,0.902894989851512,0
"<anonymized_userid>",1,74666,8453,"Thierry Baudet (FvD)",0.987985285944902,0.903001816045294,0
"<anonymized_userid>",1,74667,8454,"Thierry Baudet (FvD)",0.987998518008839,0.903108642239077,0
"<anonymized_userid>",1,74668,8455,"Thierry Baudet (FvD)",0.988011750072776,0.90321546843286,0
"<anonymized_userid>",1,74669,8456,"Thierry Baudet (FvD)",0.988024982136714,0.903322294626642,0
"<anonymized_userid>",1,74670,8457,"Thierry Baudet (FvD)",0.988038214200651,0.903429120820425,0
"<anonymized_userid>",1,74671,8458,"Thierry Baudet (FvD)",0.988051446264588,0.903535947014208,0
"<anonymized_userid>",1,74672,8459,"Thierry Baudet (FvD)",0.988064678328526,0.903642773207991,0
"<anonymized_userid>",1,74673,8460,"Thierry Baudet (FvD)",0.988077910392463,0.903749599401773,0
"<anonymized_userid>",1,74674,8461,"Thierry Baudet (FvD)",0.9880911424564,0.903856425595556,0
"<anonymized_userid>",1,74675,8462,"Thierry Baudet (FvD)",0.988104374520338,0.903963251789339,0
"<anonymized_userid>",1,74676,8463,"Thierry Baudet (FvD)",0.988117606584275,0.904070077983121,0
"<anonymized_userid>",1,74677,8464,"Thierry Baudet (FvD)",0.988130838648212,0.904176904176904,0
"<anonymized_userid>",1,74678,8465,"Thierry Baudet (FvD)",0.98814407071215,0.904283730370687,0
"<anonymized_userid>",1,74679,8466,"Thierry Baudet (FvD)",0.988157302776087,0.90439055656447,0
"<anonymized_userid>",1,74680,8467,"Thierry Baudet (FvD)",0.988170534840024,0.904497382758252,0
"<anonymized_userid>",1,74681,8468,"Thierry Baudet (FvD)",0.988183766903962,0.904604208952035,0
"<anonymized_userid>",1,74682,8469,"Thierry Baudet (FvD)",0.988196998967899,0.904711035145818,0
"<anonymized_userid>",1,74683,8470,"Thierry Baudet (FvD)",0.988210231031836,0.904817861339601,0
"<anonymized_userid>",1,74684,8471,"Thierry Baudet (FvD)",0.988223463095774,0.904924687533383,0
"<anonymized_userid>",1,74685,8472,"Thierry Baudet (FvD)",0.988236695159711,0.905031513727166,0
"<anonymized_userid>",1,74686,8473,"Thierry Baudet (FvD)",0.988249927223648,0.905138339920949,0
"<anonymized_userid>",1,74687,8474,"Thierry Baudet (FvD)",0.988263159287586,0.905245166114731,0
"<anonymized_userid>",1,74688,8475,"Thierry Baudet (FvD)",0.988276391351523,0.905351992308514,0
"<anonymized_userid>",1,74689,8476,"Thierry Baudet (FvD)",0.98828962341546,0.905458818502297,0
"<anonymized_userid>",1,74690,8477,"Thierry Baudet (FvD)",0.988302855479398,0.905565644696079,0
"<anonymized_userid>",1,74691,8478,"Thierry Baudet (FvD)",0.988316087543335,0.905672470889862,0
"<anonymized_userid>",1,74692,8479,"Thierry Baudet (FvD)",0.988329319607272,0.905779297083645,0
"<anonymized_userid>",1,74693,8480,"Thierry Baudet (FvD)",0.98834255167121,0.905886123277428,0
"<anonymized_userid>",1,74694,8481,"Thierry Baudet (FvD)",0.988355783735147,0.90599294947121,0
"<anonymized_userid>",1,74695,8482,"Thierry Baudet (FvD)",0.988369015799084,0.906099775664993,0
"<anonymized_userid>",1,74696,8483,"Thierry Baudet (FvD)",0.988382247863022,0.906206601858776,0
"<anonymized_userid>",1,74697,8484,"Thierry Baudet (FvD)",0.988395479926959,0.906313428052558,0
"<anonymized_userid>",1,74698,8485,"Thierry Baudet (FvD)",0.988408711990896,0.906420254246341,0
"<anonymized_userid>",1,74699,8486,"Thierry Baudet (FvD)",0.988421944054834,0.906527080440124,0
"<anonymized_userid>",1,74700,8487,"Thierry Baudet (FvD)",0.988435176118771,0.906633906633907,0
"<anonymized_userid>",1,74701,8488,"Thierry Baudet (FvD)",0.988448408182708,0.906740732827689,0
"<anonymized_userid>",1,74702,8489,"Thierry Baudet (FvD)",0.988461640246646,0.906847559021472,0
"<anonymized_userid>",1,74703,8490,"Thierry Baudet (FvD)",0.988474872310583,0.906954385215255,0
"<anonymized_userid>",1,74704,8491,"Thierry Baudet (FvD)",0.98848810437452,0.907061211409038,0
"<anonymized_userid>",1,74705,8492,"Thierry Baudet (FvD)",0.988501336438458,0.90716803760282,0
"<anonymized_userid>",1,74706,8493,"Thierry Baudet (FvD)",0.988514568502395,0.907274863796603,0
"<anonymized_userid>",1,74707,8494,"Thierry Baudet (FvD)",0.988527800566332,0.907381689990386,0
"<anonymized_userid>",1,74708,8495,"Thierry Baudet (FvD)",0.98854103263027,0.907488516184168,0
"<anonymized_userid>",1,74709,8496,"Thierry Baudet (FvD)",0.988554264694207,0.907595342377951,0
"<anonymized_userid>",1,74710,8497,"Thierry Baudet (FvD)",0.988567496758144,0.907702168571734,0
"<anonymized_userid>",1,74711,8498,"Thierry Baudet (FvD)",0.988580728822082,0.907808994765516,0
"<anonymized_userid>",1,74712,8499,"Thierry Baudet (FvD)",0.988593960886019,0.907915820959299,0
"<anonymized_userid>",1,74713,8500,"Thierry Baudet (FvD)",0.988607192949956,0.908022647153082,0
"<anonymized_userid>",1,74714,8501,"Thierry Baudet (FvD)",0.988620425013894,0.908129473346865,0
"<anonymized_userid>",1,74715,8502,"Thierry Baudet (FvD)",0.988633657077831,0.908236299540647,0
"<anonymized_userid>",1,74716,8503,"Thierry Baudet (FvD)",0.988646889141768,0.90834312573443,0
"<anonymized_userid>",1,74717,8504,"Thierry Baudet (FvD)",0.988660121205706,0.908449951928213,0
"<anonymized_userid>",1,74718,8505,"Thierry Baudet (FvD)",0.988673353269643,0.908556778121996,0
"<anonymized_userid>",1,74719,8506,"Thierry Baudet (FvD)",0.98868658533358,0.908663604315778,0
"<anonymized_userid>",1,74720,8507,"Thierry Baudet (FvD)",0.988699817397518,0.908770430509561,0
"<anonymized_userid>",1,74721,8508,"Thierry Baudet (FvD)",0.988713049461455,0.908877256703344,0
"<anonymized_userid>",1,74722,8509,"Thierry Baudet (FvD)",0.988726281525392,0.908984082897126,0
"<anonymized_userid>",1,74723,8510,"Thierry Baudet (FvD)",0.98873951358933,0.909090909090909,0
"<anonymized_userid>",1,74724,8511,"Thierry Baudet (FvD)",0.988752745653267,0.909197735284692,0
"<anonymized_userid>",1,74725,8512,"Thierry Baudet (FvD)",0.988765977717204,0.909304561478474,0
"<anonymized_userid>",1,74726,8513,"Thierry Baudet (FvD)",0.988779209781142,0.909411387672257,0
"<anonymized_userid>",1,74727,8514,"Thierry Baudet (FvD)",0.988792441845079,0.90951821386604,0
"<anonymized_userid>",1,74728,8515,"Thierry Baudet (FvD)",0.988805673909016,0.909625040059823,0
"<anonymized_userid>",1,74729,8516,"Thierry Baudet (FvD)",0.988818905972954,0.909731866253605,0
"<anonymized_userid>",1,74730,8517,"Thierry Baudet (FvD)",0.988832138036891,0.909838692447388,0
"<anonymized_userid>",1,74731,8518,"Thierry Baudet (FvD)",0.988845370100828,0.909945518641171,0
"<anonymized_userid>",1,74732,8519,"Thierry Baudet (FvD)",0.988858602164766,0.910052344834954,0
"<anonymized_userid>",1,74733,8520,"Thierry Baudet (FvD)",0.988871834228703,0.910159171028736,0
"<anonymized_userid>",1,74734,8521,"Thierry Baudet (FvD)",0.98888506629264,0.910265997222519,0
"<anonymized_userid>",1,74735,8522,"Thierry Baudet (FvD)",0.988898298356578,0.910372823416302,0
"<anonymized_userid>",1,74736,8523,"Thierry Baudet (FvD)",0.988911530420515,0.910479649610084,0
"<anonymized_userid>",1,74737,8524,"Thierry Baudet (FvD)",0.988924762484452,0.910586475803867,0
"<anonymized_userid>",1,74738,8525,"Thierry Baudet (FvD)",0.98893799454839,0.91069330199765,0
"<anonymized_userid>",1,74739,8526,"Thierry Baudet (FvD)",0.988951226612327,0.910800128191433,0
"<anonymized_userid>",1,74740,8527,"Thierry Baudet (FvD)",0.988964458676264,0.910906954385215,0
"<anonymized_userid>",1,74741,8528,"Thierry Baudet (FvD)",0.988977690740202,0.911013780578998,0
"<anonymized_userid>",1,74742,8529,"Thierry Baudet (FvD)",0.988990922804139,0.911120606772781,0
"<anonymized_userid>",1,74743,8530,"Thierry Baudet (FvD)",0.989004154868076,0.911227432966563,0
"<anonymized_userid>",1,74744,8531,"Thierry Baudet (FvD)",0.989017386932014,0.911334259160346,0
"<anonymized_userid>",1,74745,8532,"Thierry Baudet (FvD)",0.989030618995951,0.911441085354129,0
"<anonymized_userid>",1,74746,8533,"Thierry Baudet (FvD)",0.989043851059888,0.911547911547912,0
"<anonymized_userid>",1,74747,8534,"Thierry Baudet (FvD)",0.989057083123826,0.911654737741694,0
"<anonymized_userid>",1,74748,8535,"Thierry Baudet (FvD)",0.989070315187763,0.911761563935477,0
"<anonymized_userid>",1,74749,8536,"Thierry Baudet (FvD)",0.9890835472517,0.91186839012926,0
"<anonymized_userid>",1,74750,8537,"Thierry Baudet (FvD)",0.989096779315638,0.911975216323042,0
"<anonymized_userid>",1,74751,8538,"Thierry Baudet (FvD)",0.989110011379575,0.912082042516825,0
"<anonymized_userid>",1,74752,8539,"Thierry Baudet (FvD)",0.989123243443512,0.912188868710608,0
"<anonymized_userid>",1,74753,8540,"Thierry Baudet (FvD)",0.98913647550745,0.912295694904391,0
"<anonymized_userid>",1,74754,8541,"Thierry Baudet (FvD)",0.989149707571387,0.912402521098173,0
"<anonymized_userid>",1,74755,8542,"Thierry Baudet (FvD)",0.989162939635324,0.912509347291956,0
"<anonymized_userid>",1,74756,8543,"Thierry Baudet (FvD)",0.989176171699262,0.912616173485739,0
"<anonymized_userid>",1,74757,8544,"Thierry Baudet (FvD)",0.989189403763199,0.912722999679521,0
"<anonymized_userid>",1,74758,8545,"Thierry Baudet (FvD)",0.989202635827136,0.912829825873304,0
"<anonymized_userid>",1,74759,8546,"Thierry Baudet (FvD)",0.989215867891074,0.912936652067087,0
"<anonymized_userid>",1,74760,8547,"Thierry Baudet (FvD)",0.989229099955011,0.91304347826087,0
"<anonymized_userid>",1,74761,8548,"Thierry Baudet (FvD)",0.989242332018948,0.913150304454652,0
"<anonymized_userid>",1,74762,8549,"Thierry Baudet (FvD)",0.989255564082886,0.913257130648435,0
"<anonymized_userid>",1,74763,8550,"Thierry Baudet (FvD)",0.989268796146823,0.913363956842218,0
"<anonymized_userid>",1,74764,8551,"Thierry Baudet (FvD)",0.98928202821076,0.913470783036,0
"<anonymized_userid>",1,74765,8552,"Thierry Baudet (FvD)",0.989295260274698,0.913577609229783,0
"<anonymized_userid>",1,74766,8553,"Thierry Baudet (FvD)",0.989308492338635,0.913684435423566,0
"<anonymized_userid>",1,74767,8554,"Thierry Baudet (FvD)",0.989321724402572,0.913791261617349,0
"<anonymized_userid>",1,74768,8555,"Thierry Baudet (FvD)",0.98933495646651,0.913898087811131,0
"<anonymized_userid>",1,74769,8556,"Thierry Baudet (FvD)",0.989348188530447,0.914004914004914,0
"<anonymized_userid>",1,74770,8557,"Thierry Baudet (FvD)",0.989361420594384,0.914111740198697,0
"<anonymized_userid>",1,74771,8558,"Thierry Baudet (FvD)",0.989374652658322,0.914218566392479,0
"<anonymized_userid>",1,74772,8559,"Thierry Baudet (FvD)",0.989387884722259,0.914325392586262,0
"<anonymized_userid>",1,74773,8560,"Thierry Baudet (FvD)",0.989401116786196,0.914432218780045,0
"<anonymized_userid>",1,74774,8561,"Thierry Baudet (FvD)",0.989414348850134,0.914539044973828,0
"<anonymized_userid>",1,74775,8562,"Thierry Baudet (FvD)",0.989427580914071,0.91464587116761,0
"<anonymized_userid>",1,74776,8563,"Thierry Baudet (FvD)",0.989440812978008,0.914752697361393,0
"<anonymized_userid>",1,74777,8564,"Thierry Baudet (FvD)",0.989454045041946,0.914859523555176,0
"<anonymized_userid>",1,74778,8565,"Thierry Baudet (FvD)",0.989467277105883,0.914966349748958,0
"<anonymized_userid>",1,74779,8566,"Thierry Baudet (FvD)",0.98948050916982,0.915073175942741,0
"<anonymized_userid>",1,74780,8567,"Thierry Baudet (FvD)",0.989493741233758,0.915180002136524,0
"<anonymized_userid>",1,74781,8568,"Thierry Baudet (FvD)",0.989506973297695,0.915286828330307,0
"<anonymized_userid>",1,74782,8569,"Thierry Baudet (FvD)",0.989520205361632,0.915393654524089,0
"<anonymized_userid>",1,74783,8570,"Thierry Baudet (FvD)",0.98953343742557,0.915500480717872,0
"<anonymized_userid>",1,74784,8571,"Thierry Baudet (FvD)",0.989546669489507,0.915607306911655,0
"<anonymized_userid>",1,74785,8572,"Thierry Baudet (FvD)",0.989559901553444,0.915714133105437,0
"<anonymized_userid>",1,74786,8573,"Thierry Baudet (FvD)",0.989573133617382,0.91582095929922,0
"<anonymized_userid>",1,74787,8574,"Thierry Baudet (FvD)",0.989586365681319,0.915927785493003,0
"<anonymized_userid>",1,74788,8575,"Thierry Baudet (FvD)",0.989599597745256,0.916034611686786,0
"<anonymized_userid>",1,74789,8576,"Thierry Baudet (FvD)",0.989612829809194,0.916141437880568,0
"<anonymized_userid>",1,74790,8577,"Thierry Baudet (FvD)",0.989626061873131,0.916248264074351,0
"<anonymized_userid>",1,74791,8578,"Thierry Baudet (FvD)",0.989639293937068,0.916355090268134,0
"<anonymized_userid>",1,74792,8579,"Thierry Baudet (FvD)",0.989652526001006,0.916461916461916,0
"<anonymized_userid>",1,74793,8580,"Thierry Baudet (FvD)",0.989665758064943,0.916568742655699,0
"<anonymized_userid>",1,74794,8581,"Thierry Baudet (FvD)",0.98967899012888,0.916675568849482,0
"<anonymized_userid>",1,74795,8582,"Thierry Baudet (FvD)",0.989692222192818,0.916782395043265,0
"<anonymized_userid>",1,74796,8583,"Thierry Baudet (FvD)",0.989705454256755,0.916889221237047,0
"<anonymized_userid>",1,74797,8584,"Thierry Baudet (FvD)",0.989718686320692,0.91699604743083,0
"<anonymized_userid>",1,74798,8585,"Thierry Baudet (FvD)",0.98973191838463,0.917102873624613,0
"<anonymized_userid>",1,74799,8586,"Thierry Baudet (FvD)",0.989745150448567,0.917209699818396,0
"<anonymized_userid>",1,74800,8587,"Thierry Baudet (FvD)",0.989758382512504,0.917316526012178,0
"<anonymized_userid>",1,74801,8588,"Thierry Baudet (FvD)",0.989771614576442,0.917423352205961,0
"<anonymized_userid>",1,74802,8589,"Thierry Baudet (FvD)",0.989784846640379,0.917530178399744,0
"<anonymized_userid>",1,74803,8590,"Thierry Baudet (FvD)",0.989798078704316,0.917637004593526,0
"<anonymized_userid>",1,74804,8591,"Thierry Baudet (FvD)",0.989811310768254,0.917743830787309,0
"<anonymized_userid>",1,74805,8592,"Thierry Baudet (FvD)",0.989824542832191,0.917850656981092,0
"<anonymized_userid>",1,74806,8593,"Thierry Baudet (FvD)",0.989837774896128,0.917957483174874,0
"<anonymized_userid>",1,74807,8594,"Thierry Baudet (FvD)",0.989851006960066,0.918064309368657,0
"<anonymized_userid>",1,74808,8595,"Thierry Baudet (FvD)",0.989864239024003,0.91817113556244,0
"<anonymized_userid>",1,74809,8596,"Thierry Baudet (FvD)",0.98987747108794,0.918277961756223,0
"<anonymized_userid>",1,74810,8597,"Thierry Baudet (FvD)",0.989890703151878,0.918384787950005,0
"<anonymized_userid>",1,74811,8598,"Thierry Baudet (FvD)",0.989903935215815,0.918491614143788,0
"<anonymized_userid>",1,74812,8599,"Thierry Baudet (FvD)",0.989917167279752,0.918598440337571,0
"<anonymized_userid>",1,74813,8600,"Thierry Baudet (FvD)",0.98993039934369,0.918705266531354,0
"<anonymized_userid>",1,74814,8601,"Thierry Baudet (FvD)",0.989943631407627,0.918812092725136,0
"<anonymized_userid>",1,74815,8602,"Thierry Baudet (FvD)",0.989956863471564,0.918918918918919,0
"<anonymized_userid>",1,74816,8603,"Thierry Baudet (FvD)",0.989970095535502,0.919025745112702,0
"<anonymized_userid>",1,74817,8604,"Thierry Baudet (FvD)",0.989983327599439,0.919132571306484,0
"<anonymized_userid>",1,74818,8605,"Thierry Baudet (FvD)",0.989996559663376,0.919239397500267,0
"<anonymized_userid>",1,74819,8606,"Thierry Baudet (FvD)",0.990009791727314,0.91934622369405,0
"<anonymized_userid>",1,74820,8607,"Thierry Baudet (FvD)",0.990023023791251,0.919453049887832,0
"<anonymized_userid>",1,74821,8608,"Thierry Baudet (FvD)",0.990036255855188,0.919559876081615,0
"<anonymized_userid>",1,74822,8609,"Thierry Baudet (FvD)",0.990049487919126,0.919666702275398,0
"<anonymized_userid>",1,74823,8610,"Thierry Baudet (FvD)",0.990062719983063,0.919773528469181,0
"<anonymized_userid>",1,74824,8611,"Thierry Baudet (FvD)",0.990075952047,0.919880354662963,0
"<anonymized_userid>",1,74825,8612,"Thierry Baudet (FvD)",0.990089184110938,0.919987180856746,0
"<anonymized_userid>",1,74826,8613,"Thierry Baudet (FvD)",0.990102416174875,0.920094007050529,0
"<anonymized_userid>",1,74827,8614,"Thierry Baudet (FvD)",0.990115648238812,0.920200833244311,0
"<anonymized_userid>",1,74828,8615,"Thierry Baudet (FvD)",0.99012888030275,0.920307659438094,0
"<anonymized_userid>",1,74829,8616,"Thierry Baudet (FvD)",0.990142112366687,0.920414485631877,0
"<anonymized_userid>",1,74830,8617,"Thierry Baudet (FvD)",0.990155344430624,0.92052131182566,0
"<anonymized_userid>",1,74831,8618,"Thierry Baudet (FvD)",0.990168576494562,0.920628138019442,0
"<anonymized_userid>",1,74832,8619,"Thierry Baudet (FvD)",0.990181808558499,0.920734964213225,0
"<anonymized_userid>",1,74833,8620,"Thierry Baudet (FvD)",0.990195040622436,0.920841790407008,0
"<anonymized_userid>",1,74834,8621,"Thierry Baudet (FvD)",0.990208272686374,0.920948616600791,0
"<anonymized_userid>",1,74835,8622,"Thierry Baudet (FvD)",0.990221504750311,0.921055442794573,0
"<anonymized_userid>",1,74836,8623,"Thierry Baudet (FvD)",0.990234736814248,0.921162268988356,0
"<anonymized_userid>",1,74837,8624,"Thierry Baudet (FvD)",0.990247968878186,0.921269095182139,0
"<anonymized_userid>",1,74838,8625,"Thierry Baudet (FvD)",0.990261200942123,0.921375921375921,0
"<anonymized_userid>",1,74839,8626,"Thierry Baudet (FvD)",0.99027443300606,0.921482747569704,0
"<anonymized_userid>",1,74840,8627,"Thierry Baudet (FvD)",0.990287665069998,0.921589573763487,0
"<anonymized_userid>",1,74841,8628,"Thierry Baudet (FvD)",0.990300897133935,0.921696399957269,0
"<anonymized_userid>",1,74842,8629,"Thierry Baudet (FvD)",0.990314129197872,0.921803226151052,0
"<anonymized_userid>",1,74843,8630,"Thierry Baudet (FvD)",0.99032736126181,0.921910052344835,0
"<anonymized_userid>",1,74844,8631,"Thierry Baudet (FvD)",0.990340593325747,0.922016878538618,0
"<anonymized_userid>",1,74845,8632,"Thierry Baudet (FvD)",0.990353825389684,0.9221237047324,0
"<anonymized_userid>",1,74846,8633,"Thierry Baudet (FvD)",0.990367057453622,0.922230530926183,0
"<anonymized_userid>",1,74847,8634,"Thierry Baudet (FvD)",0.990380289517559,0.922337357119966,0
"<anonymized_userid>",1,74848,8635,"Thierry Baudet (FvD)",0.990393521581496,0.922444183313749,0
"<anonymized_userid>",1,74849,8636,"Thierry Baudet (FvD)",0.990406753645434,0.922551009507531,0
"<anonymized_userid>",1,74850,8637,"Thierry Baudet (FvD)",0.990419985709371,0.922657835701314,0
"<anonymized_userid>",1,74851,8638,"Thierry Baudet (FvD)",0.990433217773308,0.922764661895097,0
"<anonymized_userid>",1,74852,8639,"Thierry Baudet (FvD)",0.990446449837246,0.922871488088879,0
"<anonymized_userid>",1,74853,8640,"Thierry Baudet (FvD)",0.990459681901183,0.922978314282662,0
"<anonymized_userid>",1,74854,8641,"Thierry Baudet (FvD)",0.99047291396512,0.923085140476445,0
"<anonymized_userid>",1,74855,8642,"Thierry Baudet (FvD)",0.990486146029058,0.923191966670228,0
"<anonymized_userid>",1,74856,8643,"Thierry Baudet (FvD)",0.990499378092995,0.92329879286401,0
"<anonymized_userid>",1,74857,8644,"Thierry Baudet (FvD)",0.990512610156932,0.923405619057793,0
"<anonymized_userid>",1,74858,8645,"Thierry Baudet (FvD)",0.99052584222087,0.923512445251576,0
"<anonymized_userid>",1,74859,8646,"Thierry Baudet (FvD)",0.990539074284807,0.923619271445358,0
"<anonymized_userid>",1,74860,8647,"Thierry Baudet (FvD)",0.990552306348744,0.923726097639141,0
"<anonymized_userid>",1,74861,8648,"Thierry Baudet (FvD)",0.990565538412682,0.923832923832924,0
"<anonymized_userid>",1,74862,8649,"Thierry Baudet (FvD)",0.990578770476619,0.923939750026707,0
"<anonymized_userid>",1,74863,8650,"Thierry Baudet (FvD)",0.990592002540556,0.924046576220489,0
"<anonymized_userid>",1,74864,8651,"Thierry Baudet (FvD)",0.990605234604494,0.924153402414272,0
"<anonymized_userid>",1,74865,8652,"Thierry Baudet (FvD)",0.990618466668431,0.924260228608055,0
"<anonymized_userid>",1,74866,8653,"Thierry Baudet (FvD)",0.990631698732368,0.924367054801837,0
"<anonymized_userid>",1,74867,8654,"Thierry Baudet (FvD)",0.990644930796306,0.92447388099562,0
"<anonymized_userid>",1,74868,8655,"Thierry Baudet (FvD)",0.990658162860243,0.924580707189403,0
"<anonymized_userid>",1,74869,8656,"Thierry Baudet (FvD)",0.99067139492418,0.924687533383186,0
"<anonymized_userid>",1,74870,8657,"Thierry Baudet (FvD)",0.990684626988118,0.924794359576968,0
"<anonymized_userid>",1,74871,8658,"Thierry Baudet (FvD)",0.990697859052055,0.924901185770751,0
"<anonymized_userid>",1,74872,8659,"Thierry Baudet (FvD)",0.990711091115992,0.925008011964534,0
"<anonymized_userid>",1,74873,8660,"Thierry Baudet (FvD)",0.99072432317993,0.925114838158316,0
"<anonymized_userid>",1,74874,8661,"Thierry Baudet (FvD)",0.990737555243867,0.925221664352099,0
"<anonymized_userid>",1,74875,8662,"Thierry Baudet (FvD)",0.990750787307804,0.925328490545882,0
"<anonymized_userid>",1,74876,8663,"Thierry Baudet (FvD)",0.990764019371742,0.925435316739665,0
"<anonymized_userid>",1,74877,8664,"Thierry Baudet (FvD)",0.990777251435679,0.925542142933447,0
"<anonymized_userid>",1,74878,8665,"Thierry Baudet (FvD)",0.990790483499616,0.92564896912723,0
"<anonymized_userid>",1,74879,8666,"Thierry Baudet (FvD)",0.990803715563554,0.925755795321013,0
"<anonymized_userid>",1,74880,8667,"Thierry Baudet (FvD)",0.990816947627491,0.925862621514795,0
"<anonymized_userid>",1,74881,8668,"Thierry Baudet (FvD)",0.990830179691428,0.925969447708578,0
"<anonymized_userid>",1,74882,8669,"Thierry Baudet (FvD)",0.990843411755366,0.926076273902361,0
"<anonymized_userid>",1,74883,8670,"Thierry Baudet (FvD)",0.990856643819303,0.926183100096144,0
"<anonymized_userid>",1,74884,8671,"Thierry Baudet (FvD)",0.99086987588324,0.926289926289926,0
"<anonymized_userid>",1,74885,8672,"Thierry Baudet (FvD)",0.990883107947178,0.926396752483709,0
"<anonymized_userid>",1,74886,8673,"Thierry Baudet (FvD)",0.990896340011115,0.926503578677492,0
"<anonymized_userid>",1,74887,8674,"Thierry Baudet (FvD)",0.990909572075052,0.926610404871274,0
"<anonymized_userid>",1,74888,8675,"Thierry Baudet (FvD)",0.99092280413899,0.926717231065057,0
"<anonymized_userid>",1,74889,8676,"Thierry Baudet (FvD)",0.990936036202927,0.92682405725884,0
"<anonymized_userid>",1,74890,8677,"Thierry Baudet (FvD)",0.990949268266864,0.926930883452623,0
"<anonymized_userid>",1,74891,8678,"Thierry Baudet (FvD)",0.990962500330802,0.927037709646405,0
"<anonymized_userid>",1,74892,8679,"Thierry Baudet (FvD)",0.990975732394739,0.927144535840188,0
"<anonymized_userid>",1,74893,8680,"Thierry Baudet (FvD)",0.990988964458676,0.927251362033971,0
"<anonymized_userid>",1,74894,8681,"Thierry Baudet (FvD)",0.991002196522614,0.927358188227753,0
"<anonymized_userid>",1,74895,8682,"Thierry Baudet (FvD)",0.991015428586551,0.927465014421536,0
"<anonymized_userid>",1,74896,8683,"Thierry Baudet (FvD)",0.991028660650488,0.927571840615319,0
"<anonymized_userid>",1,74897,8684,"Thierry Baudet (FvD)",0.991041892714426,0.927678666809102,0
"<anonymized_userid>",1,74898,8685,"Thierry Baudet (FvD)",0.991055124778363,0.927785493002884,0
"<anonymized_userid>",1,74899,8686,"Thierry Baudet (FvD)",0.9910683568423,0.927892319196667,0
"<anonymized_userid>",1,74900,8687,"Thierry Baudet (FvD)",0.991081588906238,0.92799914539045,0
"<anonymized_userid>",1,74901,8688,"Thierry Baudet (FvD)",0.991094820970175,0.928105971584232,0
"<anonymized_userid>",1,74902,8689,"Thierry Baudet (FvD)",0.991108053034112,0.928212797778015,0
"<anonymized_userid>",1,74903,8690,"Thierry Baudet (FvD)",0.99112128509805,0.928319623971798,0
"<anonymized_userid>",1,74904,8691,"Thierry Baudet (FvD)",0.991134517161987,0.928426450165581,0
"<anonymized_userid>",1,74905,8692,"Thierry Baudet (FvD)",0.991147749225924,0.928533276359363,0
"<anonymized_userid>",1,74906,8693,"Thierry Baudet (FvD)",0.991160981289862,0.928640102553146,0
"<anonymized_userid>",1,74907,8694,"Thierry Baudet (FvD)",0.991174213353799,0.928746928746929,0
"<anonymized_userid>",1,74908,8695,"Thierry Baudet (FvD)",0.991187445417736,0.928853754940711,0
"<anonymized_userid>",1,74909,8696,"Thierry Baudet (FvD)",0.991200677481674,0.928960581134494,0
"<anonymized_userid>",1,74910,8697,"Thierry Baudet (FvD)",0.991213909545611,0.929067407328277,0
"<anonymized_userid>",1,74911,8698,"Thierry Baudet (FvD)",0.991227141609548,0.92917423352206,0
"<anonymized_userid>",1,74912,8699,"Thierry Baudet (FvD)",0.991240373673486,0.929281059715842,0
"<anonymized_userid>",1,74913,8700,"Thierry Baudet (FvD)",0.991253605737423,0.929387885909625,0
"<anonymized_userid>",1,74914,8701,"Thierry Baudet (FvD)",0.99126683780136,0.929494712103408,0
"<anonymized_userid>",1,74915,8702,"Thierry Baudet (FvD)",0.991280069865298,0.92960153829719,0
"<anonymized_userid>",1,74916,8703,"Thierry Baudet (FvD)",0.991293301929235,0.929708364490973,0
"<anonymized_userid>",1,74917,8704,"Thierry Baudet (FvD)",0.991306533993172,0.929815190684756,0
"<anonymized_userid>",1,74918,8705,"Thierry Baudet (FvD)",0.99131976605711,0.929922016878539,0
"<anonymized_userid>",1,74919,8706,"Thierry Baudet (FvD)",0.991332998121047,0.930028843072321,0
"<anonymized_userid>",1,74920,8707,"Thierry Baudet (FvD)",0.991346230184984,0.930135669266104,0
"<anonymized_userid>",1,74921,8708,"Thierry Baudet (FvD)",0.991359462248922,0.930242495459887,0
"<anonymized_userid>",1,74922,8709,"Thierry Baudet (FvD)",0.991372694312859,0.930349321653669,0
"<anonymized_userid>",1,74923,8710,"Thierry Baudet (FvD)",0.991385926376796,0.930456147847452,0
"<anonymized_userid>",1,74924,8711,"Thierry Baudet (FvD)",0.991399158440734,0.930562974041235,0
"<anonymized_userid>",1,74925,8712,"Thierry Baudet (FvD)",0.991412390504671,0.930669800235018,0
"<anonymized_userid>",1,74926,8713,"Thierry Baudet (FvD)",0.991425622568608,0.9307766264288,0
"<anonymized_userid>",1,74927,8714,"Thierry Baudet (FvD)",0.991438854632546,0.930883452622583,0
"<anonymized_userid>",1,74928,8715,"Thierry Baudet (FvD)",0.991452086696483,0.930990278816366,0
"<anonymized_userid>",1,74929,8716,"Thierry Baudet (FvD)",0.99146531876042,0.931097105010149,0
"<anonymized_userid>",1,74930,8717,"Thierry Baudet (FvD)",0.991478550824358,0.931203931203931,0
"<anonymized_userid>",1,74931,8718,"Thierry Baudet (FvD)",0.991491782888295,0.931310757397714,0
"<anonymized_userid>",1,74932,8719,"Thierry Baudet (FvD)",0.991505014952232,0.931417583591497,0
"<anonymized_userid>",1,74933,8720,"Thierry Baudet (FvD)",0.99151824701617,0.931524409785279,0
"<anonymized_userid>",1,74934,8721,"Thierry Baudet (FvD)",0.991531479080107,0.931631235979062,0
"<anonymized_userid>",1,74935,8722,"Thierry Baudet (FvD)",0.991544711144044,0.931738062172845,0
"<anonymized_userid>",1,74936,8723,"Thierry Baudet (FvD)",0.991557943207982,0.931844888366627,0
"<anonymized_userid>",1,74937,8724,"Thierry Baudet (FvD)",0.991571175271919,0.93195171456041,0
"<anonymized_userid>",1,74938,8725,"Thierry Baudet (FvD)",0.991584407335856,0.932058540754193,0
"<anonymized_userid>",1,74939,8726,"Thierry Baudet (FvD)",0.991597639399794,0.932165366947976,0
"<anonymized_userid>",1,74940,8727,"Thierry Baudet (FvD)",0.991610871463731,0.932272193141758,0
"<anonymized_userid>",1,74941,8728,"Thierry Baudet (FvD)",0.991624103527668,0.932379019335541,0
"<anonymized_userid>",1,74942,8729,"Thierry Baudet (FvD)",0.991637335591606,0.932485845529324,0
"<anonymized_userid>",1,74943,8730,"Thierry Baudet (FvD)",0.991650567655543,0.932592671723107,0
"<anonymized_userid>",1,74944,8731,"Thierry Baudet (FvD)",0.99166379971948,0.932699497916889,0
"<anonymized_userid>",1,74945,8732,"Thierry Baudet (FvD)",0.991677031783418,0.932806324110672,0
"<anonymized_userid>",1,74946,8733,"Thierry Baudet (FvD)",0.991690263847355,0.932913150304455,0
"<anonymized_userid>",1,74947,8734,"Thierry Baudet (FvD)",0.991703495911292,0.933019976498237,0
"<anonymized_userid>",1,74948,8735,"Thierry Baudet (FvD)",0.99171672797523,0.93312680269202,0
"<anonymized_userid>",1,74949,8736,"Thierry Baudet (FvD)",0.991729960039167,0.933233628885803,0
"<anonymized_userid>",1,74950,8737,"Thierry Baudet (FvD)",0.991743192103104,0.933340455079586,0
"<anonymized_userid>",1,74951,8738,"Thierry Baudet (FvD)",0.991756424167042,0.933447281273368,0
"<anonymized_userid>",1,74952,8739,"Thierry Baudet (FvD)",0.991769656230979,0.933554107467151,0
"<anonymized_userid>",1,74953,8740,"Thierry Baudet (FvD)",0.991782888294916,0.933660933660934,0
"<anonymized_userid>",1,74954,8741,"Thierry Baudet (FvD)",0.991796120358854,0.933767759854716,0
"<anonymized_userid>",1,74955,8742,"Thierry Baudet (FvD)",0.991809352422791,0.933874586048499,0
"<anonymized_userid>",1,74956,8743,"Thierry Baudet (FvD)",0.991822584486728,0.933981412242282,0
"<anonymized_userid>",1,74957,8744,"Thierry Baudet (FvD)",0.991835816550666,0.934088238436064,0
"<anonymized_userid>",1,74958,8745,"Thierry Baudet (FvD)",0.991849048614603,0.934195064629847,0
"<anonymized_userid>",1,74959,8746,"Thierry Baudet (FvD)",0.99186228067854,0.93430189082363,0
"<anonymized_userid>",1,74960,8747,"Thierry Baudet (FvD)",0.991875512742478,0.934408717017413,0
"<anonymized_userid>",1,74961,8748,"Thierry Baudet (FvD)",0.991888744806415,0.934515543211195,0
"<anonymized_userid>",1,74962,8749,"Thierry Baudet (FvD)",0.991901976870352,0.934622369404978,0
"<anonymized_userid>",1,74963,8750,"Thierry Baudet (FvD)",0.99191520893429,0.934729195598761,0
"<anonymized_userid>",1,74964,8751,"Thierry Baudet (FvD)",0.991928440998227,0.934836021792544,0
"<anonymized_userid>",1,74965,8752,"Thierry Baudet (FvD)",0.991941673062164,0.934942847986326,0
"<anonymized_userid>",1,74966,8753,"Thierry Baudet (FvD)",0.991954905126102,0.935049674180109,0
"<anonymized_userid>",1,74967,8754,"Thierry Baudet (FvD)",0.991968137190039,0.935156500373892,0
"<anonymized_userid>",1,74968,8755,"Thierry Baudet (FvD)",0.991981369253976,0.935263326567674,0
"<anonymized_userid>",1,74969,8756,"Thierry Baudet (FvD)",0.991994601317914,0.935370152761457,0
"<anonymized_userid>",1,74970,8757,"Thierry Baudet (FvD)",0.992007833381851,0.93547697895524,0
"<anonymized_userid>",1,74971,8758,"Thierry Baudet (FvD)",0.992021065445788,0.935583805149023,0
"<anonymized_userid>",1,74972,8759,"Thierry Baudet (FvD)",0.992034297509726,0.935690631342805,0
"<anonymized_userid>",1,74973,8760,"Thierry Baudet (FvD)",0.992047529573663,0.935797457536588,0
"<anonymized_userid>",1,74974,8761,"Thierry Baudet (FvD)",0.9920607616376,0.935904283730371,0
"<anonymized_userid>",1,74975,8762,"Thierry Baudet (FvD)",0.992073993701538,0.936011109924153,0
"<anonymized_userid>",1,74976,8763,"Thierry Baudet (FvD)",0.992087225765475,0.936117936117936,0
"<anonymized_userid>",1,74977,8764,"Thierry Baudet (FvD)",0.992100457829412,0.936224762311719,0
"<anonymized_userid>",1,74978,8765,"Thierry Baudet (FvD)",0.99211368989335,0.936331588505502,0
"<anonymized_userid>",1,74979,8766,"Thierry Baudet (FvD)",0.992126921957287,0.936438414699284,0
"<anonymized_userid>",1,74980,8767,"Thierry Baudet (FvD)",0.992140154021224,0.936545240893067,0
"<anonymized_userid>",1,74981,8768,"Thierry Baudet (FvD)",0.992153386085162,0.93665206708685,0
"<anonymized_userid>",1,74982,8769,"Thierry Baudet (FvD)",0.992166618149099,0.936758893280632,0
"<anonymized_userid>",1,74983,8770,"Thierry Baudet (FvD)",0.992179850213036,0.936865719474415,0
"<anonymized_userid>",1,74984,8771,"Thierry Baudet (FvD)",0.992193082276974,0.936972545668198,0
"<anonymized_userid>",1,74985,8772,"Thierry Baudet (FvD)",0.992206314340911,0.937079371861981,0
"<anonymized_userid>",1,74986,8773,"Thierry Baudet (FvD)",0.992219546404848,0.937186198055763,0
"<anonymized_userid>",1,74987,8774,"Thierry Baudet (FvD)",0.992232778468786,0.937293024249546,0
"<anonymized_userid>",1,74988,8775,"Thierry Baudet (FvD)",0.992246010532723,0.937399850443329,0
"<anonymized_userid>",1,74989,8776,"Thierry Baudet (FvD)",0.99225924259666,0.937506676637111,0
"<anonymized_userid>",1,74990,8777,"Thierry Baudet (FvD)",0.992272474660598,0.937613502830894,0
"<anonymized_userid>",1,74991,8778,"Thierry Baudet (FvD)",0.992285706724535,0.937720329024677,0
"<anonymized_userid>",1,74992,8779,"Thierry Baudet (FvD)",0.992298938788472,0.93782715521846,0
"<anonymized_userid>",1,74993,8780,"Thierry Baudet (FvD)",0.99231217085241,0.937933981412242,0
"<anonymized_userid>",1,74994,8781,"Thierry Baudet (FvD)",0.992325402916347,0.938040807606025,0
"<anonymized_userid>",1,74995,8782,"Thierry Baudet (FvD)",0.992338634980284,0.938147633799808,0
"<anonymized_userid>",1,74996,8783,"Thierry Baudet (FvD)",0.992351867044222,0.93825445999359,0
"<anonymized_userid>",1,74997,8784,"Thierry Baudet (FvD)",0.992365099108159,0.938361286187373,0
"<anonymized_userid>",1,74998,8785,"Thierry Baudet (FvD)",0.992378331172096,0.938468112381156,0
"<anonymized_userid>",1,74999,8786,"Thierry Baudet (FvD)",0.992391563236034,0.938574938574939,0
"<anonymized_userid>",1,75000,8787,"Thierry Baudet (FvD)",0.992404795299971,0.938681764768721,0
"<anonymized_userid>",1,75001,8788,"Thierry Baudet (FvD)",0.992418027363908,0.938788590962504,0
"<anonymized_userid>",1,75002,8789,"Thierry Baudet (FvD)",0.992431259427846,0.938895417156287,0
"<anonymized_userid>",1,75003,8790,"Thierry Baudet (FvD)",0.992444491491783,0.939002243350069,0
"<anonymized_userid>",1,75004,8791,"Thierry Baudet (FvD)",0.99245772355572,0.939109069543852,0
"<anonymized_userid>",1,75005,8792,"Thierry Baudet (FvD)",0.992470955619658,0.939215895737635,0
"<anonymized_userid>",1,75006,8793,"Thierry Baudet (FvD)",0.992484187683595,0.939322721931418,0
"<anonymized_userid>",1,75007,8794,"Thierry Baudet (FvD)",0.992497419747532,0.9394295481252,0
"<anonymized_userid>",1,75008,8795,"Thierry Baudet (FvD)",0.99251065181147,0.939536374318983,0
"<anonymized_userid>",1,75009,8796,"Thierry Baudet (FvD)",0.992523883875407,0.939643200512766,0
"<anonymized_userid>",1,75010,8797,"Thierry Baudet (FvD)",0.992537115939344,0.939750026706548,0
"<anonymized_userid>",1,75011,8798,"Thierry Baudet (FvD)",0.992550348003282,0.939856852900331,0
"<anonymized_userid>",1,75012,8799,"Thierry Baudet (FvD)",0.992563580067219,0.939963679094114,0
"<anonymized_userid>",1,75013,8800,"Thierry Baudet (FvD)",0.992576812131156,0.940070505287897,0
"<anonymized_userid>",1,75014,8801,"Thierry Baudet (FvD)",0.992590044195094,0.940177331481679,0
"<anonymized_userid>",1,75015,8802,"Thierry Baudet (FvD)",0.992603276259031,0.940284157675462,0
"<anonymized_userid>",1,75016,8803,"Thierry Baudet (FvD)",0.992616508322968,0.940390983869245,0
"<anonymized_userid>",1,75017,8804,"Thierry Baudet (FvD)",0.992629740386906,0.940497810063027,0
"<anonymized_userid>",1,75018,8805,"Thierry Baudet (FvD)",0.992642972450843,0.94060463625681,0
"<anonymized_userid>",1,75019,8806,"Thierry Baudet (FvD)",0.99265620451478,0.940711462450593,0
"<anonymized_userid>",1,75020,8807,"Thierry Baudet (FvD)",0.992669436578718,0.940818288644376,0
"<anonymized_userid>",1,75021,8808,"Thierry Baudet (FvD)",0.992682668642655,0.940925114838158,0
"<anonymized_userid>",1,75022,8809,"Thierry Baudet (FvD)",0.992695900706592,0.941031941031941,0
"<anonymized_userid>",1,75023,8810,"Thierry Baudet (FvD)",0.99270913277053,0.941138767225724,0
"<anonymized_userid>",1,75024,8811,"Thierry Baudet (FvD)",0.992722364834467,0.941245593419506,0
"<anonymized_userid>",1,75025,8812,"Thierry Baudet (FvD)",0.992735596898404,0.941352419613289,0
"<anonymized_userid>",1,75026,8813,"Thierry Baudet (FvD)",0.992748828962342,0.941459245807072,0
"<anonymized_userid>",1,75027,8814,"Thierry Baudet (FvD)",0.992762061026279,0.941566072000855,0
"<anonymized_userid>",1,75028,8815,"Thierry Baudet (FvD)",0.992775293090216,0.941672898194637,0
"<anonymized_userid>",1,75029,8816,"Thierry Baudet (FvD)",0.992788525154154,0.94177972438842,0
"<anonymized_userid>",1,75030,8817,"Thierry Baudet (FvD)",0.992801757218091,0.941886550582203,0
"<anonymized_userid>",1,75031,8818,"Thierry Baudet (FvD)",0.992814989282028,0.941993376775985,0
"<anonymized_userid>",1,75032,8819,"Thierry Baudet (FvD)",0.992828221345965,0.942100202969768,0
"<anonymized_userid>",1,75033,8820,"Thierry Baudet (FvD)",0.992841453409903,0.942207029163551,0
"<anonymized_userid>",1,75034,8821,"Thierry Baudet (FvD)",0.99285468547384,0.942313855357334,0
"<anonymized_userid>",1,75035,8822,"Thierry Baudet (FvD)",0.992867917537778,0.942420681551116,0
"<anonymized_userid>",1,75036,8823,"Thierry Baudet (FvD)",0.992881149601715,0.942527507744899,0
"<anonymized_userid>",1,75037,8824,"Thierry Baudet (FvD)",0.992894381665652,0.942634333938682,0
"<anonymized_userid>",1,75038,8825,"Thierry Baudet (FvD)",0.99290761372959,0.942741160132464,0
"<anonymized_userid>",1,75039,8826,"Thierry Baudet (FvD)",0.992920845793527,0.942847986326247,0
"<anonymized_userid>",1,75040,8827,"Thierry Baudet (FvD)",0.992934077857464,0.94295481252003,0
"<anonymized_userid>",1,75041,8828,"Thierry Baudet (FvD)",0.992947309921402,0.943061638713813,0
"<anonymized_userid>",1,75042,8829,"Thierry Baudet (FvD)",0.992960541985339,0.943168464907595,0
"<anonymized_userid>",1,75043,8830,"Thierry Baudet (FvD)",0.992973774049276,0.943275291101378,0
"<anonymized_userid>",1,75044,8831,"Thierry Baudet (FvD)",0.992987006113214,0.943382117295161,0
"<anonymized_userid>",1,75045,8832,"Thierry Baudet (FvD)",0.993000238177151,0.943488943488944,0
"<anonymized_userid>",1,75046,8833,"Thierry Baudet (FvD)",0.993013470241088,0.943595769682726,0
"<anonymized_userid>",1,75047,8834,"Thierry Baudet (FvD)",0.993026702305026,0.943702595876509,0
"<anonymized_userid>",1,75048,8835,"Thierry Baudet (FvD)",0.993039934368963,0.943809422070292,0
"<anonymized_userid>",1,75049,8836,"Thierry Baudet (FvD)",0.9930531664329,0.943916248264074,0
"<anonymized_userid>",1,75050,8837,"Thierry Baudet (FvD)",0.993066398496838,0.944023074457857,0
"<anonymized_userid>",1,75051,8838,"Thierry Baudet (FvD)",0.993079630560775,0.94412990065164,0
"<anonymized_userid>",1,75052,8839,"Thierry Baudet (FvD)",0.993092862624712,0.944236726845422,0
"<anonymized_userid>",1,75053,8840,"Thierry Baudet (FvD)",0.99310609468865,0.944343553039205,0
"<anonymized_userid>",1,75054,8841,"Thierry Baudet (FvD)",0.993119326752587,0.944450379232988,0
"<anonymized_userid>",1,75055,8842,"Thierry Baudet (FvD)",0.993132558816524,0.944557205426771,0
"<anonymized_userid>",1,75056,8843,"Thierry Baudet (FvD)",0.993145790880462,0.944664031620553,0
"<anonymized_userid>",1,75057,8844,"Thierry Baudet (FvD)",0.993159022944399,0.944770857814336,0
"<anonymized_userid>",1,75058,8845,"Thierry Baudet (FvD)",0.993172255008336,0.944877684008119,0
"<anonymized_userid>",1,75059,8846,"Thierry Baudet (FvD)",0.993185487072273,0.944984510201902,0
"<anonymized_userid>",1,75060,8847,"Thierry Baudet (FvD)",0.993198719136211,0.945091336395684,0
"<anonymized_userid>",1,75061,8848,"Thierry Baudet (FvD)",0.993211951200148,0.945198162589467,0
"<anonymized_userid>",1,75062,8849,"Thierry Baudet (FvD)",0.993225183264085,0.94530498878325,0
"<anonymized_userid>",1,75063,8850,"Thierry Baudet (FvD)",0.993238415328023,0.945411814977032,0
"<anonymized_userid>",1,75064,8851,"Thierry Baudet (FvD)",0.99325164739196,0.945518641170815,0
"<anonymized_userid>",1,75065,8852,"Thierry Baudet (FvD)",0.993264879455897,0.945625467364598,0
"<anonymized_userid>",1,75066,8853,"Thierry Baudet (FvD)",0.993278111519835,0.945732293558381,0
"<anonymized_userid>",1,75067,8854,"Thierry Baudet (FvD)",0.993291343583772,0.945839119752163,0
"<anonymized_userid>",1,75068,8855,"Thierry Baudet (FvD)",0.99330457564771,0.945945945945946,0
"<anonymized_userid>",1,75069,8856,"Thierry Baudet (FvD)",0.993317807711647,0.946052772139729,0
"<anonymized_userid>",1,75070,8857,"Thierry Baudet (FvD)",0.993331039775584,0.946159598333511,0
"<anonymized_userid>",1,75071,8858,"Thierry Baudet (FvD)",0.993344271839522,0.946266424527294,0
"<anonymized_userid>",1,75072,8859,"Thierry Baudet (FvD)",0.993357503903459,0.946373250721077,0
"<anonymized_userid>",1,75073,8860,"Thierry Baudet (FvD)",0.993370735967396,0.946480076914859,0
"<anonymized_userid>",1,75074,8861,"Thierry Baudet (FvD)",0.993383968031334,0.946586903108642,0
"<anonymized_userid>",1,75075,8862,"Thierry Baudet (FvD)",0.993397200095271,0.946693729302425,0
"<anonymized_userid>",1,75076,8863,"Thierry Baudet (FvD)",0.993410432159208,0.946800555496208,0
"<anonymized_userid>",1,75077,8864,"Thierry Baudet (FvD)",0.993423664223146,0.94690738168999,0
"<anonymized_userid>",1,75078,8865,"Thierry Baudet (FvD)",0.993436896287083,0.947014207883773,0
"<anonymized_userid>",1,75079,8866,"Thierry Baudet (FvD)",0.99345012835102,0.947121034077556,0
"<anonymized_userid>",1,75080,8867,"Thierry Baudet (FvD)",0.993463360414958,0.947227860271339,0
"<anonymized_userid>",1,75081,8868,"Thierry Baudet (FvD)",0.993476592478895,0.947334686465121,0
"<anonymized_userid>",1,75082,8869,"Thierry Baudet (FvD)",0.993489824542832,0.947441512658904,0
"<anonymized_userid>",1,75083,8870,"Thierry Baudet (FvD)",0.99350305660677,0.947548338852687,0
"<anonymized_userid>",1,75084,8871,"Thierry Baudet (FvD)",0.993516288670707,0.947655165046469,0
"<anonymized_userid>",1,75085,8872,"Thierry Baudet (FvD)",0.993529520734644,0.947761991240252,0
"<anonymized_userid>",1,75086,8873,"Thierry Baudet (FvD)",0.993542752798582,0.947868817434035,0
"<anonymized_userid>",1,75087,8874,"Thierry Baudet (FvD)",0.993555984862519,0.947975643627817,0
"<anonymized_userid>",1,75088,8875,"Thierry Baudet (FvD)",0.993569216926456,0.9480824698216,0
"<anonymized_userid>",1,75089,8876,"Thierry Baudet (FvD)",0.993582448990393,0.948189296015383,0
"<anonymized_userid>",1,75090,8877,"Thierry Baudet (FvD)",0.993595681054331,0.948296122209166,0
"<anonymized_userid>",1,75091,8878,"Thierry Baudet (FvD)",0.993608913118268,0.948402948402948,0
"<anonymized_userid>",1,75092,8879,"Thierry Baudet (FvD)",0.993622145182205,0.948509774596731,0
"<anonymized_userid>",1,75093,8880,"Thierry Baudet (FvD)",0.993635377246143,0.948616600790514,0
"<anonymized_userid>",1,75094,8881,"Thierry Baudet (FvD)",0.99364860931008,0.948723426984297,0
"<anonymized_userid>",1,75095,8882,"Thierry Baudet (FvD)",0.993661841374017,0.948830253178079,0
"<anonymized_userid>",1,75096,8883,"Thierry Baudet (FvD)",0.993675073437955,0.948937079371862,0
"<anonymized_userid>",1,75097,8884,"Thierry Baudet (FvD)",0.993688305501892,0.949043905565645,0
"<anonymized_userid>",1,75098,8885,"Thierry Baudet (FvD)",0.99370153756583,0.949150731759427,0
"<anonymized_userid>",1,75099,8886,"Thierry Baudet (FvD)",0.993714769629767,0.94925755795321,0
"<anonymized_userid>",1,75100,8887,"Thierry Baudet (FvD)",0.993728001693704,0.949364384146993,0
"<anonymized_userid>",1,75101,8888,"Thierry Baudet (FvD)",0.993741233757642,0.949471210340776,0
"<anonymized_userid>",1,75102,8889,"Thierry Baudet (FvD)",0.993754465821579,0.949578036534558,0
"<anonymized_userid>",1,75103,8890,"Thierry Baudet (FvD)",0.993767697885516,0.949684862728341,0
"<anonymized_userid>",1,75104,8891,"Thierry Baudet (FvD)",0.993780929949454,0.949791688922124,0
"<anonymized_userid>",1,75105,8892,"Thierry Baudet (FvD)",0.993794162013391,0.949898515115906,0
"<anonymized_userid>",1,75106,8893,"Thierry Baudet (FvD)",0.993807394077328,0.950005341309689,0
"<anonymized_userid>",1,75107,8894,"Thierry Baudet (FvD)",0.993820626141266,0.950112167503472,0
"<anonymized_userid>",1,75108,8895,"Thierry Baudet (FvD)",0.993833858205203,0.950218993697255,0
"<anonymized_userid>",1,75109,8896,"Thierry Baudet (FvD)",0.99384709026914,0.950325819891037,0
"<anonymized_userid>",1,75110,8897,"Thierry Baudet (FvD)",0.993860322333078,0.95043264608482,0
"<anonymized_userid>",1,75111,8898,"Thierry Baudet (FvD)",0.993873554397015,0.950539472278603,0
"<anonymized_userid>",1,75112,8899,"Thierry Baudet (FvD)",0.993886786460952,0.950646298472385,0
"<anonymized_userid>",1,75113,8900,"Thierry Baudet (FvD)",0.99390001852489,0.950753124666168,0
"<anonymized_userid>",1,75114,8901,"Thierry Baudet (FvD)",0.993913250588827,0.950859950859951,0
"<anonymized_userid>",1,75115,8902,"Thierry Baudet (FvD)",0.993926482652764,0.950966777053734,0
"<anonymized_userid>",1,75116,8903,"Thierry Baudet (FvD)",0.993939714716702,0.951073603247516,0
"<anonymized_userid>",1,75117,8904,"Thierry Baudet (FvD)",0.993952946780639,0.951180429441299,0
"<anonymized_userid>",1,75118,8905,"Thierry Baudet (FvD)",0.993966178844576,0.951287255635082,0
"<anonymized_userid>",1,75119,8906,"Thierry Baudet (FvD)",0.993979410908513,0.951394081828864,0
"<anonymized_userid>",1,75120,8907,"Thierry Baudet (FvD)",0.993992642972451,0.951500908022647,0
"<anonymized_userid>",1,75121,8908,"Thierry Baudet (FvD)",0.994005875036388,0.95160773421643,0
"<anonymized_userid>",1,75122,8909,"Thierry Baudet (FvD)",0.994019107100325,0.951714560410213,0
"<anonymized_userid>",1,75123,8910,"Thierry Baudet (FvD)",0.994032339164263,0.951821386603995,0
"<anonymized_userid>",1,75124,8911,"Thierry Baudet (FvD)",0.9940455712282,0.951928212797778,0
"<anonymized_userid>",1,75125,8912,"Thierry Baudet (FvD)",0.994058803292137,0.952035038991561,0
"<anonymized_userid>",1,75126,8913,"Thierry Baudet (FvD)",0.994072035356075,0.952141865185343,0
"<anonymized_userid>",1,75127,8914,"Thierry Baudet (FvD)",0.994085267420012,0.952248691379126,0
"<anonymized_userid>",1,75128,8915,"Thierry Baudet (FvD)",0.994098499483949,0.952355517572909,0
"<anonymized_userid>",1,75129,8916,"Thierry Baudet (FvD)",0.994111731547887,0.952462343766692,0
"<anonymized_userid>",1,75130,8917,"Thierry Baudet (FvD)",0.994124963611824,0.952569169960474,0
"<anonymized_userid>",1,75131,8918,"Thierry Baudet (FvD)",0.994138195675762,0.952675996154257,0
"<anonymized_userid>",1,75132,8919,"Thierry Baudet (FvD)",0.994151427739699,0.95278282234804,0
"<anonymized_userid>",1,75133,8920,"Thierry Baudet (FvD)",0.994164659803636,0.952889648541822,0
"<anonymized_userid>",1,75134,8921,"Thierry Baudet (FvD)",0.994177891867574,0.952996474735605,0
"<anonymized_userid>",1,75135,8922,"Thierry Baudet (FvD)",0.994191123931511,0.953103300929388,0
"<anonymized_userid>",1,75136,8923,"Thierry Baudet (FvD)",0.994204355995448,0.953210127123171,0
"<anonymized_userid>",1,75137,8924,"Thierry Baudet (FvD)",0.994217588059386,0.953316953316953,0
"<anonymized_userid>",1,75138,8925,"Thierry Baudet (FvD)",0.994230820123323,0.953423779510736,0
"<anonymized_userid>",1,75139,8926,"Thierry Baudet (FvD)",0.99424405218726,0.953530605704519,0
"<anonymized_userid>",1,75140,8927,"Thierry Baudet (FvD)",0.994257284251198,0.953637431898301,0
"<anonymized_userid>",1,75141,8928,"Thierry Baudet (FvD)",0.994270516315135,0.953744258092084,0
"<anonymized_userid>",1,75142,8929,"Thierry Baudet (FvD)",0.994283748379072,0.953851084285867,0
"<anonymized_userid>",1,75143,8930,"Thierry Baudet (FvD)",0.99429698044301,0.95395791047965,0
"<anonymized_userid>",1,75144,8931,"Thierry Baudet (FvD)",0.994310212506947,0.954064736673432,0
"<anonymized_userid>",1,75145,8932,"Thierry Baudet (FvD)",0.994323444570884,0.954171562867215,0
"<anonymized_userid>",1,75146,8933,"Thierry Baudet (FvD)",0.994336676634822,0.954278389060998,0
"<anonymized_userid>",1,75147,8934,"Thierry Baudet (FvD)",0.994349908698759,0.95438521525478,0
"<anonymized_userid>",1,75148,8935,"Thierry Baudet (FvD)",0.994363140762696,0.954492041448563,0
"<anonymized_userid>",1,75149,8936,"Thierry Baudet (FvD)",0.994376372826633,0.954598867642346,0
"<anonymized_userid>",1,75150,8937,"Thierry Baudet (FvD)",0.994389604890571,0.954705693836129,0
"<anonymized_userid>",1,75151,8938,"Thierry Baudet (FvD)",0.994402836954508,0.954812520029911,0
"<anonymized_userid>",1,75152,8939,"Thierry Baudet (FvD)",0.994416069018445,0.954919346223694,0
"<anonymized_userid>",1,75153,8940,"Thierry Baudet (FvD)",0.994429301082383,0.955026172417477,0
"<anonymized_userid>",1,75154,8941,"Thierry Baudet (FvD)",0.99444253314632,0.955132998611259,0
"<anonymized_userid>",1,75155,8942,"Thierry Baudet (FvD)",0.994455765210257,0.955239824805042,0
"<anonymized_userid>",1,75156,8943,"Thierry Baudet (FvD)",0.994468997274195,0.955346650998825,0
"<anonymized_userid>",1,75157,8944,"Thierry Baudet (FvD)",0.994482229338132,0.955453477192608,0
"<anonymized_userid>",1,75158,8945,"Thierry Baudet (FvD)",0.994495461402069,0.95556030338639,0
"<anonymized_userid>",1,75159,8946,"Thierry Baudet (FvD)",0.994508693466007,0.955667129580173,0
"<anonymized_userid>",1,75160,8947,"Thierry Baudet (FvD)",0.994521925529944,0.955773955773956,0
"<anonymized_userid>",1,75161,8948,"Thierry Baudet (FvD)",0.994535157593881,0.955880781967739,0
"<anonymized_userid>",1,75162,8949,"Thierry Baudet (FvD)",0.994548389657819,0.955987608161521,0
"<anonymized_userid>",1,75163,8950,"Thierry Baudet (FvD)",0.994561621721756,0.956094434355304,0
"<anonymized_userid>",1,75164,8951,"Thierry Baudet (FvD)",0.994574853785694,0.956201260549087,0
"<anonymized_userid>",1,75165,8952,"Thierry Baudet (FvD)",0.994588085849631,0.956308086742869,0
"<anonymized_userid>",1,75166,8953,"Thierry Baudet (FvD)",0.994601317913568,0.956414912936652,0
"<anonymized_userid>",1,75167,8954,"Thierry Baudet (FvD)",0.994614549977506,0.956521739130435,0
"<anonymized_userid>",1,75168,8955,"Thierry Baudet (FvD)",0.994627782041443,0.956628565324217,0
"<anonymized_userid>",1,75169,8956,"Thierry Baudet (FvD)",0.99464101410538,0.956735391518,0
"<anonymized_userid>",1,75170,8957,"Thierry Baudet (FvD)",0.994654246169318,0.956842217711783,0
"<anonymized_userid>",1,75171,8958,"Thierry Baudet (FvD)",0.994667478233255,0.956949043905566,0
"<anonymized_userid>",1,75172,8959,"Thierry Baudet (FvD)",0.994680710297192,0.957055870099348,0
"<anonymized_userid>",1,75173,8960,"Thierry Baudet (FvD)",0.99469394236113,0.957162696293131,0
"<anonymized_userid>",1,75174,8961,"Thierry Baudet (FvD)",0.994707174425067,0.957269522486914,0
"<anonymized_userid>",1,75175,8962,"Thierry Baudet (FvD)",0.994720406489004,0.957376348680697,0
"<anonymized_userid>",1,75176,8963,"Thierry Baudet (FvD)",0.994733638552942,0.957483174874479,0
"<anonymized_userid>",1,75177,8964,"Thierry Baudet (FvD)",0.994746870616879,0.957590001068262,0
"<anonymized_userid>",1,75178,8965,"Thierry Baudet (FvD)",0.994760102680816,0.957696827262045,0
"<anonymized_userid>",1,75179,8966,"Thierry Baudet (FvD)",0.994773334744753,0.957803653455827,0
"<anonymized_userid>",1,75180,8967,"Thierry Baudet (FvD)",0.994786566808691,0.95791047964961,0
"<anonymized_userid>",1,75181,8968,"Thierry Baudet (FvD)",0.994799798872628,0.958017305843393,0
"<anonymized_userid>",1,75182,8969,"Thierry Baudet (FvD)",0.994813030936565,0.958124132037176,0
"<anonymized_userid>",1,75183,8970,"Thierry Baudet (FvD)",0.994826263000503,0.958230958230958,0
"<anonymized_userid>",1,75184,8971,"Thierry Baudet (FvD)",0.99483949506444,0.958337784424741,0
"<anonymized_userid>",1,75185,8972,"Thierry Baudet (FvD)",0.994852727128377,0.958444610618524,0
"<anonymized_userid>",1,75186,8973,"Thierry Baudet (FvD)",0.994865959192315,0.958551436812306,0
"<anonymized_userid>",1,75187,8974,"Thierry Baudet (FvD)",0.994879191256252,0.958658263006089,0
"<anonymized_userid>",1,75188,8975,"Thierry Baudet (FvD)",0.994892423320189,0.958765089199872,0
"<anonymized_userid>",1,75189,8976,"Thierry Baudet (FvD)",0.994905655384127,0.958871915393655,0
"<anonymized_userid>",1,75190,8977,"Thierry Baudet (FvD)",0.994918887448064,0.958978741587437,0
"<anonymized_userid>",1,75191,8978,"Thierry Baudet (FvD)",0.994932119512001,0.95908556778122,0
"<anonymized_userid>",1,75192,8979,"Thierry Baudet (FvD)",0.994945351575939,0.959192393975003,0
"<anonymized_userid>",1,75193,8980,"Thierry Baudet (FvD)",0.994958583639876,0.959299220168785,0
"<anonymized_userid>",1,75194,8981,"Thierry Baudet (FvD)",0.994971815703813,0.959406046362568,0
"<anonymized_userid>",1,75195,8982,"Thierry Baudet (FvD)",0.994985047767751,0.959512872556351,0
"<anonymized_userid>",1,75196,8983,"Thierry Baudet (FvD)",0.994998279831688,0.959619698750134,0
"<anonymized_userid>",1,75197,8984,"Thierry Baudet (FvD)",0.995011511895626,0.959726524943916,0
"<anonymized_userid>",1,75198,8985,"Thierry Baudet (FvD)",0.995024743959563,0.959833351137699,0
"<anonymized_userid>",1,75199,8986,"Thierry Baudet (FvD)",0.9950379760235,0.959940177331482,0
"<anonymized_userid>",1,75200,8987,"Thierry Baudet (FvD)",0.995051208087438,0.960047003525264,0
"<anonymized_userid>",1,75201,8988,"Thierry Baudet (FvD)",0.995064440151375,0.960153829719047,0
"<anonymized_userid>",1,75202,8989,"Thierry Baudet (FvD)",0.995077672215312,0.96026065591283,0
"<anonymized_userid>",1,75203,8990,"Thierry Baudet (FvD)",0.99509090427925,0.960367482106612,0
"<anonymized_userid>",1,75204,8991,"Thierry Baudet (FvD)",0.995104136343187,0.960474308300395,0
"<anonymized_userid>",1,75205,8992,"Thierry Baudet (FvD)",0.995117368407124,0.960581134494178,0
"<anonymized_userid>",1,75206,8993,"Thierry Baudet (FvD)",0.995130600471061,0.960687960687961,0
"<anonymized_userid>",1,75207,8994,"Thierry Baudet (FvD)",0.995143832534999,0.960794786881743,0
"<anonymized_userid>",1,75208,8995,"Thierry Baudet (FvD)",0.995157064598936,0.960901613075526,0
"<anonymized_userid>",1,75209,8996,"Thierry Baudet (FvD)",0.995170296662873,0.961008439269309,0
"<anonymized_userid>",1,75210,8997,"Thierry Baudet (FvD)",0.995183528726811,0.961115265463092,0
"<anonymized_userid>",1,75211,8998,"Thierry Baudet (FvD)",0.995196760790748,0.961222091656874,0
"<anonymized_userid>",1,75212,8999,"Thierry Baudet (FvD)",0.995209992854685,0.961328917850657,0
"<anonymized_userid>",1,75213,9000,"Thierry Baudet (FvD)",0.995223224918623,0.96143574404444,0
"<anonymized_userid>",1,75214,9001,"Thierry Baudet (FvD)",0.99523645698256,0.961542570238222,0
"<anonymized_userid>",1,75215,9002,"Thierry Baudet (FvD)",0.995249689046497,0.961649396432005,0
"<anonymized_userid>",1,75216,9003,"Thierry Baudet (FvD)",0.995262921110435,0.961756222625788,0
"<anonymized_userid>",1,75217,9004,"Thierry Baudet (FvD)",0.995276153174372,0.961863048819571,0
"<anonymized_userid>",1,75218,9005,"Thierry Baudet (FvD)",0.995289385238309,0.961969875013353,0
"<anonymized_userid>",1,75219,9006,"Thierry Baudet (FvD)",0.995302617302247,0.962076701207136,0
"<anonymized_userid>",1,75220,9007,"Thierry Baudet (FvD)",0.995315849366184,0.962183527400919,0
"<anonymized_userid>",1,75221,9008,"Thierry Baudet (FvD)",0.995329081430121,0.962290353594701,0
"<anonymized_userid>",1,75222,9009,"Thierry Baudet (FvD)",0.995342313494059,0.962397179788484,0
"<anonymized_userid>",1,75223,9010,"Thierry Baudet (FvD)",0.995355545557996,0.962504005982267,0
"<anonymized_userid>",1,75224,9011,"Thierry Baudet (FvD)",0.995368777621933,0.96261083217605,0
"<anonymized_userid>",1,75225,9012,"Thierry Baudet (FvD)",0.995382009685871,0.962717658369832,0
"<anonymized_userid>",1,75226,9013,"Thierry Baudet (FvD)",0.995395241749808,0.962824484563615,0
"<anonymized_userid>",1,75227,9014,"Thierry Baudet (FvD)",0.995408473813745,0.962931310757398,0
"<anonymized_userid>",1,75228,9015,"Thierry Baudet (FvD)",0.995421705877683,0.96303813695118,0
"<anonymized_userid>",1,75229,9016,"Thierry Baudet (FvD)",0.99543493794162,0.963144963144963,0
"<anonymized_userid>",1,75230,9017,"Thierry Baudet (FvD)",0.995448170005558,0.963251789338746,0
"<anonymized_userid>",1,75231,9018,"Thierry Baudet (FvD)",0.995461402069495,0.963358615532529,0
"<anonymized_userid>",1,75232,9019,"Thierry Baudet (FvD)",0.995474634133432,0.963465441726311,0
"<anonymized_userid>",1,75233,9020,"Thierry Baudet (FvD)",0.99548786619737,0.963572267920094,0
"<anonymized_userid>",1,75234,9021,"Thierry Baudet (FvD)",0.995501098261307,0.963679094113877,0
"<anonymized_userid>",1,75235,9022,"Thierry Baudet (FvD)",0.995514330325244,0.963785920307659,0
"<anonymized_userid>",1,75236,9023,"Thierry Baudet (FvD)",0.995527562389181,0.963892746501442,0
"<anonymized_userid>",1,75237,9024,"Thierry Baudet (FvD)",0.995540794453119,0.963999572695225,0
"<anonymized_userid>",1,75238,9025,"Thierry Baudet (FvD)",0.995554026517056,0.964106398889008,0
"<anonymized_userid>",1,75239,9026,"Thierry Baudet (FvD)",0.995567258580993,0.96421322508279,0
"<anonymized_userid>",1,75240,9027,"Thierry Baudet (FvD)",0.995580490644931,0.964320051276573,0
"<anonymized_userid>",1,75241,9028,"Thierry Baudet (FvD)",0.995593722708868,0.964426877470356,0
"<anonymized_userid>",1,75242,9029,"Thierry Baudet (FvD)",0.995606954772805,0.964533703664138,0
"<anonymized_userid>",1,75243,9030,"Thierry Baudet (FvD)",0.995620186836743,0.964640529857921,0
"<anonymized_userid>",1,75244,9031,"Thierry Baudet (FvD)",0.99563341890068,0.964747356051704,0
"<anonymized_userid>",1,75245,9032,"Thierry Baudet (FvD)",0.995646650964617,0.964854182245487,0
"<anonymized_userid>",1,75246,9033,"Thierry Baudet (FvD)",0.995659883028555,0.964961008439269,0
"<anonymized_userid>",1,75247,9034,"Thierry Baudet (FvD)",0.995673115092492,0.965067834633052,0
"<anonymized_userid>",1,75248,9035,"Thierry Baudet (FvD)",0.995686347156429,0.965174660826835,0
"<anonymized_userid>",1,75249,9036,"Thierry Baudet (FvD)",0.995699579220367,0.965281487020617,0
"<anonymized_userid>",1,75250,9037,"Thierry Baudet (FvD)",0.995712811284304,0.9653883132144,0
"<anonymized_userid>",1,75251,9038,"Thierry Baudet (FvD)",0.995726043348241,0.965495139408183,0
"<anonymized_userid>",1,75252,9039,"Thierry Baudet (FvD)",0.995739275412179,0.965601965601966,0
"<anonymized_userid>",1,75253,9040,"Thierry Baudet (FvD)",0.995752507476116,0.965708791795748,0
"<anonymized_userid>",1,75254,9041,"Thierry Baudet (FvD)",0.995765739540053,0.965815617989531,0
"<anonymized_userid>",1,75255,9042,"Thierry Baudet (FvD)",0.995778971603991,0.965922444183314,0
"<anonymized_userid>",1,75256,9043,"Thierry Baudet (FvD)",0.995792203667928,0.966029270377097,0
"<anonymized_userid>",1,75257,9044,"Thierry Baudet (FvD)",0.995805435731865,0.966136096570879,0
"<anonymized_userid>",1,75258,9045,"Thierry Baudet (FvD)",0.995818667795803,0.966242922764662,0
"<anonymized_userid>",1,75259,9046,"Thierry Baudet (FvD)",0.99583189985974,0.966349748958445,0
"<anonymized_userid>",1,75260,9047,"Thierry Baudet (FvD)",0.995845131923677,0.966456575152227,0
"<anonymized_userid>",1,75261,9048,"Thierry Baudet (FvD)",0.995858363987615,0.96656340134601,0
"<anonymized_userid>",1,75262,9049,"Thierry Baudet (FvD)",0.995871596051552,0.966670227539793,0
"<anonymized_userid>",1,75263,9050,"Thierry Baudet (FvD)",0.99588482811549,0.966777053733575,0
"<anonymized_userid>",1,75264,9051,"Thierry Baudet (FvD)",0.995898060179427,0.966883879927358,0
"<anonymized_userid>",1,75265,9052,"Thierry Baudet (FvD)",0.995911292243364,0.966990706121141,0
"<anonymized_userid>",1,75266,9053,"Thierry Baudet (FvD)",0.995924524307301,0.967097532314924,0
"<anonymized_userid>",1,75267,9054,"Thierry Baudet (FvD)",0.995937756371239,0.967204358508706,0
"<anonymized_userid>",1,75268,9055,"Thierry Baudet (FvD)",0.995950988435176,0.967311184702489,0
"<anonymized_userid>",1,75269,9056,"Thierry Baudet (FvD)",0.995964220499113,0.967418010896272,0
"<anonymized_userid>",1,75270,9057,"Thierry Baudet (FvD)",0.995977452563051,0.967524837090054,0
"<anonymized_userid>",1,75271,9058,"Thierry Baudet (FvD)",0.995990684626988,0.967631663283837,0
"<anonymized_userid>",1,75272,9059,"Thierry Baudet (FvD)",0.996003916690925,0.96773848947762,0
"<anonymized_userid>",1,75273,9060,"Thierry Baudet (FvD)",0.996017148754863,0.967845315671403,0
"<anonymized_userid>",1,75274,9061,"Thierry Baudet (FvD)",0.9960303808188,0.967952141865185,0
"<anonymized_userid>",1,75275,9062,"Thierry Baudet (FvD)",0.996043612882737,0.968058968058968,0
"<anonymized_userid>",1,75276,9063,"Thierry Baudet (FvD)",0.996056844946675,0.968165794252751,0
"<anonymized_userid>",1,75277,9064,"Thierry Baudet (FvD)",0.996070077010612,0.968272620446534,0
"<anonymized_userid>",1,75278,9065,"Thierry Baudet (FvD)",0.996083309074549,0.968379446640316,0
"<anonymized_userid>",1,75279,9066,"Thierry Baudet (FvD)",0.996096541138487,0.968486272834099,0
"<anonymized_userid>",1,75280,9067,"Thierry Baudet (FvD)",0.996109773202424,0.968593099027882,0
"<anonymized_userid>",1,75281,9068,"Thierry Baudet (FvD)",0.996123005266361,0.968699925221664,0
"<anonymized_userid>",1,75282,9069,"Thierry Baudet (FvD)",0.996136237330299,0.968806751415447,0
"<anonymized_userid>",1,75283,9070,"Thierry Baudet (FvD)",0.996149469394236,0.96891357760923,0
"<anonymized_userid>",1,75284,9071,"Thierry Baudet (FvD)",0.996162701458173,0.969020403803012,0
"<anonymized_userid>",1,75285,9072,"Thierry Baudet (FvD)",0.996175933522111,0.969127229996795,0
"<anonymized_userid>",1,75286,9073,"Thierry Baudet (FvD)",0.996189165586048,0.969234056190578,0
"<anonymized_userid>",1,75287,9074,"Thierry Baudet (FvD)",0.996202397649985,0.969340882384361,0
"<anonymized_userid>",1,75288,9075,"Thierry Baudet (FvD)",0.996215629713923,0.969447708578143,0
"<anonymized_userid>",1,75289,9076,"Thierry Baudet (FvD)",0.99622886177786,0.969554534771926,0
"<anonymized_userid>",1,75290,9077,"Thierry Baudet (FvD)",0.996242093841797,0.969661360965709,0
"<anonymized_userid>",1,75291,9078,"Thierry Baudet (FvD)",0.996255325905735,0.969768187159492,0
"<anonymized_userid>",1,75292,9079,"Thierry Baudet (FvD)",0.996268557969672,0.969875013353274,0
"<anonymized_userid>",1,75293,9080,"Thierry Baudet (FvD)",0.996281790033609,0.969981839547057,0
"<anonymized_userid>",1,75294,9081,"Thierry Baudet (FvD)",0.996295022097547,0.97008866574084,0
"<anonymized_userid>",1,75295,9082,"Thierry Baudet (FvD)",0.996308254161484,0.970195491934622,0
"<anonymized_userid>",1,75296,9083,"Thierry Baudet (FvD)",0.996321486225421,0.970302318128405,0
"<anonymized_userid>",1,75297,9084,"Thierry Baudet (FvD)",0.996334718289359,0.970409144322188,0
"<anonymized_userid>",1,75298,9085,"Thierry Baudet (FvD)",0.996347950353296,0.97051597051597,0
"<anonymized_userid>",1,75299,9086,"Thierry Baudet (FvD)",0.996361182417233,0.970622796709753,0
"<anonymized_userid>",1,75300,9087,"Thierry Baudet (FvD)",0.996374414481171,0.970729622903536,0
"<anonymized_userid>",1,75301,9088,"Thierry Baudet (FvD)",0.996387646545108,0.970836449097319,0
"<anonymized_userid>",1,75302,9089,"Thierry Baudet (FvD)",0.996400878609045,0.970943275291101,0
"<anonymized_userid>",1,75303,9090,"Thierry Baudet (FvD)",0.996414110672983,0.971050101484884,0
"<anonymized_userid>",1,75304,9091,"Thierry Baudet (FvD)",0.99642734273692,0.971156927678667,0
"<anonymized_userid>",1,75305,9092,"Thierry Baudet (FvD)",0.996440574800857,0.97126375387245,0
"<anonymized_userid>",1,75306,9093,"Thierry Baudet (FvD)",0.996453806864795,0.971370580066232,0
"<anonymized_userid>",1,75307,9094,"Thierry Baudet (FvD)",0.996467038928732,0.971477406260015,0
"<anonymized_userid>",1,75308,9095,"Thierry Baudet (FvD)",0.996480270992669,0.971584232453798,0
"<anonymized_userid>",1,75309,9096,"Thierry Baudet (FvD)",0.996493503056607,0.97169105864758,0
"<anonymized_userid>",1,75310,9097,"Thierry Baudet (FvD)",0.996506735120544,0.971797884841363,0
"<anonymized_userid>",1,75311,9098,"Thierry Baudet (FvD)",0.996519967184481,0.971904711035146,0
"<anonymized_userid>",1,75312,9099,"Thierry Baudet (FvD)",0.996533199248419,0.972011537228929,0
"<anonymized_userid>",1,75313,9100,"Thierry Baudet (FvD)",0.996546431312356,0.972118363422711,0
"<anonymized_userid>",1,75314,9101,"Thierry Baudet (FvD)",0.996559663376293,0.972225189616494,0
"<anonymized_userid>",1,75315,9102,"Thierry Baudet (FvD)",0.996572895440231,0.972332015810277,0
"<anonymized_userid>",1,75316,9103,"Thierry Baudet (FvD)",0.996586127504168,0.972438842004059,0
"<anonymized_userid>",1,75317,9104,"Thierry Baudet (FvD)",0.996599359568105,0.972545668197842,0
"<anonymized_userid>",1,75318,9105,"Thierry Baudet (FvD)",0.996612591632043,0.972652494391625,0
"<anonymized_userid>",1,75319,9106,"Thierry Baudet (FvD)",0.99662582369598,0.972759320585408,0
"<anonymized_userid>",1,75320,9107,"Thierry Baudet (FvD)",0.996639055759917,0.97286614677919,0
"<anonymized_userid>",1,75321,9108,"Thierry Baudet (FvD)",0.996652287823855,0.972972972972973,0
"<anonymized_userid>",1,75322,9109,"Thierry Baudet (FvD)",0.996665519887792,0.973079799166756,0
"<anonymized_userid>",1,75323,9110,"Thierry Baudet (FvD)",0.996678751951729,0.973186625360538,0
"<anonymized_userid>",1,75324,9111,"Thierry Baudet (FvD)",0.996691984015667,0.973293451554321,0
"<anonymized_userid>",1,75325,9112,"Thierry Baudet (FvD)",0.996705216079604,0.973400277748104,0
"<anonymized_userid>",1,75326,9113,"Thierry Baudet (FvD)",0.996718448143541,0.973507103941887,0
"<anonymized_userid>",1,75327,9114,"Thierry Baudet (FvD)",0.996731680207479,0.973613930135669,0
"<anonymized_userid>",1,75328,9115,"Thierry Baudet (FvD)",0.996744912271416,0.973720756329452,0
"<anonymized_userid>",1,75329,9116,"Thierry Baudet (FvD)",0.996758144335353,0.973827582523235,0
"<anonymized_userid>",1,75330,9117,"Thierry Baudet (FvD)",0.996771376399291,0.973934408717017,0
"<anonymized_userid>",1,75331,9118,"Thierry Baudet (FvD)",0.996784608463228,0.9740412349108,0
"<anonymized_userid>",1,75332,9119,"Thierry Baudet (FvD)",0.996797840527165,0.974148061104583,0
"<anonymized_userid>",1,75333,9120,"Thierry Baudet (FvD)",0.996811072591103,0.974254887298366,0
"<anonymized_userid>",1,75334,9121,"Thierry Baudet (FvD)",0.99682430465504,0.974361713492148,0
"<anonymized_userid>",1,75335,9122,"Thierry Baudet (FvD)",0.996837536718977,0.974468539685931,0
"<anonymized_userid>",1,75336,9123,"Thierry Baudet (FvD)",0.996850768782915,0.974575365879714,0
"<anonymized_userid>",1,75337,9124,"Thierry Baudet (FvD)",0.996864000846852,0.974682192073496,0
"<anonymized_userid>",1,75338,9125,"Thierry Baudet (FvD)",0.996877232910789,0.974789018267279,0
"<anonymized_userid>",1,75339,9126,"Thierry Baudet (FvD)",0.996890464974727,0.974895844461062,0
"<anonymized_userid>",1,75340,9127,"Thierry Baudet (FvD)",0.996903697038664,0.975002670654845,0
"<anonymized_userid>",1,75341,9128,"Thierry Baudet (FvD)",0.996916929102601,0.975109496848627,0
"<anonymized_userid>",1,75342,9129,"Thierry Baudet (FvD)",0.996930161166539,0.97521632304241,0
"<anonymized_userid>",1,75343,9130,"Thierry Baudet (FvD)",0.996943393230476,0.975323149236193,0
"<anonymized_userid>",1,75344,9131,"Thierry Baudet (FvD)",0.996956625294413,0.975429975429975,0
"<anonymized_userid>",1,75345,9132,"Thierry Baudet (FvD)",0.996969857358351,0.975536801623758,0
"<anonymized_userid>",1,75346,9133,"Thierry Baudet (FvD)",0.996983089422288,0.975643627817541,0
"<anonymized_userid>",1,75347,9134,"Thierry Baudet (FvD)",0.996996321486225,0.975750454011324,0
"<anonymized_userid>",1,75348,9135,"Thierry Baudet (FvD)",0.997009553550163,0.975857280205106,0
"<anonymized_userid>",1,75349,9136,"Thierry Baudet (FvD)",0.9970227856141,0.975964106398889,0
"<anonymized_userid>",1,75350,9137,"Thierry Baudet (FvD)",0.997036017678037,0.976070932592672,0
"<anonymized_userid>",1,75351,9138,"Thierry Baudet (FvD)",0.997049249741975,0.976177758786454,0
"<anonymized_userid>",1,75352,9139,"Thierry Baudet (FvD)",0.997062481805912,0.976284584980237,0
"<anonymized_userid>",1,75353,9140,"Thierry Baudet (FvD)",0.997075713869849,0.97639141117402,0
"<anonymized_userid>",1,75354,9141,"Thierry Baudet (FvD)",0.997088945933787,0.976498237367803,0
"<anonymized_userid>",1,75355,9142,"Thierry Baudet (FvD)",0.997102177997724,0.976605063561585,0
"<anonymized_userid>",1,75356,9143,"Thierry Baudet (FvD)",0.997115410061661,0.976711889755368,0
"<anonymized_userid>",1,75357,9144,"Thierry Baudet (FvD)",0.997128642125599,0.976818715949151,0
"<anonymized_userid>",1,75358,9145,"Thierry Baudet (FvD)",0.997141874189536,0.976925542142933,0
"<anonymized_userid>",1,75359,9146,"Thierry Baudet (FvD)",0.997155106253473,0.977032368336716,0
"<anonymized_userid>",1,75360,9147,"Thierry Baudet (FvD)",0.997168338317411,0.977139194530499,0
"<anonymized_userid>",1,75361,9148,"Thierry Baudet (FvD)",0.997181570381348,0.977246020724282,0
"<anonymized_userid>",1,75362,9149,"Thierry Baudet (FvD)",0.997194802445285,0.977352846918064,0
"<anonymized_userid>",1,75363,9150,"Thierry Baudet (FvD)",0.997208034509223,0.977459673111847,0
"<anonymized_userid>",1,75364,9151,"Thierry Baudet (FvD)",0.99722126657316,0.97756649930563,0
"<anonymized_userid>",1,75365,9152,"Thierry Baudet (FvD)",0.997234498637097,0.977673325499412,0
"<anonymized_userid>",1,75366,9153,"Thierry Baudet (FvD)",0.997247730701035,0.977780151693195,0
"<anonymized_userid>",1,75367,9154,"Thierry Baudet (FvD)",0.997260962764972,0.977886977886978,0
"<anonymized_userid>",1,75368,9155,"Thierry Baudet (FvD)",0.997274194828909,0.977993804080761,0
"<anonymized_userid>",1,75369,9156,"Thierry Baudet (FvD)",0.997287426892847,0.978100630274543,0
"<anonymized_userid>",1,75370,9157,"Thierry Baudet (FvD)",0.997300658956784,0.978207456468326,0
"<anonymized_userid>",1,75371,9158,"Thierry Baudet (FvD)",0.997313891020721,0.978314282662109,0
"<anonymized_userid>",1,75372,9159,"Thierry Baudet (FvD)",0.997327123084659,0.978421108855892,0
"<anonymized_userid>",1,75373,9160,"Thierry Baudet (FvD)",0.997340355148596,0.978527935049674,0
"<anonymized_userid>",1,75374,9161,"Thierry Baudet (FvD)",0.997353587212533,0.978634761243457,0
"<anonymized_userid>",1,75375,9162,"Thierry Baudet (FvD)",0.997366819276471,0.97874158743724,0
"<anonymized_userid>",1,75376,9163,"Thierry Baudet (FvD)",0.997380051340408,0.978848413631022,0
"<anonymized_userid>",1,75377,9164,"Thierry Baudet (FvD)",0.997393283404345,0.978955239824805,0
"<anonymized_userid>",1,75378,9165,"Thierry Baudet (FvD)",0.997406515468283,0.979062066018588,0
"<anonymized_userid>",1,75379,9166,"Thierry Baudet (FvD)",0.99741974753222,0.97916889221237,0
"<anonymized_userid>",1,75380,9167,"Thierry Baudet (FvD)",0.997432979596157,0.979275718406153,0
"<anonymized_userid>",1,75381,9168,"Thierry Baudet (FvD)",0.997446211660095,0.979382544599936,0
"<anonymized_userid>",1,75382,9169,"Thierry Baudet (FvD)",0.997459443724032,0.979489370793719,0
"<anonymized_userid>",1,75383,9170,"Thierry Baudet (FvD)",0.997472675787969,0.979596196987501,0
"<anonymized_userid>",1,75384,9171,"Thierry Baudet (FvD)",0.997485907851907,0.979703023181284,0
"<anonymized_userid>",1,75385,9172,"Thierry Baudet (FvD)",0.997499139915844,0.979809849375067,0
"<anonymized_userid>",1,75386,9173,"Thierry Baudet (FvD)",0.997512371979781,0.979916675568849,0
"<anonymized_userid>",1,75387,9174,"Thierry Baudet (FvD)",0.997525604043719,0.980023501762632,0
"<anonymized_userid>",1,75388,9175,"Thierry Baudet (FvD)",0.997538836107656,0.980130327956415,0
"<anonymized_userid>",1,75389,9176,"Thierry Baudet (FvD)",0.997552068171593,0.980237154150198,0
"<anonymized_userid>",1,75390,9177,"Thierry Baudet (FvD)",0.997565300235531,0.98034398034398,0
"<anonymized_userid>",1,75391,9178,"Thierry Baudet (FvD)",0.997578532299468,0.980450806537763,0
"<anonymized_userid>",1,75392,9179,"Thierry Baudet (FvD)",0.997591764363405,0.980557632731546,0
"<anonymized_userid>",1,75393,9180,"Thierry Baudet (FvD)",0.997604996427343,0.980664458925328,0
"<anonymized_userid>",1,75394,9181,"Thierry Baudet (FvD)",0.99761822849128,0.980771285119111,0
"<anonymized_userid>",1,75395,9182,"Thierry Baudet (FvD)",0.997631460555217,0.980878111312894,0
"<anonymized_userid>",1,75396,9183,"Thierry Baudet (FvD)",0.997644692619155,0.980984937506677,0
"<anonymized_userid>",1,75397,9184,"Thierry Baudet (FvD)",0.997657924683092,0.981091763700459,0
"<anonymized_userid>",1,75398,9185,"Thierry Baudet (FvD)",0.997671156747029,0.981198589894242,0
"<anonymized_userid>",1,75399,9186,"Thierry Baudet (FvD)",0.997684388810967,0.981305416088025,0
"<anonymized_userid>",1,75400,9187,"Thierry Baudet (FvD)",0.997697620874904,0.981412242281807,0
"<anonymized_userid>",1,75401,9188,"Thierry Baudet (FvD)",0.997710852938841,0.98151906847559,0
"<anonymized_userid>",1,75402,9189,"Thierry Baudet (FvD)",0.997724085002779,0.981625894669373,0
"<anonymized_userid>",1,75403,9190,"Thierry Baudet (FvD)",0.997737317066716,0.981732720863156,0
"<anonymized_userid>",1,75404,9191,"Thierry Baudet (FvD)",0.997750549130653,0.981839547056938,0
"<anonymized_userid>",1,75405,9192,"Thierry Baudet (FvD)",0.997763781194591,0.981946373250721,0
"<anonymized_userid>",1,75406,9193,"Thierry Baudet (FvD)",0.997777013258528,0.982053199444504,0
"<anonymized_userid>",1,75407,9194,"Thierry Baudet (FvD)",0.997790245322465,0.982160025638287,0
"<anonymized_userid>",1,75408,9195,"Thierry Baudet (FvD)",0.997803477386403,0.982266851832069,0
"<anonymized_userid>",1,75409,9196,"Thierry Baudet (FvD)",0.99781670945034,0.982373678025852,0
"<anonymized_userid>",1,75410,9197,"Thierry Baudet (FvD)",0.997829941514277,0.982480504219635,0
"<anonymized_userid>",1,75411,9198,"Thierry Baudet (FvD)",0.997843173578215,0.982587330413417,0
"<anonymized_userid>",1,75412,9199,"Thierry Baudet (FvD)",0.997856405642152,0.9826941566072,0
"<anonymized_userid>",1,75413,9200,"Thierry Baudet (FvD)",0.997869637706089,0.982800982800983,0
"<anonymized_userid>",1,75414,9201,"Thierry Baudet (FvD)",0.997882869770027,0.982907808994765,0
"<anonymized_userid>",1,75415,9202,"Thierry Baudet (FvD)",0.997896101833964,0.983014635188548,0
"<anonymized_userid>",1,75416,9203,"Thierry Baudet (FvD)",0.997909333897901,0.983121461382331,0
"<anonymized_userid>",1,75417,9204,"Thierry Baudet (FvD)",0.997922565961839,0.983228287576114,0
"<anonymized_userid>",1,75418,9205,"Thierry Baudet (FvD)",0.997935798025776,0.983335113769896,0
"<anonymized_userid>",1,75419,9206,"Thierry Baudet (FvD)",0.997949030089713,0.983441939963679,0
"<anonymized_userid>",1,75420,9207,"Thierry Baudet (FvD)",0.997962262153651,0.983548766157462,0
"<anonymized_userid>",1,75421,9208,"Thierry Baudet (FvD)",0.997975494217588,0.983655592351245,0
"<anonymized_userid>",1,75422,9209,"Thierry Baudet (FvD)",0.997988726281525,0.983762418545027,0
"<anonymized_userid>",1,75423,9210,"Thierry Baudet (FvD)",0.998001958345463,0.98386924473881,0
"<anonymized_userid>",1,75424,9211,"Thierry Baudet (FvD)",0.9980151904094,0.983976070932593,0
"<anonymized_userid>",1,75425,9212,"Thierry Baudet (FvD)",0.998028422473337,0.984082897126375,0
"<anonymized_userid>",1,75426,9213,"Thierry Baudet (FvD)",0.998041654537275,0.984189723320158,0
"<anonymized_userid>",1,75427,9214,"Thierry Baudet (FvD)",0.998054886601212,0.984296549513941,0
"<anonymized_userid>",1,75428,9215,"Thierry Baudet (FvD)",0.998068118665149,0.984403375707724,0
"<anonymized_userid>",1,75429,9216,"Thierry Baudet (FvD)",0.998081350729087,0.984510201901506,0
"<anonymized_userid>",1,75430,9217,"Thierry Baudet (FvD)",0.998094582793024,0.984617028095289,0
"<anonymized_userid>",1,75431,9218,"Thierry Baudet (FvD)",0.998107814856961,0.984723854289072,0
"<anonymized_userid>",1,75432,9219,"Thierry Baudet (FvD)",0.998121046920899,0.984830680482854,0
"<anonymized_userid>",1,75433,9220,"Thierry Baudet (FvD)",0.998134278984836,0.984937506676637,0
"<anonymized_userid>",1,75434,9221,"Thierry Baudet (FvD)",0.998147511048773,0.98504433287042,0
"<anonymized_userid>",1,75435,9222,"Thierry Baudet (FvD)",0.998160743112711,0.985151159064203,0
"<anonymized_userid>",1,75436,9223,"Thierry Baudet (FvD)",0.998173975176648,0.985257985257985,0
"<anonymized_userid>",1,75437,9224,"Thierry Baudet (FvD)",0.998187207240585,0.985364811451768,0
"<anonymized_userid>",1,75438,9225,"Thierry Baudet (FvD)",0.998200439304523,0.985471637645551,0
"<anonymized_userid>",1,75439,9226,"Thierry Baudet (FvD)",0.99821367136846,0.985578463839333,0
"<anonymized_userid>",1,75440,9227,"Thierry Baudet (FvD)",0.998226903432397,0.985685290033116,0
"<anonymized_userid>",1,75441,9228,"Thierry Baudet (FvD)",0.998240135496335,0.985792116226899,0
"<anonymized_userid>",1,75442,9229,"Thierry Baudet (FvD)",0.998253367560272,0.985898942420682,0
"<anonymized_userid>",1,75443,9230,"Thierry Baudet (FvD)",0.998266599624209,0.986005768614464,0
"<anonymized_userid>",1,75444,9231,"Thierry Baudet (FvD)",0.998279831688147,0.986112594808247,0
"<anonymized_userid>",1,75445,9232,"Thierry Baudet (FvD)",0.998293063752084,0.98621942100203,0
"<anonymized_userid>",1,75446,9233,"Thierry Baudet (FvD)",0.998306295816021,0.986326247195812,0
"<anonymized_userid>",1,75447,9234,"Thierry Baudet (FvD)",0.998319527879959,0.986433073389595,0
"<anonymized_userid>",1,75448,9235,"Thierry Baudet (FvD)",0.998332759943896,0.986539899583378,0
"<anonymized_userid>",1,75449,9236,"Thierry Baudet (FvD)",0.998345992007833,0.986646725777161,0
"<anonymized_userid>",1,75450,9237,"Thierry Baudet (FvD)",0.998359224071771,0.986753551970943,0
"<anonymized_userid>",1,75451,9238,"Thierry Baudet (FvD)",0.998372456135708,0.986860378164726,0
"<anonymized_userid>",1,75452,9239,"Thierry Baudet (FvD)",0.998385688199645,0.986967204358509,0
"<anonymized_userid>",1,75453,9240,"Thierry Baudet (FvD)",0.998398920263583,0.987074030552291,0
"<anonymized_userid>",1,75454,9241,"Thierry Baudet (FvD)",0.99841215232752,0.987180856746074,0
"<anonymized_userid>",1,75455,9242,"Thierry Baudet (FvD)",0.998425384391457,0.987287682939857,0
"<anonymized_userid>",1,75456,9243,"Thierry Baudet (FvD)",0.998438616455395,0.98739450913364,0
"<anonymized_userid>",1,75457,9244,"Thierry Baudet (FvD)",0.998451848519332,0.987501335327422,0
"<anonymized_userid>",1,75458,9245,"Thierry Baudet (FvD)",0.998465080583269,0.987608161521205,0
"<anonymized_userid>",1,75459,9246,"Thierry Baudet (FvD)",0.998478312647207,0.987714987714988,0
"<anonymized_userid>",1,75460,9247,"Thierry Baudet (FvD)",0.998491544711144,0.98782181390877,0
"<anonymized_userid>",1,75461,9248,"Thierry Baudet (FvD)",0.998504776775081,0.987928640102553,0
"<anonymized_userid>",1,75462,9249,"Thierry Baudet (FvD)",0.998518008839019,0.988035466296336,0
"<anonymized_userid>",1,75463,9250,"Thierry Baudet (FvD)",0.998531240902956,0.988142292490119,0
"<anonymized_userid>",1,75464,9251,"Thierry Baudet (FvD)",0.998544472966893,0.988249118683901,0
"<anonymized_userid>",1,75465,9252,"Thierry Baudet (FvD)",0.998557705030831,0.988355944877684,0
"<anonymized_userid>",1,75466,9253,"Thierry Baudet (FvD)",0.998570937094768,0.988462771071467,0
"<anonymized_userid>",1,75467,9254,"Thierry Baudet (FvD)",0.998584169158705,0.988569597265249,0
"<anonymized_userid>",1,75468,9255,"Thierry Baudet (FvD)",0.998597401222643,0.988676423459032,0
"<anonymized_userid>",1,75469,9256,"Thierry Baudet (FvD)",0.99861063328658,0.988783249652815,0
"<anonymized_userid>",1,75470,9257,"Thierry Baudet (FvD)",0.998623865350517,0.988890075846598,0
"<anonymized_userid>",1,75471,9258,"Thierry Baudet (FvD)",0.998637097414455,0.98899690204038,0
"<anonymized_userid>",1,75472,9259,"Thierry Baudet (FvD)",0.998650329478392,0.989103728234163,0
"<anonymized_userid>",1,75473,9260,"Thierry Baudet (FvD)",0.998663561542329,0.989210554427946,0
"<anonymized_userid>",1,75474,9261,"Thierry Baudet (FvD)",0.998676793606267,0.989317380621728,0
"<anonymized_userid>",1,75475,9262,"Thierry Baudet (FvD)",0.998690025670204,0.989424206815511,0
"<anonymized_userid>",1,75476,9263,"Thierry Baudet (FvD)",0.998703257734141,0.989531033009294,0
"<anonymized_userid>",1,75477,9264,"Thierry Baudet (FvD)",0.998716489798079,0.989637859203077,0
"<anonymized_userid>",1,75478,9265,"Thierry Baudet (FvD)",0.998729721862016,0.989744685396859,0
"<anonymized_userid>",1,75479,9266,"Thierry Baudet (FvD)",0.998742953925953,0.989851511590642,0
"<anonymized_userid>",1,75480,9267,"Thierry Baudet (FvD)",0.998756185989891,0.989958337784425,0
"<anonymized_userid>",1,75481,9268,"Thierry Baudet (FvD)",0.998769418053828,0.990065163978207,0
"<anonymized_userid>",1,75482,9269,"Thierry Baudet (FvD)",0.998782650117765,0.99017199017199,0
"<anonymized_userid>",1,75483,9270,"Thierry Baudet (FvD)",0.998795882181703,0.990278816365773,0
"<anonymized_userid>",1,75484,9271,"Thierry Baudet (FvD)",0.99880911424564,0.990385642559556,0
"<anonymized_userid>",1,75485,9272,"Thierry Baudet (FvD)",0.998822346309577,0.990492468753338,0
"<anonymized_userid>",1,75486,9273,"Thierry Baudet (FvD)",0.998835578373515,0.990599294947121,0
"<anonymized_userid>",1,75487,9274,"Thierry Baudet (FvD)",0.998848810437452,0.990706121140904,0
"<anonymized_userid>",1,75488,9275,"Thierry Baudet (FvD)",0.998862042501389,0.990812947334687,0
"<anonymized_userid>",1,75489,9276,"Thierry Baudet (FvD)",0.998875274565327,0.990919773528469,0
"<anonymized_userid>",1,75490,9277,"Thierry Baudet (FvD)",0.998888506629264,0.991026599722252,0
"<anonymized_userid>",1,75491,9278,"Thierry Baudet (FvD)",0.998901738693201,0.991133425916035,0
"<anonymized_userid>",1,75492,9279,"Thierry Baudet (FvD)",0.998914970757139,0.991240252109817,0
"<anonymized_userid>",1,75493,9280,"Thierry Baudet (FvD)",0.998928202821076,0.9913470783036,0
"<anonymized_userid>",1,75494,9281,"Thierry Baudet (FvD)",0.998941434885013,0.991453904497383,0
"<anonymized_userid>",1,75495,9282,"Thierry Baudet (FvD)",0.998954666948951,0.991560730691165,0
"<anonymized_userid>",1,75496,9283,"Thierry Baudet (FvD)",0.998967899012888,0.991667556884948,0
"<anonymized_userid>",1,75497,9284,"Thierry Baudet (FvD)",0.998981131076825,0.991774383078731,0
"<anonymized_userid>",1,75498,9285,"Thierry Baudet (FvD)",0.998994363140763,0.991881209272514,0
"<anonymized_userid>",1,75499,9286,"Thierry Baudet (FvD)",0.9990075952047,0.991988035466296,0
"<anonymized_userid>",1,75500,9287,"Thierry Baudet (FvD)",0.999020827268637,0.992094861660079,0
"<anonymized_userid>",1,75501,9288,"Thierry Baudet (FvD)",0.999034059332575,0.992201687853862,0
"<anonymized_userid>",1,75502,9289,"Thierry Baudet (FvD)",0.999047291396512,0.992308514047645,0
"<anonymized_userid>",1,75503,9290,"Thierry Baudet (FvD)",0.999060523460449,0.992415340241427,0
"<anonymized_userid>",1,75504,9291,"Thierry Baudet (FvD)",0.999073755524387,0.99252216643521,0
"<anonymized_userid>",1,75505,9292,"Thierry Baudet (FvD)",0.999086987588324,0.992628992628993,0
"<anonymized_userid>",1,75506,9293,"Thierry Baudet (FvD)",0.999100219652261,0.992735818822775,0
"<anonymized_userid>",1,75507,9294,"Thierry Baudet (FvD)",0.999113451716199,0.992842645016558,0
"<anonymized_userid>",1,75508,9295,"Thierry Baudet (FvD)",0.999126683780136,0.992949471210341,0
"<anonymized_userid>",1,75509,9296,"Thierry Baudet (FvD)",0.999139915844073,0.993056297404123,0
"<anonymized_userid>",1,75510,9297,"Thierry Baudet (FvD)",0.999153147908011,0.993163123597906,0
"<anonymized_userid>",1,75511,9298,"Thierry Baudet (FvD)",0.999166379971948,0.993269949791689,0
"<anonymized_userid>",1,75512,9299,"Thierry Baudet (FvD)",0.999179612035885,0.993376775985472,0
"<anonymized_userid>",1,75513,9300,"Thierry Baudet (FvD)",0.999192844099823,0.993483602179254,0
"<anonymized_userid>",1,75514,9301,"Thierry Baudet (FvD)",0.99920607616376,0.993590428373037,0
"<anonymized_userid>",1,75515,9302,"Thierry Baudet (FvD)",0.999219308227697,0.99369725456682,0
"<anonymized_userid>",1,75516,9303,"Thierry Baudet (FvD)",0.999232540291635,0.993804080760602,0
"<anonymized_userid>",1,75517,9304,"Thierry Baudet (FvD)",0.999245772355572,0.993910906954385,0
"<anonymized_userid>",1,75518,9305,"Thierry Baudet (FvD)",0.999259004419509,0.994017733148168,0
"<anonymized_userid>",1,75519,9306,"Thierry Baudet (FvD)",0.999272236483447,0.994124559341951,0
"<anonymized_userid>",1,75520,9307,"Thierry Baudet (FvD)",0.999285468547384,0.994231385535733,0
"<anonymized_userid>",1,75521,9308,"Thierry Baudet (FvD)",0.999298700611321,0.994338211729516,0
"<anonymized_userid>",1,75522,9309,"Thierry Baudet (FvD)",0.999311932675259,0.994445037923299,0
"<anonymized_userid>",1,75523,9310,"Thierry Baudet (FvD)",0.999325164739196,0.994551864117082,0
"<anonymized_userid>",1,75524,9311,"Thierry Baudet (FvD)",0.999338396803133,0.994658690310864,0
"<anonymized_userid>",1,75525,9312,"Thierry Baudet (FvD)",0.999351628867071,0.994765516504647,0
"<anonymized_userid>",1,75526,9313,"Thierry Baudet (FvD)",0.999364860931008,0.99487234269843,0
"<anonymized_userid>",1,75527,9314,"Thierry Baudet (FvD)",0.999378092994945,0.994979168892212,0
"<anonymized_userid>",1,75528,9315,"Thierry Baudet (FvD)",0.999391325058883,0.995085995085995,0
"<anonymized_userid>",1,75529,9316,"Thierry Baudet (FvD)",0.99940455712282,0.995192821279778,0
"<anonymized_userid>",1,75530,9317,"Thierry Baudet (FvD)",0.999417789186757,0.99529964747356,0
"<anonymized_userid>",1,75531,9318,"Thierry Baudet (FvD)",0.999431021250695,0.995406473667343,0
"<anonymized_userid>",1,75532,9319,"Thierry Baudet (FvD)",0.999444253314632,0.995513299861126,0
"<anonymized_userid>",1,75533,9320,"Thierry Baudet (FvD)",0.999457485378569,0.995620126054909,0
"<anonymized_userid>",1,75534,9321,"Thierry Baudet (FvD)",0.999470717442507,0.995726952248691,0
"<anonymized_userid>",1,75535,9322,"Thierry Baudet (FvD)",0.999483949506444,0.995833778442474,0
"<anonymized_userid>",1,75536,9323,"Thierry Baudet (FvD)",0.999497181570381,0.995940604636257,0
"<anonymized_userid>",1,75537,9324,"Thierry Baudet (FvD)",0.999510413634319,0.99604743083004,0
"<anonymized_userid>",1,75538,9325,"Thierry Baudet (FvD)",0.999523645698256,0.996154257023822,0
"<anonymized_userid>",1,75539,9326,"Thierry Baudet (FvD)",0.999536877762193,0.996261083217605,0
"<anonymized_userid>",1,75540,9327,"Thierry Baudet (FvD)",0.999550109826131,0.996367909411388,0
"<anonymized_userid>",1,75541,9328,"Thierry Baudet (FvD)",0.999563341890068,0.99647473560517,0
"<anonymized_userid>",1,75542,9329,"Thierry Baudet (FvD)",0.999576573954005,0.996581561798953,0
"<anonymized_userid>",1,75543,9330,"Thierry Baudet (FvD)",0.999589806017943,0.996688387992736,0
"<anonymized_userid>",1,75544,9331,"Thierry Baudet (FvD)",0.99960303808188,0.996795214186519,0
"<anonymized_userid>",1,75545,9332,"Thierry Baudet (FvD)",0.999616270145817,0.996902040380301,0
"<anonymized_userid>",1,75546,9333,"Thierry Baudet (FvD)",0.999629502209755,0.997008866574084,0
"<anonymized_userid>",1,75547,9334,"Thierry Baudet (FvD)",0.999642734273692,0.997115692767867,0
"<anonymized_userid>",1,75548,9335,"Thierry Baudet (FvD)",0.999655966337629,0.997222518961649,0
"<anonymized_userid>",1,75549,9336,"Thierry Baudet (FvD)",0.999669198401567,0.997329345155432,0
"<anonymized_userid>",1,75550,9337,"Thierry Baudet (FvD)",0.999682430465504,0.997436171349215,0
"<anonymized_userid>",1,75551,9338,"Thierry Baudet (FvD)",0.999695662529441,0.997542997542998,0
"<anonymized_userid>",1,75552,9339,"Thierry Baudet (FvD)",0.999708894593379,0.99764982373678,0
"<anonymized_userid>",1,75553,9340,"Thierry Baudet (FvD)",0.999722126657316,0.997756649930563,0
"<anonymized_userid>",1,75554,9341,"Thierry Baudet (FvD)",0.999735358721253,0.997863476124346,0
"<anonymized_userid>",1,75555,9342,"Thierry Baudet (FvD)",0.999748590785191,0.997970302318128,0
"<anonymized_userid>",1,75556,9343,"Thierry Baudet (FvD)",0.999761822849128,0.998077128511911,0
"<anonymized_userid>",1,75557,9344,"Thierry Baudet (FvD)",0.999775054913065,0.998183954705694,0
"<anonymized_userid>",1,75558,9345,"Thierry Baudet (FvD)",0.999788286977003,0.998290780899477,0
"<anonymized_userid>",1,75559,9346,"Thierry Baudet (FvD)",0.99980151904094,0.998397607093259,0
"<anonymized_userid>",1,75560,9347,"Thierry Baudet (FvD)",0.999814751104877,0.998504433287042,0
"<anonymized_userid>",1,75561,9348,"Thierry Baudet (FvD)",0.999827983168815,0.998611259480825,0
"<anonymized_userid>",1,75562,9349,"Thierry Baudet (FvD)",0.999841215232752,0.998718085674607,0
"<anonymized_userid>",1,75563,9350,"Thierry Baudet (FvD)",0.999854447296689,0.99882491186839,0
"<anonymized_userid>",1,75564,9351,"Thierry Baudet (FvD)",0.999867679360627,0.998931738062173,0
"<anonymized_userid>",1,75565,9352,"Thierry Baudet (FvD)",0.999880911424564,0.999038564255956,0
"<anonymized_userid>",1,75566,9353,"Thierry Baudet (FvD)",0.999894143488501,0.999145390449738,0
"<anonymized_userid>",1,75567,9354,"Thierry Baudet (FvD)",0.999907375552439,0.999252216643521,0
"<anonymized_userid>",1,75568,9355,"Thierry Baudet (FvD)",0.999920607616376,0.999359042837304,0
"<anonymized_userid>",1,75569,9356,"Thierry Baudet (FvD)",0.999933839680313,0.999465869031086,0
"<anonymized_userid>",1,75570,9357,"Thierry Baudet (FvD)",0.999947071744251,0.999572695224869,0
"<anonymized_userid>",1,75571,9358,"Thierry Baudet (FvD)",0.999960303808188,0.999679521418652,0
"<anonymized_userid>",1,75572,9359,"Thierry Baudet (FvD)",0.999973535872125,0.999786347612435,0
"<anonymized_userid>",1,75573,9360,"Thierry Baudet (FvD)",0.999986767936063,0.999893173806217,0
"<anonymized_userid>",1,75574,9361,"Thierry Baudet (FvD)",1,1,0
"<anonymized_userid>",80,80,1,"Mark Rutte (VVD)",0.0201055541593365,0.000398883127243718,0
"<anonymized_userid>",76,156,2,"Mark Rutte (VVD)",0.0392058306107062,0.000797766254487435,0
"<anonymized_userid>",63,219,3,"Mark Rutte (VVD)",0.0550389545111837,0.00119664938173115,0
"<anonymized_userid>",61,280,4,"Mark Rutte (VVD)",0.0703694395576778,0.00159553250897487,0
"<anonymized_userid>",42,322,5,"Mark Rutte (VVD)",0.0809248554913295,0.00199441563621859,0
"<anonymized_userid>",35,357,6,"Mark Rutte (VVD)",0.0897210354360392,0.00239329876346231,0
"<anonymized_userid>",32,389,7,"Mark Rutte (VVD)",0.0977632570997738,0.00279218189070602,0
"<anonymized_userid>",26,415,8,"Mark Rutte (VVD)",0.104297562201558,0.00319106501794974,0
"<anonymized_userid>",21,436,9,"Mark Rutte (VVD)",0.109575270168384,0.00358994814519346,0
"<anonymized_userid>",20,456,10,"Mark Rutte (VVD)",0.114601658708218,0.00398883127243718,0
"<anonymized_userid>",18,474,11,"Mark Rutte (VVD)",0.119125408394069,0.00438771439968089,0
"<anonymized_userid>",18,492,12,"Mark Rutte (VVD)",0.12364915807992,0.00478659752692461,0
"<anonymized_userid>",16,508,13,"Mark Rutte (VVD)",0.127670268911787,0.00518548065416833,0
"<anonymized_userid>",15,523,14,"Mark Rutte (VVD)",0.131440060316662,0.00558436378141205,0
"<anonymized_userid>",15,538,15,"Mark Rutte (VVD)",0.135209851721538,0.00598324690865576,0
"<anonymized_userid>",13,551,16,"Mark Rutte (VVD)",0.13847700427243,0.00638213003589948,0
"<anonymized_userid>",13,564,17,"Mark Rutte (VVD)",0.141744156823322,0.0067810131631432,0
"<anonymized_userid>",13,577,18,"Mark Rutte (VVD)",0.145011309374215,0.00717989629038692,0
"<anonymized_userid>",13,590,19,"Mark Rutte (VVD)",0.148278461925107,0.00757877941763063,0
"<anonymized_userid>",13,603,20,"Mark Rutte (VVD)",0.151545614475999,0.00797766254487435,0
"<anonymized_userid>",13,616,21,"Mark Rutte (VVD)",0.154812767026891,0.00837654567211807,0
"<anonymized_userid>",13,629,22,"Mark Rutte (VVD)",0.158079919577783,0.00877542879936179,0
"<anonymized_userid>",12,641,23,"Mark Rutte (VVD)",0.161095752701684,0.00917431192660551,0
"<anonymized_userid>",12,653,24,"Mark Rutte (VVD)",0.164111585825584,0.00957319505384922,0
"<anonymized_userid>",12,665,25,"Mark Rutte (VVD)",0.167127418949485,0.00997207818109294,0
"<anonymized_userid>",11,676,26,"Mark Rutte (VVD)",0.169891932646394,0.0103709613083367,0
"<anonymized_userid>",11,687,27,"Mark Rutte (VVD)",0.172656446343302,0.0107698444355804,0
"<anonymized_userid>",11,698,28,"Mark Rutte (VVD)",0.175420960040211,0.0111687275628241,0
"<anonymized_userid>",10,708,29,"Mark Rutte (VVD)",0.177934154310128,0.0115676106900678,0
"<anonymized_userid>",10,718,30,"Mark Rutte (VVD)",0.180447348580045,0.0119664938173115,0
"<anonymized_userid>",10,728,31,"Mark Rutte (VVD)",0.182960542849962,0.0123653769445552,0
"<anonymized_userid>",10,738,32,"Mark Rutte (VVD)",0.185473737119879,0.012764260071799,0
"<anonymized_userid>",10,748,33,"Mark Rutte (VVD)",0.187986931389796,0.0131631431990427,0
"<anonymized_userid>",10,758,34,"Mark Rutte (VVD)",0.190500125659713,0.0135620263262864,0
"<anonymized_userid>",9,767,35,"Mark Rutte (VVD)",0.192762000502639,0.0139609094535301,0
"<anonymized_userid>",9,776,36,"Mark Rutte (VVD)",0.195023875345564,0.0143597925807738,0
"<anonymized_userid>",9,785,37,"Mark Rutte (VVD)",0.19728575018849,0.0147586757080176,0
"<anonymized_userid>",9,794,38,"Mark Rutte (VVD)",0.199547625031415,0.0151575588352613,0
"<anonymized_userid>",8,802,39,"Mark Rutte (VVD)",0.201558180447349,0.015556441962505,0
"<anonymized_userid>",8,810,40,"Mark Rutte (VVD)",0.203568735863282,0.0159553250897487,0
"<anonymized_userid>",8,818,41,"Mark Rutte (VVD)",0.205579291279216,0.0163542082169924,0
"<anonymized_userid>",8,826,42,"Mark Rutte (VVD)",0.20758984669515,0.0167530913442361,0
"<anonymized_userid>",8,834,43,"Mark Rutte (VVD)",0.209600402111083,0.0171519744714799,0
"<anonymized_userid>",8,842,44,"Mark Rutte (VVD)",0.211610957527017,0.0175508575987236,0
"<anonymized_userid>",7,849,45,"Mark Rutte (VVD)",0.213370193515959,0.0179497407259673,0
"<anonymized_userid>",7,856,46,"Mark Rutte (VVD)",0.215129429504901,0.018348623853211,0
"<anonymized_userid>",7,863,47,"Mark Rutte (VVD)",0.216888665493843,0.0187475069804547,0
"<anonymized_userid>",7,870,48,"Mark Rutte (VVD)",0.218647901482785,0.0191463901076984,0
"<anonymized_userid>",7,877,49,"Mark Rutte (VVD)",0.220407137471727,0.0195452732349422,0
"<anonymized_userid>",7,884,50,"Mark Rutte (VVD)",0.222166373460669,0.0199441563621859,0
"<anonymized_userid>",7,891,51,"Mark Rutte (VVD)",0.22392560944961,0.0203430394894296,0
"<anonymized_userid>",7,898,52,"Mark Rutte (VVD)",0.225684845438552,0.0207419226166733,0
"<anonymized_userid>",7,905,53,"Mark Rutte (VVD)",0.227444081427494,0.021140805743917,0
"<anonymized_userid>",6,911,54,"Mark Rutte (VVD)",0.228951997989445,0.0215396888711607,0
"<anonymized_userid>",6,917,55,"Mark Rutte (VVD)",0.230459914551395,0.0219385719984045,0
"<anonymized_userid>",6,923,56,"Mark Rutte (VVD)",0.231967831113345,0.0223374551256482,0
"<anonymized_userid>",6,929,57,"Mark Rutte (VVD)",0.233475747675295,0.0227363382528919,0
"<anonymized_userid>",6,935,58,"Mark Rutte (VVD)",0.234983664237246,0.0231352213801356,0
"<anonymized_userid>",6,941,59,"Mark Rutte (VVD)",0.236491580799196,0.0235341045073793,0
"<anonymized_userid>",6,947,60,"Mark Rutte (VVD)",0.237999497361146,0.0239329876346231,0
"<anonymized_userid>",6,953,61,"Mark Rutte (VVD)",0.239507413923096,0.0243318707618668,0
"<anonymized_userid>",6,959,62,"Mark Rutte (VVD)",0.241015330485047,0.0247307538891105,0
"<anonymized_userid>",6,965,63,"Mark Rutte (VVD)",0.242523247046997,0.0251296370163542,0
"<anonymized_userid>",6,971,64,"Mark Rutte (VVD)",0.244031163608947,0.0255285201435979,0
"<anonymized_userid>",6,977,65,"Mark Rutte (VVD)",0.245539080170897,0.0259274032708416,0
"<anonymized_userid>",6,983,66,"Mark Rutte (VVD)",0.247046996732847,0.0263262863980854,0
"<anonymized_userid>",6,989,67,"Mark Rutte (VVD)",0.248554913294798,0.0267251695253291,0
"<anonymized_userid>",6,995,68,"Mark Rutte (VVD)",0.250062829856748,0.0271240526525728,0
"<anonymized_userid>",5,1000,69,"Mark Rutte (VVD)",0.251319426991706,0.0275229357798165,0
"<anonymized_userid>",5,1005,70,"Mark Rutte (VVD)",0.252576024126665,0.0279218189070602,0
"<anonymized_userid>",5,1010,71,"Mark Rutte (VVD)",0.253832621261624,0.0283207020343039,0
"<anonymized_userid>",5,1015,72,"Mark Rutte (VVD)",0.255089218396582,0.0287195851615477,0
"<anonymized_userid>",5,1020,73,"Mark Rutte (VVD)",0.256345815531541,0.0291184682887914,0
"<anonymized_userid>",5,1025,74,"Mark Rutte (VVD)",0.257602412666499,0.0295173514160351,0
"<anonymized_userid>",5,1030,75,"Mark Rutte (VVD)",0.258859009801458,0.0299162345432788,0
"<anonymized_userid>",5,1035,76,"Mark Rutte (VVD)",0.260115606936416,0.0303151176705225,0
"<anonymized_userid>",5,1040,77,"Mark Rutte (VVD)",0.261372204071375,0.0307140007977663,0
"<anonymized_userid>",5,1045,78,"Mark Rutte (VVD)",0.262628801206333,0.03111288392501,0
"<anonymized_userid>",5,1050,79,"Mark Rutte (VVD)",0.263885398341292,0.0315117670522537,0
"<anonymized_userid>",5,1055,80,"Mark Rutte (VVD)",0.26514199547625,0.0319106501794974,0
"<anonymized_userid>",5,1060,81,"Mark Rutte (VVD)",0.266398592611209,0.0323095333067411,0
"<anonymized_userid>",5,1065,82,"Mark Rutte (VVD)",0.267655189746167,0.0327084164339848,0
"<anonymized_userid>",5,1070,83,"Mark Rutte (VVD)",0.268911786881126,0.0331072995612286,0
"<anonymized_userid>",5,1075,84,"Mark Rutte (VVD)",0.270168384016084,0.0335061826884723,0
"<anonymized_userid>",5,1080,85,"Mark Rutte (VVD)",0.271424981151043,0.033905065815716,0
"<anonymized_userid>",4,1084,86,"Mark Rutte (VVD)",0.27243025885901,0.0343039489429597,0
"<anonymized_userid>",4,1088,87,"Mark Rutte (VVD)",0.273435536566977,0.0347028320702034,0
"<anonymized_userid>",4,1092,88,"Mark Rutte (VVD)",0.274440814274943,0.0351017151974471,0
"<anonymized_userid>",4,1096,89,"Mark Rutte (VVD)",0.27544609198291,0.0355005983246909,0
"<anonymized_userid>",4,1100,90,"Mark Rutte (VVD)",0.276451369690877,0.0358994814519346,0
"<anonymized_userid>",4,1104,91,"Mark Rutte (VVD)",0.277456647398844,0.0362983645791783,0
"<anonymized_userid>",4,1108,92,"Mark Rutte (VVD)",0.278461925106811,0.036697247706422,0
"<anonymized_userid>",4,1112,93,"Mark Rutte (VVD)",0.279467202814778,0.0370961308336657,0
"<anonymized_userid>",4,1116,94,"Mark Rutte (VVD)",0.280472480522744,0.0374950139609095,0
"<anonymized_userid>",4,1120,95,"Mark Rutte (VVD)",0.281477758230711,0.0378938970881532,0
"<anonymized_userid>",4,1124,96,"Mark Rutte (VVD)",0.282483035938678,0.0382927802153969,0
"<anonymized_userid>",4,1128,97,"Mark Rutte (VVD)",0.283488313646645,0.0386916633426406,0
"<anonymized_userid>",4,1132,98,"Mark Rutte (VVD)",0.284493591354612,0.0390905464698843,0
"<anonymized_userid>",4,1136,99,"Mark Rutte (VVD)",0.285498869062579,0.039489429597128,0
"<anonymized_userid>",4,1140,100,"Mark Rutte (VVD)",0.286504146770545,0.0398883127243718,0
"<anonymized_userid>",4,1144,101,"Mark Rutte (VVD)",0.287509424478512,0.0402871958516155,0
"<anonymized_userid>",4,1148,102,"Mark Rutte (VVD)",0.288514702186479,0.0406860789788592,0
"<anonymized_userid>",4,1152,103,"Mark Rutte (VVD)",0.289519979894446,0.0410849621061029,0
"<anonymized_userid>",4,1156,104,"Mark Rutte (VVD)",0.290525257602413,0.0414838452333466,0
"<anonymized_userid>",4,1160,105,"Mark Rutte (VVD)",0.291530535310379,0.0418827283605904,0
"<anonymized_userid>",4,1164,106,"Mark Rutte (VVD)",0.292535813018346,0.0422816114878341,0
"<anonymized_userid>",4,1168,107,"Mark Rutte (VVD)",0.293541090726313,0.0426804946150778,0
"<anonymized_userid>",4,1172,108,"Mark Rutte (VVD)",0.29454636843428,0.0430793777423215,0
"<anonymized_userid>",4,1176,109,"Mark Rutte (VVD)",0.295551646142247,0.0434782608695652,0
"<anonymized_userid>",4,1180,110,"Mark Rutte (VVD)",0.296556923850214,0.0438771439968089,0
"<anonymized_userid>",4,1184,111,"Mark Rutte (VVD)",0.29756220155818,0.0442760271240527,0
"<anonymized_userid>",4,1188,112,"Mark Rutte (VVD)",0.298567479266147,0.0446749102512964,0
"<anonymized_userid>",4,1192,113,"Mark Rutte (VVD)",0.299572756974114,0.0450737933785401,0
"<anonymized_userid>",4,1196,114,"Mark Rutte (VVD)",0.300578034682081,0.0454726765057838,0
"<anonymized_userid>",4,1200,115,"Mark Rutte (VVD)",0.301583312390048,0.0458715596330275,0
"<anonymized_userid>",4,1204,116,"Mark Rutte (VVD)",0.302588590098015,0.0462704427602712,0
"<anonymized_userid>",4,1208,117,"Mark Rutte (VVD)",0.303593867805981,0.046669325887515,0
"<anonymized_userid>",3,1211,118,"Mark Rutte (VVD)",0.304347826086957,0.0470682090147587,0
"<anonymized_userid>",3,1214,119,"Mark Rutte (VVD)",0.305101784367932,0.0474670921420024,0
"<anonymized_userid>",3,1217,120,"Mark Rutte (VVD)",0.305855742648907,0.0478659752692461,0
"<anonymized_userid>",3,1220,121,"Mark Rutte (VVD)",0.306609700929882,0.0482648583964898,0
"<anonymized_userid>",3,1223,122,"Mark Rutte (VVD)",0.307363659210857,0.0486637415237335,0
"<anonymized_userid>",3,1226,123,"Mark Rutte (VVD)",0.308117617491832,0.0490626246509773,0
"<anonymized_userid>",3,1229,124,"Mark Rutte (VVD)",0.308871575772807,0.049461507778221,0
"<anonymized_userid>",3,1232,125,"Mark Rutte (VVD)",0.309625534053782,0.0498603909054647,0
"<anonymized_userid>",3,1235,126,"Mark Rutte (VVD)",0.310379492334757,0.0502592740327084,0
"<anonymized_userid>",3,1238,127,"Mark Rutte (VVD)",0.311133450615733,0.0506581571599521,0
"<anonymized_userid>",3,1241,128,"Mark Rutte (VVD)",0.311887408896708,0.0510570402871958,0
"<anonymized_userid>",3,1244,129,"Mark Rutte (VVD)",0.312641367177683,0.0514559234144396,0
"<anonymized_userid>",3,1247,130,"Mark Rutte (VVD)",0.313395325458658,0.0518548065416833,0
"<anonymized_userid>",3,1250,131,"Mark Rutte (VVD)",0.314149283739633,0.052253689668927,0
"<anonymized_userid>",3,1253,132,"Mark Rutte (VVD)",0.314903242020608,0.0526525727961707,0
"<anonymized_userid>",3,1256,133,"Mark Rutte (VVD)",0.315657200301583,0.0530514559234144,0
"<anonymized_userid>",3,1259,134,"Mark Rutte (VVD)",0.316411158582558,0.0534503390506582,0
"<anonymized_userid>",3,1262,135,"Mark Rutte (VVD)",0.317165116863534,0.0538492221779019,0
"<anonymized_userid>",3,1265,136,"Mark Rutte (VVD)",0.317919075144509,0.0542481053051456,0
"<anonymized_userid>",3,1268,137,"Mark Rutte (VVD)",0.318673033425484,0.0546469884323893,0
"<anonymized_userid>",3,1271,138,"Mark Rutte (VVD)",0.319426991706459,0.055045871559633,0
"<anonymized_userid>",3,1274,139,"Mark Rutte (VVD)",0.320180949987434,0.0554447546868767,0
"<anonymized_userid>",3,1277,140,"Mark Rutte (VVD)",0.320934908268409,0.0558436378141205,0
"<anonymized_userid>",3,1280,141,"Mark Rutte (VVD)",0.321688866549384,0.0562425209413642,0
"<anonymized_userid>",3,1283,142,"Mark Rutte (VVD)",0.322442824830359,0.0566414040686079,0
"<anonymized_userid>",3,1286,143,"Mark Rutte (VVD)",0.323196783111334,0.0570402871958516,0
"<anonymized_userid>",3,1289,144,"Mark Rutte (VVD)",0.32395074139231,0.0574391703230953,0
"<anonymized_userid>",3,1292,145,"Mark Rutte (VVD)",0.324704699673285,0.0578380534503391,0
"<anonymized_userid>",3,1295,146,"Mark Rutte (VVD)",0.32545865795426,0.0582369365775828,0
"<anonymized_userid>",3,1298,147,"Mark Rutte (VVD)",0.326212616235235,0.0586358197048265,0
"<anonymized_userid>",3,1301,148,"Mark Rutte (VVD)",0.32696657451621,0.0590347028320702,0
"<anonymized_userid>",3,1304,149,"Mark Rutte (VVD)",0.327720532797185,0.0594335859593139,0
"<anonymized_userid>",3,1307,150,"Mark Rutte (VVD)",0.32847449107816,0.0598324690865576,0
"<anonymized_userid>",3,1310,151,"Mark Rutte (VVD)",0.329228449359135,0.0602313522138014,0
"<anonymized_userid>",3,1313,152,"Mark Rutte (VVD)",0.329982407640111,0.0606302353410451,0
"<anonymized_userid>",3,1316,153,"Mark Rutte (VVD)",0.330736365921086,0.0610291184682888,0
"<anonymized_userid>",3,1319,154,"Mark Rutte (VVD)",0.331490324202061,0.0614280015955325,0
"<anonymized_userid>",3,1322,155,"Mark Rutte (VVD)",0.332244282483036,0.0618268847227762,0
"<anonymized_userid>",3,1325,156,"Mark Rutte (VVD)",0.332998240764011,0.0622257678500199,0
"<anonymized_userid>",3,1328,157,"Mark Rutte (VVD)",0.333752199044986,0.0626246509772637,0
"<anonymized_userid>",3,1331,158,"Mark Rutte (VVD)",0.334506157325961,0.0630235341045074,0
"<anonymized_userid>",3,1334,159,"Mark Rutte (VVD)",0.335260115606936,0.0634224172317511,0
"<anonymized_userid>",3,1337,160,"Mark Rutte (VVD)",0.336014073887912,0.0638213003589948,0
"<anonymized_userid>",3,1340,161,"Mark Rutte (VVD)",0.336768032168887,0.0642201834862385,0
"<anonymized_userid>",3,1343,162,"Mark Rutte (VVD)",0.337521990449862,0.0646190666134823,0
"<anonymized_userid>",3,1346,163,"Mark Rutte (VVD)",0.338275948730837,0.065017949740726,0
"<anonymized_userid>",3,1349,164,"Mark Rutte (VVD)",0.339029907011812,0.0654168328679697,0
"<anonymized_userid>",3,1352,165,"Mark Rutte (VVD)",0.339783865292787,0.0658157159952134,0
"<anonymized_userid>",3,1355,166,"Mark Rutte (VVD)",0.340537823573762,0.0662145991224571,0
"<anonymized_userid>",3,1358,167,"Mark Rutte (VVD)",0.341291781854737,0.0666134822497008,0
"<anonymized_userid>",3,1361,168,"Mark Rutte (VVD)",0.342045740135712,0.0670123653769445,0
"<anonymized_userid>",3,1364,169,"Mark Rutte (VVD)",0.342799698416688,0.0674112485041883,0
"<anonymized_userid>",3,1367,170,"Mark Rutte (VVD)",0.343553656697663,0.067810131631432,0
"<anonymized_userid>",3,1370,171,"Mark Rutte (VVD)",0.344307614978638,0.0682090147586757,0
"<anonymized_userid>",3,1373,172,"Mark Rutte (VVD)",0.345061573259613,0.0686078978859194,0
"<anonymized_userid>",3,1376,173,"Mark Rutte (VVD)",0.345815531540588,0.0690067810131631,0
"<anonymized_userid>",3,1379,174,"Mark Rutte (VVD)",0.346569489821563,0.0694056641404069,0
"<anonymized_userid>",3,1382,175,"Mark Rutte (VVD)",0.347323448102538,0.0698045472676506,0
"<anonymized_userid>",3,1385,176,"Mark Rutte (VVD)",0.348077406383513,0.0702034303948943,0
"<anonymized_userid>",3,1388,177,"Mark Rutte (VVD)",0.348831364664489,0.070602313522138,0
"<anonymized_userid>",3,1391,178,"Mark Rutte (VVD)",0.349585322945464,0.0710011966493817,0
"<anonymized_userid>",3,1394,179,"Mark Rutte (VVD)",0.350339281226439,0.0714000797766254,0
"<anonymized_userid>",3,1397,180,"Mark Rutte (VVD)",0.351093239507414,0.0717989629038692,0
"<anonymized_userid>",3,1400,181,"Mark Rutte (VVD)",0.351847197788389,0.0721978460311129,0
"<anonymized_userid>",3,1403,182,"Mark Rutte (VVD)",0.352601156069364,0.0725967291583566,0
"<anonymized_userid>",3,1406,183,"Mark Rutte (VVD)",0.353355114350339,0.0729956122856003,0
"<anonymized_userid>",3,1409,184,"Mark Rutte (VVD)",0.354109072631314,0.073394495412844,0
"<anonymized_userid>",3,1412,185,"Mark Rutte (VVD)",0.35486303091229,0.0737933785400878,0
"<anonymized_userid>",3,1415,186,"Mark Rutte (VVD)",0.355616989193265,0.0741922616673315,0
"<anonymized_userid>",3,1418,187,"Mark Rutte (VVD)",0.35637094747424,0.0745911447945752,0
"<anonymized_userid>",3,1421,188,"Mark Rutte (VVD)",0.357124905755215,0.0749900279218189,0
"<anonymized_userid>",3,1424,189,"Mark Rutte (VVD)",0.35787886403619,0.0753889110490626,0
"<anonymized_userid>",3,1427,190,"Mark Rutte (VVD)",0.358632822317165,0.0757877941763063,0
"<anonymized_userid>",3,1430,191,"Mark Rutte (VVD)",0.35938678059814,0.0761866773035501,0
"<anonymized_userid>",3,1433,192,"Mark Rutte (VVD)",0.360140738879115,0.0765855604307938,0
"<anonymized_userid>",3,1436,193,"Mark Rutte (VVD)",0.36089469716009,0.0769844435580375,0
"<anonymized_userid>",3,1439,194,"Mark Rutte (VVD)",0.361648655441066,0.0773833266852812,0
"<anonymized_userid>",3,1442,195,"Mark Rutte (VVD)",0.362402613722041,0.0777822098125249,0
"<anonymized_userid>",3,1445,196,"Mark Rutte (VVD)",0.363156572003016,0.0781810929397686,0
"<anonymized_userid>",3,1448,197,"Mark Rutte (VVD)",0.363910530283991,0.0785799760670124,0
"<anonymized_userid>",2,1450,198,"Mark Rutte (VVD)",0.364413169137974,0.0789788591942561,0
"<anonymized_userid>",2,1452,199,"Mark Rutte (VVD)",0.364915807991958,0.0793777423214998,0
"<anonymized_userid>",2,1454,200,"Mark Rutte (VVD)",0.365418446845941,0.0797766254487435,0
"<anonymized_userid>",2,1456,201,"Mark Rutte (VVD)",0.365921085699925,0.0801755085759872,0
"<anonymized_userid>",2,1458,202,"Mark Rutte (VVD)",0.366423724553908,0.080574391703231,0
"<anonymized_userid>",2,1460,203,"Mark Rutte (VVD)",0.366926363407891,0.0809732748304747,0
"<anonymized_userid>",2,1462,204,"Mark Rutte (VVD)",0.367429002261875,0.0813721579577184,0
"<anonymized_userid>",2,1464,205,"Mark Rutte (VVD)",0.367931641115858,0.0817710410849621,0
"<anonymized_userid>",2,1466,206,"Mark Rutte (VVD)",0.368434279969842,0.0821699242122058,0
"<anonymized_userid>",2,1468,207,"Mark Rutte (VVD)",0.368936918823825,0.0825688073394495,0
"<anonymized_userid>",2,1470,208,"Mark Rutte (VVD)",0.369439557677809,0.0829676904666933,0
"<anonymized_userid>",2,1472,209,"Mark Rutte (VVD)",0.369942196531792,0.083366573593937,0
"<anonymized_userid>",2,1474,210,"Mark Rutte (VVD)",0.370444835385775,0.0837654567211807,0
"<anonymized_userid>",2,1476,211,"Mark Rutte (VVD)",0.370947474239759,0.0841643398484244,0
"<anonymized_userid>",2,1478,212,"Mark Rutte (VVD)",0.371450113093742,0.0845632229756681,0
"<anonymized_userid>",2,1480,213,"Mark Rutte (VVD)",0.371952751947726,0.0849621061029118,0
"<anonymized_userid>",2,1482,214,"Mark Rutte (VVD)",0.372455390801709,0.0853609892301556,0
"<anonymized_userid>",2,1484,215,"Mark Rutte (VVD)",0.372958029655692,0.0857598723573993,0
"<anonymized_userid>",2,1486,216,"Mark Rutte (VVD)",0.373460668509676,0.086158755484643,0
"<anonymized_userid>",2,1488,217,"Mark Rutte (VVD)",0.373963307363659,0.0865576386118867,0
"<anonymized_userid>",2,1490,218,"Mark Rutte (VVD)",0.374465946217643,0.0869565217391304,0
"<anonymized_userid>",2,1492,219,"Mark Rutte (VVD)",0.374968585071626,0.0873554048663742,0
"<anonymized_userid>",2,1494,220,"Mark Rutte (VVD)",0.375471223925609,0.0877542879936179,0
"<anonymized_userid>",2,1496,221,"Mark Rutte (VVD)",0.375973862779593,0.0881531711208616,0
"<anonymized_userid>",2,1498,222,"Mark Rutte (VVD)",0.376476501633576,0.0885520542481053,0
"<anonymized_userid>",2,1500,223,"Mark Rutte (VVD)",0.37697914048756,0.088950937375349,0
"<anonymized_userid>",2,1502,224,"Mark Rutte (VVD)",0.377481779341543,0.0893498205025927,0
"<anonymized_userid>",2,1504,225,"Mark Rutte (VVD)",0.377984418195527,0.0897487036298365,0
"<anonymized_userid>",2,1506,226,"Mark Rutte (VVD)",0.37848705704951,0.0901475867570802,0
"<anonymized_userid>",2,1508,227,"Mark Rutte (VVD)",0.378989695903493,0.0905464698843239,0
"<anonymized_userid>",2,1510,228,"Mark Rutte (VVD)",0.379492334757477,0.0909453530115676,0
"<anonymized_userid>",2,1512,229,"Mark Rutte (VVD)",0.37999497361146,0.0913442361388113,0
"<anonymized_userid>",2,1514,230,"Mark Rutte (VVD)",0.380497612465444,0.0917431192660551,0
"<anonymized_userid>",2,1516,231,"Mark Rutte (VVD)",0.381000251319427,0.0921420023932988,0
"<anonymized_userid>",2,1518,232,"Mark Rutte (VVD)",0.38150289017341,0.0925408855205425,0
"<anonymized_userid>",2,1520,233,"Mark Rutte (VVD)",0.382005529027394,0.0929397686477862,0
"<anonymized_userid>",2,1522,234,"Mark Rutte (VVD)",0.382508167881377,0.0933386517750299,0
"<anonymized_userid>",2,1524,235,"Mark Rutte (VVD)",0.383010806735361,0.0937375349022736,0
"<anonymized_userid>",2,1526,236,"Mark Rutte (VVD)",0.383513445589344,0.0941364180295173,0
"<anonymized_userid>",2,1528,237,"Mark Rutte (VVD)",0.384016084443327,0.0945353011567611,0
"<anonymized_userid>",2,1530,238,"Mark Rutte (VVD)",0.384518723297311,0.0949341842840048,0
"<anonymized_userid>",2,1532,239,"Mark Rutte (VVD)",0.385021362151294,0.0953330674112485,0
"<anonymized_userid>",2,1534,240,"Mark Rutte (VVD)",0.385524001005278,0.0957319505384922,0
"<anonymized_userid>",2,1536,241,"Mark Rutte (VVD)",0.386026639859261,0.0961308336657359,0
"<anonymized_userid>",2,1538,242,"Mark Rutte (VVD)",0.386529278713245,0.0965297167929797,0
"<anonymized_userid>",2,1540,243,"Mark Rutte (VVD)",0.387031917567228,0.0969285999202234,0
"<anonymized_userid>",2,1542,244,"Mark Rutte (VVD)",0.387534556421211,0.0973274830474671,0
"<anonymized_userid>",2,1544,245,"Mark Rutte (VVD)",0.388037195275195,0.0977263661747108,0
"<anonymized_userid>",2,1546,246,"Mark Rutte (VVD)",0.388539834129178,0.0981252493019545,0
"<anonymized_userid>",2,1548,247,"Mark Rutte (VVD)",0.389042472983162,0.0985241324291982,0
"<anonymized_userid>",2,1550,248,"Mark Rutte (VVD)",0.389545111837145,0.098923015556442,0
"<anonymized_userid>",2,1552,249,"Mark Rutte (VVD)",0.390047750691128,0.0993218986836857,0
"<anonymized_userid>",2,1554,250,"Mark Rutte (VVD)",0.390550389545112,0.0997207818109294,0
"<anonymized_userid>",2,1556,251,"Mark Rutte (VVD)",0.391053028399095,0.100119664938173,0
"<anonymized_userid>",2,1558,252,"Mark Rutte (VVD)",0.391555667253079,0.100518548065417,0
"<anonymized_userid>",2,1560,253,"Mark Rutte (VVD)",0.392058306107062,0.100917431192661,0
"<anonymized_userid>",2,1562,254,"Mark Rutte (VVD)",0.392560944961045,0.101316314319904,0
"<anonymized_userid>",2,1564,255,"Mark Rutte (VVD)",0.393063583815029,0.101715197447148,0
"<anonymized_userid>",2,1566,256,"Mark Rutte (VVD)",0.393566222669012,0.102114080574392,0
"<anonymized_userid>",2,1568,257,"Mark Rutte (VVD)",0.394068861522996,0.102512963701635,0
"<anonymized_userid>",2,1570,258,"Mark Rutte (VVD)",0.394571500376979,0.102911846828879,0
"<anonymized_userid>",2,1572,259,"Mark Rutte (VVD)",0.395074139230963,0.103310729956123,0
"<anonymized_userid>",2,1574,260,"Mark Rutte (VVD)",0.395576778084946,0.103709613083367,0
"<anonymized_userid>",2,1576,261,"Mark Rutte (VVD)",0.396079416938929,0.10410849621061,0
"<anonymized_userid>",2,1578,262,"Mark Rutte (VVD)",0.396582055792913,0.104507379337854,0
"<anonymized_userid>",2,1580,263,"Mark Rutte (VVD)",0.397084694646896,0.104906262465098,0
"<anonymized_userid>",2,1582,264,"Mark Rutte (VVD)",0.39758733350088,0.105305145592341,0
"<anonymized_userid>",2,1584,265,"Mark Rutte (VVD)",0.398089972354863,0.105704028719585,0
"<anonymized_userid>",2,1586,266,"Mark Rutte (VVD)",0.398592611208846,0.106102911846829,0
"<anonymized_userid>",2,1588,267,"Mark Rutte (VVD)",0.39909525006283,0.106501794974073,0
"<anonymized_userid>",2,1590,268,"Mark Rutte (VVD)",0.399597888916813,0.106900678101316,0
"<anonymized_userid>",2,1592,269,"Mark Rutte (VVD)",0.400100527770797,0.10729956122856,0
"<anonymized_userid>",2,1594,270,"Mark Rutte (VVD)",0.40060316662478,0.107698444355804,0
"<anonymized_userid>",2,1596,271,"Mark Rutte (VVD)",0.401105805478764,0.108097327483047,0
"<anonymized_userid>",2,1598,272,"Mark Rutte (VVD)",0.401608444332747,0.108496210610291,0
"<anonymized_userid>",2,1600,273,"Mark Rutte (VVD)",0.40211108318673,0.108895093737535,0
"<anonymized_userid>",2,1602,274,"Mark Rutte (VVD)",0.402613722040714,0.109293976864779,0
"<anonymized_userid>",2,1604,275,"Mark Rutte (VVD)",0.403116360894697,0.109692859992022,0
"<anonymized_userid>",2,1606,276,"Mark Rutte (VVD)",0.403618999748681,0.110091743119266,0
"<anonymized_userid>",2,1608,277,"Mark Rutte (VVD)",0.404121638602664,0.11049062624651,0
"<anonymized_userid>",2,1610,278,"Mark Rutte (VVD)",0.404624277456647,0.110889509373753,0
"<anonymized_userid>",2,1612,279,"Mark Rutte (VVD)",0.405126916310631,0.111288392500997,0
"<anonymized_userid>",2,1614,280,"Mark Rutte (VVD)",0.405629555164614,0.111687275628241,0
"<anonymized_userid>",2,1616,281,"Mark Rutte (VVD)",0.406132194018598,0.112086158755485,0
"<anonymized_userid>",2,1618,282,"Mark Rutte (VVD)",0.406634832872581,0.112485041882728,0
"<anonymized_userid>",2,1620,283,"Mark Rutte (VVD)",0.407137471726564,0.112883925009972,0
"<anonymized_userid>",2,1622,284,"Mark Rutte (VVD)",0.407640110580548,0.113282808137216,0
"<anonymized_userid>",2,1624,285,"Mark Rutte (VVD)",0.408142749434531,0.11368169126446,0
"<anonymized_userid>",2,1626,286,"Mark Rutte (VVD)",0.408645388288515,0.114080574391703,0
"<anonymized_userid>",2,1628,287,"Mark Rutte (VVD)",0.409148027142498,0.114479457518947,0
"<anonymized_userid>",2,1630,288,"Mark Rutte (VVD)",0.409650665996482,0.114878340646191,0
"<anonymized_userid>",2,1632,289,"Mark Rutte (VVD)",0.410153304850465,0.115277223773434,0
"<anonymized_userid>",2,1634,290,"Mark Rutte (VVD)",0.410655943704448,0.115676106900678,0
"<anonymized_userid>",2,1636,291,"Mark Rutte (VVD)",0.411158582558432,0.116074990027922,0
"<anonymized_userid>",2,1638,292,"Mark Rutte (VVD)",0.411661221412415,0.116473873155166,0
"<anonymized_userid>",2,1640,293,"Mark Rutte (VVD)",0.412163860266399,0.116872756282409,0
"<anonymized_userid>",2,1642,294,"Mark Rutte (VVD)",0.412666499120382,0.117271639409653,0
"<anonymized_userid>",2,1644,295,"Mark Rutte (VVD)",0.413169137974365,0.117670522536897,0
"<anonymized_userid>",2,1646,296,"Mark Rutte (VVD)",0.413671776828349,0.11806940566414,0
"<anonymized_userid>",2,1648,297,"Mark Rutte (VVD)",0.414174415682332,0.118468288791384,0
"<anonymized_userid>",2,1650,298,"Mark Rutte (VVD)",0.414677054536316,0.118867171918628,0
"<anonymized_userid>",2,1652,299,"Mark Rutte (VVD)",0.415179693390299,0.119266055045872,0
"<anonymized_userid>",2,1654,300,"Mark Rutte (VVD)",0.415682332244282,0.119664938173115,0
"<anonymized_userid>",2,1656,301,"Mark Rutte (VVD)",0.416184971098266,0.120063821300359,0
"<anonymized_userid>",2,1658,302,"Mark Rutte (VVD)",0.416687609952249,0.120462704427603,0
"<anonymized_userid>",2,1660,303,"Mark Rutte (VVD)",0.417190248806233,0.120861587554846,0
"<anonymized_userid>",2,1662,304,"Mark Rutte (VVD)",0.417692887660216,0.12126047068209,0
"<anonymized_userid>",2,1664,305,"Mark Rutte (VVD)",0.4181955265142,0.121659353809334,0
"<anonymized_userid>",2,1666,306,"Mark Rutte (VVD)",0.418698165368183,0.122058236936578,0
"<anonymized_userid>",2,1668,307,"Mark Rutte (VVD)",0.419200804222166,0.122457120063821,0
"<anonymized_userid>",2,1670,308,"Mark Rutte (VVD)",0.41970344307615,0.122856003191065,0
"<anonymized_userid>",2,1672,309,"Mark Rutte (VVD)",0.420206081930133,0.123254886318309,0
"<anonymized_userid>",2,1674,310,"Mark Rutte (VVD)",0.420708720784117,0.123653769445552,0
"<anonymized_userid>",2,1676,311,"Mark Rutte (VVD)",0.4212113596381,0.124052652572796,0
"<anonymized_userid>",2,1678,312,"Mark Rutte (VVD)",0.421713998492083,0.12445153570004,0
"<anonymized_userid>",2,1680,313,"Mark Rutte (VVD)",0.422216637346067,0.124850418827284,0
"<anonymized_userid>",2,1682,314,"Mark Rutte (VVD)",0.42271927620005,0.125249301954527,0
"<anonymized_userid>",2,1684,315,"Mark Rutte (VVD)",0.423221915054034,0.125648185081771,0
"<anonymized_userid>",2,1686,316,"Mark Rutte (VVD)",0.423724553908017,0.126047068209015,0
"<anonymized_userid>",2,1688,317,"Mark Rutte (VVD)",0.424227192762,0.126445951336258,0
"<anonymized_userid>",2,1690,318,"Mark Rutte (VVD)",0.424729831615984,0.126844834463502,0
"<anonymized_userid>",2,1692,319,"Mark Rutte (VVD)",0.425232470469967,0.127243717590746,0
"<anonymized_userid>",2,1694,320,"Mark Rutte (VVD)",0.425735109323951,0.12764260071799,0
"<anonymized_userid>",2,1696,321,"Mark Rutte (VVD)",0.426237748177934,0.128041483845233,0
"<anonymized_userid>",2,1698,322,"Mark Rutte (VVD)",0.426740387031918,0.128440366972477,0
"<anonymized_userid>",2,1700,323,"Mark Rutte (VVD)",0.427243025885901,0.128839250099721,0
"<anonymized_userid>",2,1702,324,"Mark Rutte (VVD)",0.427745664739884,0.129238133226965,0
"<anonymized_userid>",2,1704,325,"Mark Rutte (VVD)",0.428248303593868,0.129637016354208,0
"<anonymized_userid>",2,1706,326,"Mark Rutte (VVD)",0.428750942447851,0.130035899481452,0
"<anonymized_userid>",2,1708,327,"Mark Rutte (VVD)",0.429253581301835,0.130434782608696,0
"<anonymized_userid>",2,1710,328,"Mark Rutte (VVD)",0.429756220155818,0.130833665735939,0
"<anonymized_userid>",2,1712,329,"Mark Rutte (VVD)",0.430258859009801,0.131232548863183,0
"<anonymized_userid>",2,1714,330,"Mark Rutte (VVD)",0.430761497863785,0.131631431990427,0
"<anonymized_userid>",2,1716,331,"Mark Rutte (VVD)",0.431264136717768,0.132030315117671,0
"<anonymized_userid>",2,1718,332,"Mark Rutte (VVD)",0.431766775571752,0.132429198244914,0
"<anonymized_userid>",2,1720,333,"Mark Rutte (VVD)",0.432269414425735,0.132828081372158,0
"<anonymized_userid>",2,1722,334,"Mark Rutte (VVD)",0.432772053279719,0.133226964499402,0
"<anonymized_userid>",2,1724,335,"Mark Rutte (VVD)",0.433274692133702,0.133625847626645,0
"<anonymized_userid>",2,1726,336,"Mark Rutte (VVD)",0.433777330987685,0.134024730753889,0
"<anonymized_userid>",2,1728,337,"Mark Rutte (VVD)",0.434279969841669,0.134423613881133,0
"<anonymized_userid>",2,1730,338,"Mark Rutte (VVD)",0.434782608695652,0.134822497008377,0
"<anonymized_userid>",2,1732,339,"Mark Rutte (VVD)",0.435285247549636,0.13522138013562,0
"<anonymized_userid>",2,1734,340,"Mark Rutte (VVD)",0.435787886403619,0.135620263262864,0
"<anonymized_userid>",2,1736,341,"Mark Rutte (VVD)",0.436290525257602,0.136019146390108,0
"<anonymized_userid>",2,1738,342,"Mark Rutte (VVD)",0.436793164111586,0.136418029517351,0
"<anonymized_userid>",2,1740,343,"Mark Rutte (VVD)",0.437295802965569,0.136816912644595,0
"<anonymized_userid>",2,1742,344,"Mark Rutte (VVD)",0.437798441819553,0.137215795771839,0
"<anonymized_userid>",2,1744,345,"Mark Rutte (VVD)",0.438301080673536,0.137614678899083,0
"<anonymized_userid>",2,1746,346,"Mark Rutte (VVD)",0.438803719527519,0.138013562026326,0
"<anonymized_userid>",2,1748,347,"Mark Rutte (VVD)",0.439306358381503,0.13841244515357,0
"<anonymized_userid>",2,1750,348,"Mark Rutte (VVD)",0.439808997235486,0.138811328280814,0
"<anonymized_userid>",2,1752,349,"Mark Rutte (VVD)",0.44031163608947,0.139210211408057,0
"<anonymized_userid>",2,1754,350,"Mark Rutte (VVD)",0.440814274943453,0.139609094535301,0
"<anonymized_userid>",2,1756,351,"Mark Rutte (VVD)",0.441316913797437,0.140007977662545,0
"<anonymized_userid>",2,1758,352,"Mark Rutte (VVD)",0.44181955265142,0.140406860789789,0
"<anonymized_userid>",2,1760,353,"Mark Rutte (VVD)",0.442322191505403,0.140805743917032,0
"<anonymized_userid>",2,1762,354,"Mark Rutte (VVD)",0.442824830359387,0.141204627044276,0
"<anonymized_userid>",2,1764,355,"Mark Rutte (VVD)",0.44332746921337,0.14160351017152,0
"<anonymized_userid>",2,1766,356,"Mark Rutte (VVD)",0.443830108067354,0.142002393298763,0
"<anonymized_userid>",2,1768,357,"Mark Rutte (VVD)",0.444332746921337,0.142401276426007,0
"<anonymized_userid>",2,1770,358,"Mark Rutte (VVD)",0.44483538577532,0.142800159553251,0
"<anonymized_userid>",2,1772,359,"Mark Rutte (VVD)",0.445338024629304,0.143199042680495,0
"<anonymized_userid>",2,1774,360,"Mark Rutte (VVD)",0.445840663483287,0.143597925807738,0
"<anonymized_userid>",2,1776,361,"Mark Rutte (VVD)",0.446343302337271,0.143996808934982,0
"<anonymized_userid>",2,1778,362,"Mark Rutte (VVD)",0.446845941191254,0.144395692062226,0
"<anonymized_userid>",2,1780,363,"Mark Rutte (VVD)",0.447348580045237,0.144794575189469,0
"<anonymized_userid>",2,1782,364,"Mark Rutte (VVD)",0.447851218899221,0.145193458316713,0
"<anonymized_userid>",2,1784,365,"Mark Rutte (VVD)",0.448353857753204,0.145592341443957,0
"<anonymized_userid>",2,1786,366,"Mark Rutte (VVD)",0.448856496607188,0.145991224571201,0
"<anonymized_userid>",2,1788,367,"Mark Rutte (VVD)",0.449359135461171,0.146390107698444,0
"<anonymized_userid>",2,1790,368,"Mark Rutte (VVD)",0.449861774315155,0.146788990825688,0
"<anonymized_userid>",2,1792,369,"Mark Rutte (VVD)",0.450364413169138,0.147187873952932,0
"<anonymized_userid>",2,1794,370,"Mark Rutte (VVD)",0.450867052023121,0.147586757080176,0
"<anonymized_userid>",2,1796,371,"Mark Rutte (VVD)",0.451369690877105,0.147985640207419,0
"<anonymized_userid>",2,1798,372,"Mark Rutte (VVD)",0.451872329731088,0.148384523334663,0
"<anonymized_userid>",2,1800,373,"Mark Rutte (VVD)",0.452374968585072,0.148783406461907,0
"<anonymized_userid>",2,1802,374,"Mark Rutte (VVD)",0.452877607439055,0.14918228958915,0
"<anonymized_userid>",2,1804,375,"Mark Rutte (VVD)",0.453380246293038,0.149581172716394,0
"<anonymized_userid>",2,1806,376,"Mark Rutte (VVD)",0.453882885147022,0.149980055843638,0
"<anonymized_userid>",2,1808,377,"Mark Rutte (VVD)",0.454385524001005,0.150378938970882,0
"<anonymized_userid>",2,1810,378,"Mark Rutte (VVD)",0.454888162854989,0.150777822098125,0
"<anonymized_userid>",2,1812,379,"Mark Rutte (VVD)",0.455390801708972,0.151176705225369,0
"<anonymized_userid>",2,1814,380,"Mark Rutte (VVD)",0.455893440562955,0.151575588352613,0
"<anonymized_userid>",2,1816,381,"Mark Rutte (VVD)",0.456396079416939,0.151974471479856,0
"<anonymized_userid>",2,1818,382,"Mark Rutte (VVD)",0.456898718270922,0.1523733546071,0
"<anonymized_userid>",2,1820,383,"Mark Rutte (VVD)",0.457401357124906,0.152772237734344,0
"<anonymized_userid>",2,1822,384,"Mark Rutte (VVD)",0.457903995978889,0.153171120861588,0
"<anonymized_userid>",2,1824,385,"Mark Rutte (VVD)",0.458406634832873,0.153570003988831,0
"<anonymized_userid>",2,1826,386,"Mark Rutte (VVD)",0.458909273686856,0.153968887116075,0
"<anonymized_userid>",2,1828,387,"Mark Rutte (VVD)",0.459411912540839,0.154367770243319,0
"<anonymized_userid>",2,1830,388,"Mark Rutte (VVD)",0.459914551394823,0.154766653370562,0
"<anonymized_userid>",2,1832,389,"Mark Rutte (VVD)",0.460417190248806,0.155165536497806,0
"<anonymized_userid>",2,1834,390,"Mark Rutte (VVD)",0.46091982910279,0.15556441962505,0
"<anonymized_userid>",2,1836,391,"Mark Rutte (VVD)",0.461422467956773,0.155963302752294,0
"<anonymized_userid>",2,1838,392,"Mark Rutte (VVD)",0.461925106810756,0.156362185879537,0
"<anonymized_userid>",2,1840,393,"Mark Rutte (VVD)",0.46242774566474,0.156761069006781,0
"<anonymized_userid>",2,1842,394,"Mark Rutte (VVD)",0.462930384518723,0.157159952134025,0
"<anonymized_userid>",2,1844,395,"Mark Rutte (VVD)",0.463433023372707,0.157558835261268,0
"<anonymized_userid>",2,1846,396,"Mark Rutte (VVD)",0.46393566222669,0.157957718388512,0
"<anonymized_userid>",2,1848,397,"Mark Rutte (VVD)",0.464438301080674,0.158356601515756,0
"<anonymized_userid>",2,1850,398,"Mark Rutte (VVD)",0.464940939934657,0.158755484643,0
"<anonymized_userid>",2,1852,399,"Mark Rutte (VVD)",0.46544357878864,0.159154367770243,0
"<anonymized_userid>",2,1854,400,"Mark Rutte (VVD)",0.465946217642624,0.159553250897487,0
"<anonymized_userid>",2,1856,401,"Mark Rutte (VVD)",0.466448856496607,0.159952134024731,0
"<anonymized_userid>",2,1858,402,"Mark Rutte (VVD)",0.466951495350591,0.160351017151974,0
"<anonymized_userid>",2,1860,403,"Mark Rutte (VVD)",0.467454134204574,0.160749900279218,0
"<anonymized_userid>",2,1862,404,"Mark Rutte (VVD)",0.467956773058557,0.161148783406462,0
"<anonymized_userid>",2,1864,405,"Mark Rutte (VVD)",0.468459411912541,0.161547666533706,0
"<anonymized_userid>",2,1866,406,"Mark Rutte (VVD)",0.468962050766524,0.161946549660949,0
"<anonymized_userid>",2,1868,407,"Mark Rutte (VVD)",0.469464689620508,0.162345432788193,0
"<anonymized_userid>",2,1870,408,"Mark Rutte (VVD)",0.469967328474491,0.162744315915437,0
"<anonymized_userid>",2,1872,409,"Mark Rutte (VVD)",0.470469967328475,0.16314319904268,0
"<anonymized_userid>",2,1874,410,"Mark Rutte (VVD)",0.470972606182458,0.163542082169924,0
"<anonymized_userid>",2,1876,411,"Mark Rutte (VVD)",0.471475245036441,0.163940965297168,0
"<anonymized_userid>",2,1878,412,"Mark Rutte (VVD)",0.471977883890425,0.164339848424412,0
"<anonymized_userid>",2,1880,413,"Mark Rutte (VVD)",0.472480522744408,0.164738731551655,0
"<anonymized_userid>",2,1882,414,"Mark Rutte (VVD)",0.472983161598392,0.165137614678899,0
"<anonymized_userid>",2,1884,415,"Mark Rutte (VVD)",0.473485800452375,0.165536497806143,0
"<anonymized_userid>",2,1886,416,"Mark Rutte (VVD)",0.473988439306358,0.165935380933387,0
"<anonymized_userid>",2,1888,417,"Mark Rutte (VVD)",0.474491078160342,0.16633426406063,0
"<anonymized_userid>",2,1890,418,"Mark Rutte (VVD)",0.474993717014325,0.166733147187874,0
"<anonymized_userid>",1,1891,419,"Mark Rutte (VVD)",0.475245036441317,0.167132030315118,0
"<anonymized_userid>",1,1892,420,"Mark Rutte (VVD)",0.475496355868309,0.167530913442361,0
"<anonymized_userid>",1,1893,421,"Mark Rutte (VVD)",0.4757476752953,0.167929796569605,0
"<anonymized_userid>",1,1894,422,"Mark Rutte (VVD)",0.475998994722292,0.168328679696849,0
"<anonymized_userid>",1,1895,423,"Mark Rutte (VVD)",0.476250314149284,0.168727562824093,0
"<anonymized_userid>",1,1896,424,"Mark Rutte (VVD)",0.476501633576275,0.169126445951336,0
"<anonymized_userid>",1,1897,425,"Mark Rutte (VVD)",0.476752953003267,0.16952532907858,0
"<anonymized_userid>",1,1898,426,"Mark Rutte (VVD)",0.477004272430259,0.169924212205824,0
"<anonymized_userid>",1,1899,427,"Mark Rutte (VVD)",0.477255591857251,0.170323095333067,0
"<anonymized_userid>",1,1900,428,"Mark Rutte (VVD)",0.477506911284242,0.170721978460311,0
"<anonymized_userid>",1,1901,429,"Mark Rutte (VVD)",0.477758230711234,0.171120861587555,0
"<anonymized_userid>",1,1902,430,"Mark Rutte (VVD)",0.478009550138226,0.171519744714799,0
"<anonymized_userid>",1,1903,431,"Mark Rutte (VVD)",0.478260869565217,0.171918627842042,0
"<anonymized_userid>",1,1904,432,"Mark Rutte (VVD)",0.478512188992209,0.172317510969286,0
"<anonymized_userid>",1,1905,433,"Mark Rutte (VVD)",0.478763508419201,0.17271639409653,0
"<anonymized_userid>",1,1906,434,"Mark Rutte (VVD)",0.479014827846193,0.173115277223773,0
"<anonymized_userid>",1,1907,435,"Mark Rutte (VVD)",0.479266147273184,0.173514160351017,0
"<anonymized_userid>",1,1908,436,"Mark Rutte (VVD)",0.479517466700176,0.173913043478261,0
"<anonymized_userid>",1,1909,437,"Mark Rutte (VVD)",0.479768786127168,0.174311926605505,0
"<anonymized_userid>",1,1910,438,"Mark Rutte (VVD)",0.480020105554159,0.174710809732748,0
"<anonymized_userid>",1,1911,439,"Mark Rutte (VVD)",0.480271424981151,0.175109692859992,0
"<anonymized_userid>",1,1912,440,"Mark Rutte (VVD)",0.480522744408143,0.175508575987236,0
"<anonymized_userid>",1,1913,441,"Mark Rutte (VVD)",0.480774063835134,0.175907459114479,0
"<anonymized_userid>",1,1914,442,"Mark Rutte (VVD)",0.481025383262126,0.176306342241723,0
"<anonymized_userid>",1,1915,443,"Mark Rutte (VVD)",0.481276702689118,0.176705225368967,0
"<anonymized_userid>",1,1916,444,"Mark Rutte (VVD)",0.48152802211611,0.177104108496211,0
"<anonymized_userid>",1,1917,445,"Mark Rutte (VVD)",0.481779341543101,0.177502991623454,0
"<anonymized_userid>",1,1918,446,"Mark Rutte (VVD)",0.482030660970093,0.177901874750698,0
"<anonymized_userid>",1,1919,447,"Mark Rutte (VVD)",0.482281980397085,0.178300757877942,0
"<anonymized_userid>",1,1920,448,"Mark Rutte (VVD)",0.482533299824076,0.178699641005185,0
"<anonymized_userid>",1,1921,449,"Mark Rutte (VVD)",0.482784619251068,0.179098524132429,0
"<anonymized_userid>",1,1922,450,"Mark Rutte (VVD)",0.48303593867806,0.179497407259673,0
"<anonymized_userid>",1,1923,451,"Mark Rutte (VVD)",0.483287258105052,0.179896290386917,0
"<anonymized_userid>",1,1924,452,"Mark Rutte (VVD)",0.483538577532043,0.18029517351416,0
"<anonymized_userid>",1,1925,453,"Mark Rutte (VVD)",0.483789896959035,0.180694056641404,0
"<anonymized_userid>",1,1926,454,"Mark Rutte (VVD)",0.484041216386027,0.181092939768648,0
"<anonymized_userid>",1,1927,455,"Mark Rutte (VVD)",0.484292535813018,0.181491822895891,0
"<anonymized_userid>",1,1928,456,"Mark Rutte (VVD)",0.48454385524001,0.181890706023135,0
"<anonymized_userid>",1,1929,457,"Mark Rutte (VVD)",0.484795174667002,0.182289589150379,0
"<anonymized_userid>",1,1930,458,"Mark Rutte (VVD)",0.485046494093993,0.182688472277623,0
"<anonymized_userid>",1,1931,459,"Mark Rutte (VVD)",0.485297813520985,0.183087355404866,0
"<anonymized_userid>",1,1932,460,"Mark Rutte (VVD)",0.485549132947977,0.18348623853211,0
"<anonymized_userid>",1,1933,461,"Mark Rutte (VVD)",0.485800452374969,0.183885121659354,0
"<anonymized_userid>",1,1934,462,"Mark Rutte (VVD)",0.48605177180196,0.184284004786598,0
"<anonymized_userid>",1,1935,463,"Mark Rutte (VVD)",0.486303091228952,0.184682887913841,0
"<anonymized_userid>",1,1936,464,"Mark Rutte (VVD)",0.486554410655944,0.185081771041085,0
"<anonymized_userid>",1,1937,465,"Mark Rutte (VVD)",0.486805730082935,0.185480654168329,0
"<anonymized_userid>",1,1938,466,"Mark Rutte (VVD)",0.487057049509927,0.185879537295572,0
"<anonymized_userid>",1,1939,467,"Mark Rutte (VVD)",0.487308368936919,0.186278420422816,0
"<anonymized_userid>",1,1940,468,"Mark Rutte (VVD)",0.487559688363911,0.18667730355006,0
"<anonymized_userid>",1,1941,469,"Mark Rutte (VVD)",0.487811007790902,0.187076186677304,0
"<anonymized_userid>",1,1942,470,"Mark Rutte (VVD)",0.488062327217894,0.187475069804547,0
"<anonymized_userid>",1,1943,471,"Mark Rutte (VVD)",0.488313646644886,0.187873952931791,0
"<anonymized_userid>",1,1944,472,"Mark Rutte (VVD)",0.488564966071877,0.188272836059035,0
"<anonymized_userid>",1,1945,473,"Mark Rutte (VVD)",0.488816285498869,0.188671719186278,0
"<anonymized_userid>",1,1946,474,"Mark Rutte (VVD)",0.489067604925861,0.189070602313522,0
"<anonymized_userid>",1,1947,475,"Mark Rutte (VVD)",0.489318924352852,0.189469485440766,0
"<anonymized_userid>",1,1948,476,"Mark Rutte (VVD)",0.489570243779844,0.18986836856801,0
"<anonymized_userid>",1,1949,477,"Mark Rutte (VVD)",0.489821563206836,0.190267251695253,0
"<anonymized_userid>",1,1950,478,"Mark Rutte (VVD)",0.490072882633828,0.190666134822497,0
"<anonymized_userid>",1,1951,479,"Mark Rutte (VVD)",0.490324202060819,0.191065017949741,0
"<anonymized_userid>",1,1952,480,"Mark Rutte (VVD)",0.490575521487811,0.191463901076984,0
"<anonymized_userid>",1,1953,481,"Mark Rutte (VVD)",0.490826840914803,0.191862784204228,0
"<anonymized_userid>",1,1954,482,"Mark Rutte (VVD)",0.491078160341794,0.192261667331472,0
"<anonymized_userid>",1,1955,483,"Mark Rutte (VVD)",0.491329479768786,0.192660550458716,0
"<anonymized_userid>",1,1956,484,"Mark Rutte (VVD)",0.491580799195778,0.193059433585959,0
"<anonymized_userid>",1,1957,485,"Mark Rutte (VVD)",0.49183211862277,0.193458316713203,0
"<anonymized_userid>",1,1958,486,"Mark Rutte (VVD)",0.492083438049761,0.193857199840447,0
"<anonymized_userid>",1,1959,487,"Mark Rutte (VVD)",0.492334757476753,0.19425608296769,0
"<anonymized_userid>",1,1960,488,"Mark Rutte (VVD)",0.492586076903745,0.194654966094934,0
"<anonymized_userid>",1,1961,489,"Mark Rutte (VVD)",0.492837396330736,0.195053849222178,0
"<anonymized_userid>",1,1962,490,"Mark Rutte (VVD)",0.493088715757728,0.195452732349422,0
"<anonymized_userid>",1,1963,491,"Mark Rutte (VVD)",0.49334003518472,0.195851615476665,0
"<anonymized_userid>",1,1964,492,"Mark Rutte (VVD)",0.493591354611711,0.196250498603909,0
"<anonymized_userid>",1,1965,493,"Mark Rutte (VVD)",0.493842674038703,0.196649381731153,0
"<anonymized_userid>",1,1966,494,"Mark Rutte (VVD)",0.494093993465695,0.197048264858396,0
"<anonymized_userid>",1,1967,495,"Mark Rutte (VVD)",0.494345312892687,0.19744714798564,0
"<anonymized_userid>",1,1968,496,"Mark Rutte (VVD)",0.494596632319678,0.197846031112884,0
"<anonymized_userid>",1,1969,497,"Mark Rutte (VVD)",0.49484795174667,0.198244914240128,0
"<anonymized_userid>",1,1970,498,"Mark Rutte (VVD)",0.495099271173662,0.198643797367371,0
"<anonymized_userid>",1,1971,499,"Mark Rutte (VVD)",0.495350590600653,0.199042680494615,0
"<anonymized_userid>",1,1972,500,"Mark Rutte (VVD)",0.495601910027645,0.199441563621859,0
"<anonymized_userid>",1,1973,501,"Mark Rutte (VVD)",0.495853229454637,0.199840446749103,0
"<anonymized_userid>",1,1974,502,"Mark Rutte (VVD)",0.496104548881629,0.200239329876346,0
"<anonymized_userid>",1,1975,503,"Mark Rutte (VVD)",0.49635586830862,0.20063821300359,0
"<anonymized_userid>",1,1976,504,"Mark Rutte (VVD)",0.496607187735612,0.201037096130834,0
"<anonymized_userid>",1,1977,505,"Mark Rutte (VVD)",0.496858507162604,0.201435979258077,0
"<anonymized_userid>",1,1978,506,"Mark Rutte (VVD)",0.497109826589595,0.201834862385321,0
"<anonymized_userid>",1,1979,507,"Mark Rutte (VVD)",0.497361146016587,0.202233745512565,0
"<anonymized_userid>",1,1980,508,"Mark Rutte (VVD)",0.497612465443579,0.202632628639809,0
"<anonymized_userid>",1,1981,509,"Mark Rutte (VVD)",0.49786378487057,0.203031511767052,0
"<anonymized_userid>",1,1982,510,"Mark Rutte (VVD)",0.498115104297562,0.203430394894296,0
"<anonymized_userid>",1,1983,511,"Mark Rutte (VVD)",0.498366423724554,0.20382927802154,0
"<anonymized_userid>",1,1984,512,"Mark Rutte (VVD)",0.498617743151546,0.204228161148783,0
"<anonymized_userid>",1,1985,513,"Mark Rutte (VVD)",0.498869062578537,0.204627044276027,0
"<anonymized_userid>",1,1986,514,"Mark Rutte (VVD)",0.499120382005529,0.205025927403271,0
"<anonymized_userid>",1,1987,515,"Mark Rutte (VVD)",0.499371701432521,0.205424810530515,0
"<anonymized_userid>",1,1988,516,"Mark Rutte (VVD)",0.499623020859512,0.205823693657758,0
"<anonymized_userid>",1,1989,517,"Mark Rutte (VVD)",0.499874340286504,0.206222576785002,0
"<anonymized_userid>",1,1990,518,"Mark Rutte (VVD)",0.500125659713496,0.206621459912246,0
"<anonymized_userid>",1,1991,519,"Mark Rutte (VVD)",0.500376979140488,0.207020343039489,0
"<anonymized_userid>",1,1992,520,"Mark Rutte (VVD)",0.500628298567479,0.207419226166733,0
"<anonymized_userid>",1,1993,521,"Mark Rutte (VVD)",0.500879617994471,0.207818109293977,0
"<anonymized_userid>",1,1994,522,"Mark Rutte (VVD)",0.501130937421463,0.208216992421221,0
"<anonymized_userid>",1,1995,523,"Mark Rutte (VVD)",0.501382256848454,0.208615875548464,0
"<anonymized_userid>",1,1996,524,"Mark Rutte (VVD)",0.501633576275446,0.209014758675708,0
"<anonymized_userid>",1,1997,525,"Mark Rutte (VVD)",0.501884895702438,0.209413641802952,0
"<anonymized_userid>",1,1998,526,"Mark Rutte (VVD)",0.50213621512943,0.209812524930195,0
"<anonymized_userid>",1,1999,527,"Mark Rutte (VVD)",0.502387534556421,0.210211408057439,0
"<anonymized_userid>",1,2000,528,"Mark Rutte (VVD)",0.502638853983413,0.210610291184683,0
"<anonymized_userid>",1,2001,529,"Mark Rutte (VVD)",0.502890173410405,0.211009174311927,0
"<anonymized_userid>",1,2002,530,"Mark Rutte (VVD)",0.503141492837396,0.21140805743917,0
"<anonymized_userid>",1,2003,531,"Mark Rutte (VVD)",0.503392812264388,0.211806940566414,0
"<anonymized_userid>",1,2004,532,"Mark Rutte (VVD)",0.50364413169138,0.212205823693658,0
"<anonymized_userid>",1,2005,533,"Mark Rutte (VVD)",0.503895451118371,0.212604706820901,0
"<anonymized_userid>",1,2006,534,"Mark Rutte (VVD)",0.504146770545363,0.213003589948145,0
"<anonymized_userid>",1,2007,535,"Mark Rutte (VVD)",0.504398089972355,0.213402473075389,0
"<anonymized_userid>",1,2008,536,"Mark Rutte (VVD)",0.504649409399347,0.213801356202633,0
"<anonymized_userid>",1,2009,537,"Mark Rutte (VVD)",0.504900728826338,0.214200239329876,0
"<anonymized_userid>",1,2010,538,"Mark Rutte (VVD)",0.50515204825333,0.21459912245712,0
"<anonymized_userid>",1,2011,539,"Mark Rutte (VVD)",0.505403367680322,0.214998005584364,0
"<anonymized_userid>",1,2012,540,"Mark Rutte (VVD)",0.505654687107313,0.215396888711608,0
"<anonymized_userid>",1,2013,541,"Mark Rutte (VVD)",0.505906006534305,0.215795771838851,0
"<anonymized_userid>",1,2014,542,"Mark Rutte (VVD)",0.506157325961297,0.216194654966095,0
"<anonymized_userid>",1,2015,543,"Mark Rutte (VVD)",0.506408645388289,0.216593538093339,0
"<anonymized_userid>",1,2016,544,"Mark Rutte (VVD)",0.50665996481528,0.216992421220582,0
"<anonymized_userid>",1,2017,545,"Mark Rutte (VVD)",0.506911284242272,0.217391304347826,0
"<anonymized_userid>",1,2018,546,"Mark Rutte (VVD)",0.507162603669264,0.21779018747507,0
"<anonymized_userid>",1,2019,547,"Mark Rutte (VVD)",0.507413923096255,0.218189070602314,0
"<anonymized_userid>",1,2020,548,"Mark Rutte (VVD)",0.507665242523247,0.218587953729557,0
"<anonymized_userid>",1,2021,549,"Mark Rutte (VVD)",0.507916561950239,0.218986836856801,0
"<anonymized_userid>",1,2022,550,"Mark Rutte (VVD)",0.50816788137723,0.219385719984045,0
"<anonymized_userid>",1,2023,551,"Mark Rutte (VVD)",0.508419200804222,0.219784603111288,0
"<anonymized_userid>",1,2024,552,"Mark Rutte (VVD)",0.508670520231214,0.220183486238532,0
"<anonymized_userid>",1,2025,553,"Mark Rutte (VVD)",0.508921839658206,0.220582369365776,0
"<anonymized_userid>",1,2026,554,"Mark Rutte (VVD)",0.509173159085197,0.22098125249302,0
"<anonymized_userid>",1,2027,555,"Mark Rutte (VVD)",0.509424478512189,0.221380135620263,0
"<anonymized_userid>",1,2028,556,"Mark Rutte (VVD)",0.509675797939181,0.221779018747507,0
"<anonymized_userid>",1,2029,557,"Mark Rutte (VVD)",0.509927117366172,0.222177901874751,0
"<anonymized_userid>",1,2030,558,"Mark Rutte (VVD)",0.510178436793164,0.222576785001994,0
"<anonymized_userid>",1,2031,559,"Mark Rutte (VVD)",0.510429756220156,0.222975668129238,0
"<anonymized_userid>",1,2032,560,"Mark Rutte (VVD)",0.510681075647147,0.223374551256482,0
"<anonymized_userid>",1,2033,561,"Mark Rutte (VVD)",0.510932395074139,0.223773434383726,0
"<anonymized_userid>",1,2034,562,"Mark Rutte (VVD)",0.511183714501131,0.224172317510969,0
"<anonymized_userid>",1,2035,563,"Mark Rutte (VVD)",0.511435033928123,0.224571200638213,0
"<anonymized_userid>",1,2036,564,"Mark Rutte (VVD)",0.511686353355114,0.224970083765457,0
"<anonymized_userid>",1,2037,565,"Mark Rutte (VVD)",0.511937672782106,0.2253689668927,0
"<anonymized_userid>",1,2038,566,"Mark Rutte (VVD)",0.512188992209098,0.225767850019944,0
"<anonymized_userid>",1,2039,567,"Mark Rutte (VVD)",0.512440311636089,0.226166733147188,0
"<anonymized_userid>",1,2040,568,"Mark Rutte (VVD)",0.512691631063081,0.226565616274432,0
"<anonymized_userid>",1,2041,569,"Mark Rutte (VVD)",0.512942950490073,0.226964499401675,0
"<anonymized_userid>",1,2042,570,"Mark Rutte (VVD)",0.513194269917065,0.227363382528919,0
"<anonymized_userid>",1,2043,571,"Mark Rutte (VVD)",0.513445589344056,0.227762265656163,0
"<anonymized_userid>",1,2044,572,"Mark Rutte (VVD)",0.513696908771048,0.228161148783406,0
"<anonymized_userid>",1,2045,573,"Mark Rutte (VVD)",0.51394822819804,0.22856003191065,0
"<anonymized_userid>",1,2046,574,"Mark Rutte (VVD)",0.514199547625031,0.228958915037894,0
"<anonymized_userid>",1,2047,575,"Mark Rutte (VVD)",0.514450867052023,0.229357798165138,0
"<anonymized_userid>",1,2048,576,"Mark Rutte (VVD)",0.514702186479015,0.229756681292381,0
"<anonymized_userid>",1,2049,577,"Mark Rutte (VVD)",0.514953505906007,0.230155564419625,0
"<anonymized_userid>",1,2050,578,"Mark Rutte (VVD)",0.515204825332998,0.230554447546869,0
"<anonymized_userid>",1,2051,579,"Mark Rutte (VVD)",0.51545614475999,0.230953330674112,0
"<anonymized_userid>",1,2052,580,"Mark Rutte (VVD)",0.515707464186982,0.231352213801356,0
"<anonymized_userid>",1,2053,581,"Mark Rutte (VVD)",0.515958783613973,0.2317510969286,0
"<anonymized_userid>",1,2054,582,"Mark Rutte (VVD)",0.516210103040965,0.232149980055844,0
"<anonymized_userid>",1,2055,583,"Mark Rutte (VVD)",0.516461422467957,0.232548863183087,0
"<anonymized_userid>",1,2056,584,"Mark Rutte (VVD)",0.516712741894948,0.232947746310331,0
"<anonymized_userid>",1,2057,585,"Mark Rutte (VVD)",0.51696406132194,0.233346629437575,0
"<anonymized_userid>",1,2058,586,"Mark Rutte (VVD)",0.517215380748932,0.233745512564819,0
"<anonymized_userid>",1,2059,587,"Mark Rutte (VVD)",0.517466700175924,0.234144395692062,0
"<anonymized_userid>",1,2060,588,"Mark Rutte (VVD)",0.517718019602915,0.234543278819306,0
"<anonymized_userid>",1,2061,589,"Mark Rutte (VVD)",0.517969339029907,0.23494216194655,0
"<anonymized_userid>",1,2062,590,"Mark Rutte (VVD)",0.518220658456899,0.235341045073793,0
"<anonymized_userid>",1,2063,591,"Mark Rutte (VVD)",0.51847197788389,0.235739928201037,0
"<anonymized_userid>",1,2064,592,"Mark Rutte (VVD)",0.518723297310882,0.236138811328281,0
"<anonymized_userid>",1,2065,593,"Mark Rutte (VVD)",0.518974616737874,0.236537694455525,0
"<anonymized_userid>",1,2066,594,"Mark Rutte (VVD)",0.519225936164866,0.236936577582768,0
"<anonymized_userid>",1,2067,595,"Mark Rutte (VVD)",0.519477255591857,0.237335460710012,0
"<anonymized_userid>",1,2068,596,"Mark Rutte (VVD)",0.519728575018849,0.237734343837256,0
"<anonymized_userid>",1,2069,597,"Mark Rutte (VVD)",0.519979894445841,0.238133226964499,0
"<anonymized_userid>",1,2070,598,"Mark Rutte (VVD)",0.520231213872832,0.238532110091743,0
"<anonymized_userid>",1,2071,599,"Mark Rutte (VVD)",0.520482533299824,0.238930993218987,0
"<anonymized_userid>",1,2072,600,"Mark Rutte (VVD)",0.520733852726816,0.239329876346231,0
"<anonymized_userid>",1,2073,601,"Mark Rutte (VVD)",0.520985172153807,0.239728759473474,0
"<anonymized_userid>",1,2074,602,"Mark Rutte (VVD)",0.521236491580799,0.240127642600718,0
"<anonymized_userid>",1,2075,603,"Mark Rutte (VVD)",0.521487811007791,0.240526525727962,0
"<anonymized_userid>",1,2076,604,"Mark Rutte (VVD)",0.521739130434783,0.240925408855205,0
"<anonymized_userid>",1,2077,605,"Mark Rutte (VVD)",0.521990449861774,0.241324291982449,0
"<anonymized_userid>",1,2078,606,"Mark Rutte (VVD)",0.522241769288766,0.241723175109693,0
"<anonymized_userid>",1,2079,607,"Mark Rutte (VVD)",0.522493088715758,0.242122058236937,0
"<anonymized_userid>",1,2080,608,"Mark Rutte (VVD)",0.522744408142749,0.24252094136418,0
"<anonymized_userid>",1,2081,609,"Mark Rutte (VVD)",0.522995727569741,0.242919824491424,0
"<anonymized_userid>",1,2082,610,"Mark Rutte (VVD)",0.523247046996733,0.243318707618668,0
"<anonymized_userid>",1,2083,611,"Mark Rutte (VVD)",0.523498366423725,0.243717590745911,0
"<anonymized_userid>",1,2084,612,"Mark Rutte (VVD)",0.523749685850716,0.244116473873155,0
"<anonymized_userid>",1,2085,613,"Mark Rutte (VVD)",0.524001005277708,0.244515357000399,0
"<anonymized_userid>",1,2086,614,"Mark Rutte (VVD)",0.5242523247047,0.244914240127643,0
"<anonymized_userid>",1,2087,615,"Mark Rutte (VVD)",0.524503644131691,0.245313123254886,0
"<anonymized_userid>",1,2088,616,"Mark Rutte (VVD)",0.524754963558683,0.24571200638213,0
"<anonymized_userid>",1,2089,617,"Mark Rutte (VVD)",0.525006282985675,0.246110889509374,0
"<anonymized_userid>",1,2090,618,"Mark Rutte (VVD)",0.525257602412667,0.246509772636617,0
"<anonymized_userid>",1,2091,619,"Mark Rutte (VVD)",0.525508921839658,0.246908655763861,0
"<anonymized_userid>",1,2092,620,"Mark Rutte (VVD)",0.52576024126665,0.247307538891105,0
"<anonymized_userid>",1,2093,621,"Mark Rutte (VVD)",0.526011560693642,0.247706422018349,0
"<anonymized_userid>",1,2094,622,"Mark Rutte (VVD)",0.526262880120633,0.248105305145592,0
"<anonymized_userid>",1,2095,623,"Mark Rutte (VVD)",0.526514199547625,0.248504188272836,0
"<anonymized_userid>",1,2096,624,"Mark Rutte (VVD)",0.526765518974617,0.24890307140008,0
"<anonymized_userid>",1,2097,625,"Mark Rutte (VVD)",0.527016838401608,0.249301954527323,0
"<anonymized_userid>",1,2098,626,"Mark Rutte (VVD)",0.5272681578286,0.249700837654567,0
"<anonymized_userid>",1,2099,627,"Mark Rutte (VVD)",0.527519477255592,0.250099720781811,1
"<anonymized_userid>",1,2100,628,"Mark Rutte (VVD)",0.527770796682584,0.250498603909055,0
"<anonymized_userid>",1,2101,629,"Mark Rutte (VVD)",0.528022116109575,0.250897487036298,0
"<anonymized_userid>",1,2102,630,"Mark Rutte (VVD)",0.528273435536567,0.251296370163542,0
"<anonymized_userid>",1,2103,631,"Mark Rutte (VVD)",0.528524754963559,0.251695253290786,0
"<anonymized_userid>",1,2104,632,"Mark Rutte (VVD)",0.52877607439055,0.25209413641803,0
"<anonymized_userid>",1,2105,633,"Mark Rutte (VVD)",0.529027393817542,0.252493019545273,0
"<anonymized_userid>",1,2106,634,"Mark Rutte (VVD)",0.529278713244534,0.252891902672517,0
"<anonymized_userid>",1,2107,635,"Mark Rutte (VVD)",0.529530032671526,0.253290785799761,0
"<anonymized_userid>",1,2108,636,"Mark Rutte (VVD)",0.529781352098517,0.253689668927004,0
"<anonymized_userid>",1,2109,637,"Mark Rutte (VVD)",0.530032671525509,0.254088552054248,0
"<anonymized_userid>",1,2110,638,"Mark Rutte (VVD)",0.530283990952501,0.254487435181492,0
"<anonymized_userid>",1,2111,639,"Mark Rutte (VVD)",0.530535310379492,0.254886318308736,0
"<anonymized_userid>",1,2112,640,"Mark Rutte (VVD)",0.530786629806484,0.255285201435979,0
"<anonymized_userid>",1,2113,641,"Mark Rutte (VVD)",0.531037949233476,0.255684084563223,0
"<anonymized_userid>",1,2114,642,"Mark Rutte (VVD)",0.531289268660467,0.256082967690467,0
"<anonymized_userid>",1,2115,643,"Mark Rutte (VVD)",0.531540588087459,0.25648185081771,0
"<anonymized_userid>",1,2116,644,"Mark Rutte (VVD)",0.531791907514451,0.256880733944954,0
"<anonymized_userid>",1,2117,645,"Mark Rutte (VVD)",0.532043226941443,0.257279617072198,0
"<anonymized_userid>",1,2118,646,"Mark Rutte (VVD)",0.532294546368434,0.257678500199442,0
"<anonymized_userid>",1,2119,647,"Mark Rutte (VVD)",0.532545865795426,0.258077383326685,0
"<anonymized_userid>",1,2120,648,"Mark Rutte (VVD)",0.532797185222418,0.258476266453929,0
"<anonymized_userid>",1,2121,649,"Mark Rutte (VVD)",0.533048504649409,0.258875149581173,0
"<anonymized_userid>",1,2122,650,"Mark Rutte (VVD)",0.533299824076401,0.259274032708416,0
"<anonymized_userid>",1,2123,651,"Mark Rutte (VVD)",0.533551143503393,0.25967291583566,0
"<anonymized_userid>",1,2124,652,"Mark Rutte (VVD)",0.533802462930384,0.260071798962904,0
"<anonymized_userid>",1,2125,653,"Mark Rutte (VVD)",0.534053782357376,0.260470682090148,0
"<anonymized_userid>",1,2126,654,"Mark Rutte (VVD)",0.534305101784368,0.260869565217391,0
"<anonymized_userid>",1,2127,655,"Mark Rutte (VVD)",0.53455642121136,0.261268448344635,0
"<anonymized_userid>",1,2128,656,"Mark Rutte (VVD)",0.534807740638351,0.261667331471879,0
"<anonymized_userid>",1,2129,657,"Mark Rutte (VVD)",0.535059060065343,0.262066214599122,0
"<anonymized_userid>",1,2130,658,"Mark Rutte (VVD)",0.535310379492335,0.262465097726366,0
"<anonymized_userid>",1,2131,659,"Mark Rutte (VVD)",0.535561698919326,0.26286398085361,0
"<anonymized_userid>",1,2132,660,"Mark Rutte (VVD)",0.535813018346318,0.263262863980854,0
"<anonymized_userid>",1,2133,661,"Mark Rutte (VVD)",0.53606433777331,0.263661747108097,0
"<anonymized_userid>",1,2134,662,"Mark Rutte (VVD)",0.536315657200302,0.264060630235341,0
"<anonymized_userid>",1,2135,663,"Mark Rutte (VVD)",0.536566976627293,0.264459513362585,0
"<anonymized_userid>",1,2136,664,"Mark Rutte (VVD)",0.536818296054285,0.264858396489829,0
"<anonymized_userid>",1,2137,665,"Mark Rutte (VVD)",0.537069615481277,0.265257279617072,0
"<anonymized_userid>",1,2138,666,"Mark Rutte (VVD)",0.537320934908268,0.265656162744316,0
"<anonymized_userid>",1,2139,667,"Mark Rutte (VVD)",0.53757225433526,0.26605504587156,0
"<anonymized_userid>",1,2140,668,"Mark Rutte (VVD)",0.537823573762252,0.266453928998803,0
"<anonymized_userid>",1,2141,669,"Mark Rutte (VVD)",0.538074893189244,0.266852812126047,0
"<anonymized_userid>",1,2142,670,"Mark Rutte (VVD)",0.538326212616235,0.267251695253291,0
"<anonymized_userid>",1,2143,671,"Mark Rutte (VVD)",0.538577532043227,0.267650578380535,0
"<anonymized_userid>",1,2144,672,"Mark Rutte (VVD)",0.538828851470219,0.268049461507778,0
"<anonymized_userid>",1,2145,673,"Mark Rutte (VVD)",0.53908017089721,0.268448344635022,0
"<anonymized_userid>",1,2146,674,"Mark Rutte (VVD)",0.539331490324202,0.268847227762266,0
"<anonymized_userid>",1,2147,675,"Mark Rutte (VVD)",0.539582809751194,0.269246110889509,0
"<anonymized_userid>",1,2148,676,"Mark Rutte (VVD)",0.539834129178186,0.269644994016753,0
"<anonymized_userid>",1,2149,677,"Mark Rutte (VVD)",0.540085448605177,0.270043877143997,0
"<anonymized_userid>",1,2150,678,"Mark Rutte (VVD)",0.540336768032169,0.270442760271241,0
"<anonymized_userid>",1,2151,679,"Mark Rutte (VVD)",0.540588087459161,0.270841643398484,0
"<anonymized_userid>",1,2152,680,"Mark Rutte (VVD)",0.540839406886152,0.271240526525728,0
"<anonymized_userid>",1,2153,681,"Mark Rutte (VVD)",0.541090726313144,0.271639409652972,0
"<anonymized_userid>",1,2154,682,"Mark Rutte (VVD)",0.541342045740136,0.272038292780215,0
"<anonymized_userid>",1,2155,683,"Mark Rutte (VVD)",0.541593365167127,0.272437175907459,0
"<anonymized_userid>",1,2156,684,"Mark Rutte (VVD)",0.541844684594119,0.272836059034703,0
"<anonymized_userid>",1,2157,685,"Mark Rutte (VVD)",0.542096004021111,0.273234942161947,0
"<anonymized_userid>",1,2158,686,"Mark Rutte (VVD)",0.542347323448103,0.27363382528919,0
"<anonymized_userid>",1,2159,687,"Mark Rutte (VVD)",0.542598642875094,0.274032708416434,0
"<anonymized_userid>",1,2160,688,"Mark Rutte (VVD)",0.542849962302086,0.274431591543678,0
"<anonymized_userid>",1,2161,689,"Mark Rutte (VVD)",0.543101281729078,0.274830474670921,0
"<anonymized_userid>",1,2162,690,"Mark Rutte (VVD)",0.543352601156069,0.275229357798165,0
"<anonymized_userid>",1,2163,691,"Mark Rutte (VVD)",0.543603920583061,0.275628240925409,0
"<anonymized_userid>",1,2164,692,"Mark Rutte (VVD)",0.543855240010053,0.276027124052653,0
"<anonymized_userid>",1,2165,693,"Mark Rutte (VVD)",0.544106559437044,0.276426007179896,0
"<anonymized_userid>",1,2166,694,"Mark Rutte (VVD)",0.544357878864036,0.27682489030714,0
"<anonymized_userid>",1,2167,695,"Mark Rutte (VVD)",0.544609198291028,0.277223773434384,0
"<anonymized_userid>",1,2168,696,"Mark Rutte (VVD)",0.54486051771802,0.277622656561627,0
"<anonymized_userid>",1,2169,697,"Mark Rutte (VVD)",0.545111837145011,0.278021539688871,0
"<anonymized_userid>",1,2170,698,"Mark Rutte (VVD)",0.545363156572003,0.278420422816115,0
"<anonymized_userid>",1,2171,699,"Mark Rutte (VVD)",0.545614475998995,0.278819305943359,0
"<anonymized_userid>",1,2172,700,"Mark Rutte (VVD)",0.545865795425986,0.279218189070602,0
"<anonymized_userid>",1,2173,701,"Mark Rutte (VVD)",0.546117114852978,0.279617072197846,0
"<anonymized_userid>",1,2174,702,"Mark Rutte (VVD)",0.54636843427997,0.28001595532509,0
"<anonymized_userid>",1,2175,703,"Mark Rutte (VVD)",0.546619753706962,0.280414838452333,0
"<anonymized_userid>",1,2176,704,"Mark Rutte (VVD)",0.546871073133953,0.280813721579577,0
"<anonymized_userid>",1,2177,705,"Mark Rutte (VVD)",0.547122392560945,0.281212604706821,0
"<anonymized_userid>",1,2178,706,"Mark Rutte (VVD)",0.547373711987937,0.281611487834065,0
"<anonymized_userid>",1,2179,707,"Mark Rutte (VVD)",0.547625031414928,0.282010370961308,0
"<anonymized_userid>",1,2180,708,"Mark Rutte (VVD)",0.54787635084192,0.282409254088552,0
"<anonymized_userid>",1,2181,709,"Mark Rutte (VVD)",0.548127670268912,0.282808137215796,0
"<anonymized_userid>",1,2182,710,"Mark Rutte (VVD)",0.548378989695903,0.283207020343039,0
"<anonymized_userid>",1,2183,711,"Mark Rutte (VVD)",0.548630309122895,0.283605903470283,0
"<anonymized_userid>",1,2184,712,"Mark Rutte (VVD)",0.548881628549887,0.284004786597527,0
"<anonymized_userid>",1,2185,713,"Mark Rutte (VVD)",0.549132947976879,0.284403669724771,0
"<anonymized_userid>",1,2186,714,"Mark Rutte (VVD)",0.54938426740387,0.284802552852014,0
"<anonymized_userid>",1,2187,715,"Mark Rutte (VVD)",0.549635586830862,0.285201435979258,0
"<anonymized_userid>",1,2188,716,"Mark Rutte (VVD)",0.549886906257854,0.285600319106502,0
"<anonymized_userid>",1,2189,717,"Mark Rutte (VVD)",0.550138225684845,0.285999202233746,0
"<anonymized_userid>",1,2190,718,"Mark Rutte (VVD)",0.550389545111837,0.286398085360989,0
"<anonymized_userid>",1,2191,719,"Mark Rutte (VVD)",0.550640864538829,0.286796968488233,0
"<anonymized_userid>",1,2192,720,"Mark Rutte (VVD)",0.550892183965821,0.287195851615477,0
"<anonymized_userid>",1,2193,721,"Mark Rutte (VVD)",0.551143503392812,0.28759473474272,0
"<anonymized_userid>",1,2194,722,"Mark Rutte (VVD)",0.551394822819804,0.287993617869964,0
"<anonymized_userid>",1,2195,723,"Mark Rutte (VVD)",0.551646142246796,0.288392500997208,0
"<anonymized_userid>",1,2196,724,"Mark Rutte (VVD)",0.551897461673787,0.288791384124452,0
"<anonymized_userid>",1,2197,725,"Mark Rutte (VVD)",0.552148781100779,0.289190267251695,0
"<anonymized_userid>",1,2198,726,"Mark Rutte (VVD)",0.552400100527771,0.289589150378939,0
"<anonymized_userid>",1,2199,727,"Mark Rutte (VVD)",0.552651419954763,0.289988033506183,0
"<anonymized_userid>",1,2200,728,"Mark Rutte (VVD)",0.552902739381754,0.290386916633426,0
"<anonymized_userid>",1,2201,729,"Mark Rutte (VVD)",0.553154058808746,0.29078579976067,0
"<anonymized_userid>",1,2202,730,"Mark Rutte (VVD)",0.553405378235738,0.291184682887914,0
"<anonymized_userid>",1,2203,731,"Mark Rutte (VVD)",0.553656697662729,0.291583566015158,0
"<anonymized_userid>",1,2204,732,"Mark Rutte (VVD)",0.553908017089721,0.291982449142401,0
"<anonymized_userid>",1,2205,733,"Mark Rutte (VVD)",0.554159336516713,0.292381332269645,0
"<anonymized_userid>",1,2206,734,"Mark Rutte (VVD)",0.554410655943704,0.292780215396889,0
"<anonymized_userid>",1,2207,735,"Mark Rutte (VVD)",0.554661975370696,0.293179098524132,0
"<anonymized_userid>",1,2208,736,"Mark Rutte (VVD)",0.554913294797688,0.293577981651376,0
"<anonymized_userid>",1,2209,737,"Mark Rutte (VVD)",0.55516461422468,0.29397686477862,0
"<anonymized_userid>",1,2210,738,"Mark Rutte (VVD)",0.555415933651671,0.294375747905864,0
"<anonymized_userid>",1,2211,739,"Mark Rutte (VVD)",0.555667253078663,0.294774631033107,0
"<anonymized_userid>",1,2212,740,"Mark Rutte (VVD)",0.555918572505655,0.295173514160351,0
"<anonymized_userid>",1,2213,741,"Mark Rutte (VVD)",0.556169891932646,0.295572397287595,0
"<anonymized_userid>",1,2214,742,"Mark Rutte (VVD)",0.556421211359638,0.295971280414838,0
"<anonymized_userid>",1,2215,743,"Mark Rutte (VVD)",0.55667253078663,0.296370163542082,0
"<anonymized_userid>",1,2216,744,"Mark Rutte (VVD)",0.556923850213622,0.296769046669326,0
"<anonymized_userid>",1,2217,745,"Mark Rutte (VVD)",0.557175169640613,0.29716792979657,0
"<anonymized_userid>",1,2218,746,"Mark Rutte (VVD)",0.557426489067605,0.297566812923813,0
"<anonymized_userid>",1,2219,747,"Mark Rutte (VVD)",0.557677808494597,0.297965696051057,0
"<anonymized_userid>",1,2220,748,"Mark Rutte (VVD)",0.557929127921588,0.298364579178301,0
"<anonymized_userid>",1,2221,749,"Mark Rutte (VVD)",0.55818044734858,0.298763462305544,0
"<anonymized_userid>",1,2222,750,"Mark Rutte (VVD)",0.558431766775572,0.299162345432788,0
"<anonymized_userid>",1,2223,751,"Mark Rutte (VVD)",0.558683086202563,0.299561228560032,0
"<anonymized_userid>",1,2224,752,"Mark Rutte (VVD)",0.558934405629555,0.299960111687276,0
"<anonymized_userid>",1,2225,753,"Mark Rutte (VVD)",0.559185725056547,0.300358994814519,0
"<anonymized_userid>",1,2226,754,"Mark Rutte (VVD)",0.559437044483539,0.300757877941763,0
"<anonymized_userid>",1,2227,755,"Mark Rutte (VVD)",0.55968836391053,0.301156761069007,0
"<anonymized_userid>",1,2228,756,"Mark Rutte (VVD)",0.559939683337522,0.30155564419625,0
"<anonymized_userid>",1,2229,757,"Mark Rutte (VVD)",0.560191002764514,0.301954527323494,0
"<anonymized_userid>",1,2230,758,"Mark Rutte (VVD)",0.560442322191505,0.302353410450738,0
"<anonymized_userid>",1,2231,759,"Mark Rutte (VVD)",0.560693641618497,0.302752293577982,0
"<anonymized_userid>",1,2232,760,"Mark Rutte (VVD)",0.560944961045489,0.303151176705225,0
"<anonymized_userid>",1,2233,761,"Mark Rutte (VVD)",0.56119628047248,0.303550059832469,0
"<anonymized_userid>",1,2234,762,"Mark Rutte (VVD)",0.561447599899472,0.303948942959713,0
"<anonymized_userid>",1,2235,763,"Mark Rutte (VVD)",0.561698919326464,0.304347826086957,0
"<anonymized_userid>",1,2236,764,"Mark Rutte (VVD)",0.561950238753456,0.3047467092142,0
"<anonymized_userid>",1,2237,765,"Mark Rutte (VVD)",0.562201558180447,0.305145592341444,0
"<anonymized_userid>",1,2238,766,"Mark Rutte (VVD)",0.562452877607439,0.305544475468688,0
"<anonymized_userid>",1,2239,767,"Mark Rutte (VVD)",0.562704197034431,0.305943358595931,0
"<anonymized_userid>",1,2240,768,"Mark Rutte (VVD)",0.562955516461423,0.306342241723175,0
"<anonymized_userid>",1,2241,769,"Mark Rutte (VVD)",0.563206835888414,0.306741124850419,0
"<anonymized_userid>",1,2242,770,"Mark Rutte (VVD)",0.563458155315406,0.307140007977663,0
"<anonymized_userid>",1,2243,771,"Mark Rutte (VVD)",0.563709474742398,0.307538891104906,0
"<anonymized_userid>",1,2244,772,"Mark Rutte (VVD)",0.563960794169389,0.30793777423215,0
"<anonymized_userid>",1,2245,773,"Mark Rutte (VVD)",0.564212113596381,0.308336657359394,0
"<anonymized_userid>",1,2246,774,"Mark Rutte (VVD)",0.564463433023373,0.308735540486637,0
"<anonymized_userid>",1,2247,775,"Mark Rutte (VVD)",0.564714752450364,0.309134423613881,0
"<anonymized_userid>",1,2248,776,"Mark Rutte (VVD)",0.564966071877356,0.309533306741125,0
"<anonymized_userid>",1,2249,777,"Mark Rutte (VVD)",0.565217391304348,0.309932189868369,0
"<anonymized_userid>",1,2250,778,"Mark Rutte (VVD)",0.56546871073134,0.310331072995612,0
"<anonymized_userid>",1,2251,779,"Mark Rutte (VVD)",0.565720030158331,0.310729956122856,0
"<anonymized_userid>",1,2252,780,"Mark Rutte (VVD)",0.565971349585323,0.3111288392501,0
"<anonymized_userid>",1,2253,781,"Mark Rutte (VVD)",0.566222669012315,0.311527722377343,0
"<anonymized_userid>",1,2254,782,"Mark Rutte (VVD)",0.566473988439306,0.311926605504587,0
"<anonymized_userid>",1,2255,783,"Mark Rutte (VVD)",0.566725307866298,0.312325488631831,0
"<anonymized_userid>",1,2256,784,"Mark Rutte (VVD)",0.56697662729329,0.312724371759075,0
"<anonymized_userid>",1,2257,785,"Mark Rutte (VVD)",0.567227946720281,0.313123254886318,0
"<anonymized_userid>",1,2258,786,"Mark Rutte (VVD)",0.567479266147273,0.313522138013562,0
"<anonymized_userid>",1,2259,787,"Mark Rutte (VVD)",0.567730585574265,0.313921021140806,0
"<anonymized_userid>",1,2260,788,"Mark Rutte (VVD)",0.567981905001257,0.314319904268049,0
"<anonymized_userid>",1,2261,789,"Mark Rutte (VVD)",0.568233224428248,0.314718787395293,0
"<anonymized_userid>",1,2262,790,"Mark Rutte (VVD)",0.56848454385524,0.315117670522537,0
"<anonymized_userid>",1,2263,791,"Mark Rutte (VVD)",0.568735863282232,0.315516553649781,0
"<anonymized_userid>",1,2264,792,"Mark Rutte (VVD)",0.568987182709223,0.315915436777024,0
"<anonymized_userid>",1,2265,793,"Mark Rutte (VVD)",0.569238502136215,0.316314319904268,0
"<anonymized_userid>",1,2266,794,"Mark Rutte (VVD)",0.569489821563207,0.316713203031512,0
"<anonymized_userid>",1,2267,795,"Mark Rutte (VVD)",0.569741140990199,0.317112086158755,0
"<anonymized_userid>",1,2268,796,"Mark Rutte (VVD)",0.56999246041719,0.317510969285999,0
"<anonymized_userid>",1,2269,797,"Mark Rutte (VVD)",0.570243779844182,0.317909852413243,0
"<anonymized_userid>",1,2270,798,"Mark Rutte (VVD)",0.570495099271174,0.318308735540487,0
"<anonymized_userid>",1,2271,799,"Mark Rutte (VVD)",0.570746418698165,0.31870761866773,0
"<anonymized_userid>",1,2272,800,"Mark Rutte (VVD)",0.570997738125157,0.319106501794974,0
"<anonymized_userid>",1,2273,801,"Mark Rutte (VVD)",0.571249057552149,0.319505384922218,0
"<anonymized_userid>",1,2274,802,"Mark Rutte (VVD)",0.57150037697914,0.319904268049461,0
"<anonymized_userid>",1,2275,803,"Mark Rutte (VVD)",0.571751696406132,0.320303151176705,0
"<anonymized_userid>",1,2276,804,"Mark Rutte (VVD)",0.572003015833124,0.320702034303949,0
"<anonymized_userid>",1,2277,805,"Mark Rutte (VVD)",0.572254335260116,0.321100917431193,0
"<anonymized_userid>",1,2278,806,"Mark Rutte (VVD)",0.572505654687107,0.321499800558436,0
"<anonymized_userid>",1,2279,807,"Mark Rutte (VVD)",0.572756974114099,0.32189868368568,0
"<anonymized_userid>",1,2280,808,"Mark Rutte (VVD)",0.573008293541091,0.322297566812924,0
"<anonymized_userid>",1,2281,809,"Mark Rutte (VVD)",0.573259612968082,0.322696449940168,0
"<anonymized_userid>",1,2282,810,"Mark Rutte (VVD)",0.573510932395074,0.323095333067411,0
"<anonymized_userid>",1,2283,811,"Mark Rutte (VVD)",0.573762251822066,0.323494216194655,0
"<anonymized_userid>",1,2284,812,"Mark Rutte (VVD)",0.574013571249057,0.323893099321899,0
"<anonymized_userid>",1,2285,813,"Mark Rutte (VVD)",0.574264890676049,0.324291982449142,0
"<anonymized_userid>",1,2286,814,"Mark Rutte (VVD)",0.574516210103041,0.324690865576386,0
"<anonymized_userid>",1,2287,815,"Mark Rutte (VVD)",0.574767529530033,0.32508974870363,0
"<anonymized_userid>",1,2288,816,"Mark Rutte (VVD)",0.575018848957024,0.325488631830874,0
"<anonymized_userid>",1,2289,817,"Mark Rutte (VVD)",0.575270168384016,0.325887514958117,0
"<anonymized_userid>",1,2290,818,"Mark Rutte (VVD)",0.575521487811008,0.326286398085361,0
"<anonymized_userid>",1,2291,819,"Mark Rutte (VVD)",0.575772807238,0.326685281212605,0
"<anonymized_userid>",1,2292,820,"Mark Rutte (VVD)",0.576024126664991,0.327084164339848,0
"<anonymized_userid>",1,2293,821,"Mark Rutte (VVD)",0.576275446091983,0.327483047467092,0
"<anonymized_userid>",1,2294,822,"Mark Rutte (VVD)",0.576526765518975,0.327881930594336,0
"<anonymized_userid>",1,2295,823,"Mark Rutte (VVD)",0.576778084945966,0.32828081372158,0
"<anonymized_userid>",1,2296,824,"Mark Rutte (VVD)",0.577029404372958,0.328679696848823,0
"<anonymized_userid>",1,2297,825,"Mark Rutte (VVD)",0.57728072379995,0.329078579976067,0
"<anonymized_userid>",1,2298,826,"Mark Rutte (VVD)",0.577532043226941,0.329477463103311,0
"<anonymized_userid>",1,2299,827,"Mark Rutte (VVD)",0.577783362653933,0.329876346230554,0
"<anonymized_userid>",1,2300,828,"Mark Rutte (VVD)",0.578034682080925,0.330275229357798,0
"<anonymized_userid>",1,2301,829,"Mark Rutte (VVD)",0.578286001507917,0.330674112485042,0
"<anonymized_userid>",1,2302,830,"Mark Rutte (VVD)",0.578537320934908,0.331072995612286,0
"<anonymized_userid>",1,2303,831,"Mark Rutte (VVD)",0.5787886403619,0.331471878739529,0
"<anonymized_userid>",1,2304,832,"Mark Rutte (VVD)",0.579039959788892,0.331870761866773,0
"<anonymized_userid>",1,2305,833,"Mark Rutte (VVD)",0.579291279215883,0.332269644994017,0
"<anonymized_userid>",1,2306,834,"Mark Rutte (VVD)",0.579542598642875,0.33266852812126,0
"<anonymized_userid>",1,2307,835,"Mark Rutte (VVD)",0.579793918069867,0.333067411248504,0
"<anonymized_userid>",1,2308,836,"Mark Rutte (VVD)",0.580045237496859,0.333466294375748,0
"<anonymized_userid>",1,2309,837,"Mark Rutte (VVD)",0.58029655692385,0.333865177502992,0
"<anonymized_userid>",1,2310,838,"Mark Rutte (VVD)",0.580547876350842,0.334264060630235,0
"<anonymized_userid>",1,2311,839,"Mark Rutte (VVD)",0.580799195777834,0.334662943757479,0
"<anonymized_userid>",1,2312,840,"Mark Rutte (VVD)",0.581050515204825,0.335061826884723,0
"<anonymized_userid>",1,2313,841,"Mark Rutte (VVD)",0.581301834631817,0.335460710011966,0
"<anonymized_userid>",1,2314,842,"Mark Rutte (VVD)",0.581553154058809,0.33585959313921,0
"<anonymized_userid>",1,2315,843,"Mark Rutte (VVD)",0.5818044734858,0.336258476266454,0
"<anonymized_userid>",1,2316,844,"Mark Rutte (VVD)",0.582055792912792,0.336657359393698,0
"<anonymized_userid>",1,2317,845,"Mark Rutte (VVD)",0.582307112339784,0.337056242520941,0
"<anonymized_userid>",1,2318,846,"Mark Rutte (VVD)",0.582558431766776,0.337455125648185,0
"<anonymized_userid>",1,2319,847,"Mark Rutte (VVD)",0.582809751193767,0.337854008775429,0
"<anonymized_userid>",1,2320,848,"Mark Rutte (VVD)",0.583061070620759,0.338252891902672,0
"<anonymized_userid>",1,2321,849,"Mark Rutte (VVD)",0.583312390047751,0.338651775029916,0
"<anonymized_userid>",1,2322,850,"Mark Rutte (VVD)",0.583563709474742,0.33905065815716,0
"<anonymized_userid>",1,2323,851,"Mark Rutte (VVD)",0.583815028901734,0.339449541284404,0
"<anonymized_userid>",1,2324,852,"Mark Rutte (VVD)",0.584066348328726,0.339848424411647,0
"<anonymized_userid>",1,2325,853,"Mark Rutte (VVD)",0.584317667755717,0.340247307538891,0
"<anonymized_userid>",1,2326,854,"Mark Rutte (VVD)",0.584568987182709,0.340646190666135,0
"<anonymized_userid>",1,2327,855,"Mark Rutte (VVD)",0.584820306609701,0.341045073793379,0
"<anonymized_userid>",1,2328,856,"Mark Rutte (VVD)",0.585071626036693,0.341443956920622,0
"<anonymized_userid>",1,2329,857,"Mark Rutte (VVD)",0.585322945463684,0.341842840047866,0
"<anonymized_userid>",1,2330,858,"Mark Rutte (VVD)",0.585574264890676,0.34224172317511,0
"<anonymized_userid>",1,2331,859,"Mark Rutte (VVD)",0.585825584317668,0.342640606302353,0
"<anonymized_userid>",1,2332,860,"Mark Rutte (VVD)",0.586076903744659,0.343039489429597,0
"<anonymized_userid>",1,2333,861,"Mark Rutte (VVD)",0.586328223171651,0.343438372556841,0
"<anonymized_userid>",1,2334,862,"Mark Rutte (VVD)",0.586579542598643,0.343837255684085,0
"<anonymized_userid>",1,2335,863,"Mark Rutte (VVD)",0.586830862025635,0.344236138811328,0
"<anonymized_userid>",1,2336,864,"Mark Rutte (VVD)",0.587082181452626,0.344635021938572,0
"<anonymized_userid>",1,2337,865,"Mark Rutte (VVD)",0.587333500879618,0.345033905065816,0
"<anonymized_userid>",1,2338,866,"Mark Rutte (VVD)",0.58758482030661,0.345432788193059,0
"<anonymized_userid>",1,2339,867,"Mark Rutte (VVD)",0.587836139733601,0.345831671320303,0
"<anonymized_userid>",1,2340,868,"Mark Rutte (VVD)",0.588087459160593,0.346230554447547,0
"<anonymized_userid>",1,2341,869,"Mark Rutte (VVD)",0.588338778587585,0.346629437574791,0
"<anonymized_userid>",1,2342,870,"Mark Rutte (VVD)",0.588590098014577,0.347028320702034,0
"<anonymized_userid>",1,2343,871,"Mark Rutte (VVD)",0.588841417441568,0.347427203829278,0
"<anonymized_userid>",1,2344,872,"Mark Rutte (VVD)",0.58909273686856,0.347826086956522,0
"<anonymized_userid>",1,2345,873,"Mark Rutte (VVD)",0.589344056295552,0.348224970083765,0
"<anonymized_userid>",1,2346,874,"Mark Rutte (VVD)",0.589595375722543,0.348623853211009,0
"<anonymized_userid>",1,2347,875,"Mark Rutte (VVD)",0.589846695149535,0.349022736338253,0
"<anonymized_userid>",1,2348,876,"Mark Rutte (VVD)",0.590098014576527,0.349421619465497,0
"<anonymized_userid>",1,2349,877,"Mark Rutte (VVD)",0.590349334003519,0.34982050259274,0
"<anonymized_userid>",1,2350,878,"Mark Rutte (VVD)",0.59060065343051,0.350219385719984,0
"<anonymized_userid>",1,2351,879,"Mark Rutte (VVD)",0.590851972857502,0.350618268847228,0
"<anonymized_userid>",1,2352,880,"Mark Rutte (VVD)",0.591103292284494,0.351017151974471,0
"<anonymized_userid>",1,2353,881,"Mark Rutte (VVD)",0.591354611711485,0.351416035101715,0
"<anonymized_userid>",1,2354,882,"Mark Rutte (VVD)",0.591605931138477,0.351814918228959,0
"<anonymized_userid>",1,2355,883,"Mark Rutte (VVD)",0.591857250565469,0.352213801356203,0
"<anonymized_userid>",1,2356,884,"Mark Rutte (VVD)",0.59210856999246,0.352612684483446,0
"<anonymized_userid>",1,2357,885,"Mark Rutte (VVD)",0.592359889419452,0.35301156761069,0
"<anonymized_userid>",1,2358,886,"Mark Rutte (VVD)",0.592611208846444,0.353410450737934,0
"<anonymized_userid>",1,2359,887,"Mark Rutte (VVD)",0.592862528273436,0.353809333865177,0
"<anonymized_userid>",1,2360,888,"Mark Rutte (VVD)",0.593113847700427,0.354208216992421,0
"<anonymized_userid>",1,2361,889,"Mark Rutte (VVD)",0.593365167127419,0.354607100119665,0
"<anonymized_userid>",1,2362,890,"Mark Rutte (VVD)",0.593616486554411,0.355005983246909,0
"<anonymized_userid>",1,2363,891,"Mark Rutte (VVD)",0.593867805981402,0.355404866374152,0
"<anonymized_userid>",1,2364,892,"Mark Rutte (VVD)",0.594119125408394,0.355803749501396,0
"<anonymized_userid>",1,2365,893,"Mark Rutte (VVD)",0.594370444835386,0.35620263262864,0
"<anonymized_userid>",1,2366,894,"Mark Rutte (VVD)",0.594621764262377,0.356601515755884,0
"<anonymized_userid>",1,2367,895,"Mark Rutte (VVD)",0.594873083689369,0.357000398883127,0
"<anonymized_userid>",1,2368,896,"Mark Rutte (VVD)",0.595124403116361,0.357399282010371,0
"<anonymized_userid>",1,2369,897,"Mark Rutte (VVD)",0.595375722543353,0.357798165137615,0
"<anonymized_userid>",1,2370,898,"Mark Rutte (VVD)",0.595627041970344,0.358197048264858,0
"<anonymized_userid>",1,2371,899,"Mark Rutte (VVD)",0.595878361397336,0.358595931392102,0
"<anonymized_userid>",1,2372,900,"Mark Rutte (VVD)",0.596129680824328,0.358994814519346,0
"<anonymized_userid>",1,2373,901,"Mark Rutte (VVD)",0.596381000251319,0.35939369764659,0
"<anonymized_userid>",1,2374,902,"Mark Rutte (VVD)",0.596632319678311,0.359792580773833,0
"<anonymized_userid>",1,2375,903,"Mark Rutte (VVD)",0.596883639105303,0.360191463901077,0
"<anonymized_userid>",1,2376,904,"Mark Rutte (VVD)",0.597134958532295,0.360590347028321,0
"<anonymized_userid>",1,2377,905,"Mark Rutte (VVD)",0.597386277959286,0.360989230155564,0
"<anonymized_userid>",1,2378,906,"Mark Rutte (VVD)",0.597637597386278,0.361388113282808,0
"<anonymized_userid>",1,2379,907,"Mark Rutte (VVD)",0.59788891681327,0.361786996410052,0
"<anonymized_userid>",1,2380,908,"Mark Rutte (VVD)",0.598140236240261,0.362185879537296,0
"<anonymized_userid>",1,2381,909,"Mark Rutte (VVD)",0.598391555667253,0.362584762664539,0
"<anonymized_userid>",1,2382,910,"Mark Rutte (VVD)",0.598642875094245,0.362983645791783,0
"<anonymized_userid>",1,2383,911,"Mark Rutte (VVD)",0.598894194521236,0.363382528919027,0
"<anonymized_userid>",1,2384,912,"Mark Rutte (VVD)",0.599145513948228,0.36378141204627,0
"<anonymized_userid>",1,2385,913,"Mark Rutte (VVD)",0.59939683337522,0.364180295173514,0
"<anonymized_userid>",1,2386,914,"Mark Rutte (VVD)",0.599648152802212,0.364579178300758,0
"<anonymized_userid>",1,2387,915,"Mark Rutte (VVD)",0.599899472229203,0.364978061428002,0
"<anonymized_userid>",1,2388,916,"Mark Rutte (VVD)",0.600150791656195,0.365376944555245,0
"<anonymized_userid>",1,2389,917,"Mark Rutte (VVD)",0.600402111083187,0.365775827682489,0
"<anonymized_userid>",1,2390,918,"Mark Rutte (VVD)",0.600653430510178,0.366174710809733,0
"<anonymized_userid>",1,2391,919,"Mark Rutte (VVD)",0.60090474993717,0.366573593936976,0
"<anonymized_userid>",1,2392,920,"Mark Rutte (VVD)",0.601156069364162,0.36697247706422,0
"<anonymized_userid>",1,2393,921,"Mark Rutte (VVD)",0.601407388791154,0.367371360191464,0
"<anonymized_userid>",1,2394,922,"Mark Rutte (VVD)",0.601658708218145,0.367770243318708,0
"<anonymized_userid>",1,2395,923,"Mark Rutte (VVD)",0.601910027645137,0.368169126445951,0
"<anonymized_userid>",1,2396,924,"Mark Rutte (VVD)",0.602161347072129,0.368568009573195,0
"<anonymized_userid>",1,2397,925,"Mark Rutte (VVD)",0.60241266649912,0.368966892700439,0
"<anonymized_userid>",1,2398,926,"Mark Rutte (VVD)",0.602663985926112,0.369365775827682,0
"<anonymized_userid>",1,2399,927,"Mark Rutte (VVD)",0.602915305353104,0.369764658954926,0
"<anonymized_userid>",1,2400,928,"Mark Rutte (VVD)",0.603166624780096,0.37016354208217,0
"<anonymized_userid>",1,2401,929,"Mark Rutte (VVD)",0.603417944207087,0.370562425209414,0
"<anonymized_userid>",1,2402,930,"Mark Rutte (VVD)",0.603669263634079,0.370961308336657,0
"<anonymized_userid>",1,2403,931,"Mark Rutte (VVD)",0.603920583061071,0.371360191463901,0
"<anonymized_userid>",1,2404,932,"Mark Rutte (VVD)",0.604171902488062,0.371759074591145,0
"<anonymized_userid>",1,2405,933,"Mark Rutte (VVD)",0.604423221915054,0.372157957718388,0
"<anonymized_userid>",1,2406,934,"Mark Rutte (VVD)",0.604674541342046,0.372556840845632,0
"<anonymized_userid>",1,2407,935,"Mark Rutte (VVD)",0.604925860769037,0.372955723972876,0
"<anonymized_userid>",1,2408,936,"Mark Rutte (VVD)",0.605177180196029,0.37335460710012,0
"<anonymized_userid>",1,2409,937,"Mark Rutte (VVD)",0.605428499623021,0.373753490227363,0
"<anonymized_userid>",1,2410,938,"Mark Rutte (VVD)",0.605679819050013,0.374152373354607,0
"<anonymized_userid>",1,2411,939,"Mark Rutte (VVD)",0.605931138477004,0.374551256481851,0
"<anonymized_userid>",1,2412,940,"Mark Rutte (VVD)",0.606182457903996,0.374950139609095,0
"<anonymized_userid>",1,2413,941,"Mark Rutte (VVD)",0.606433777330988,0.375349022736338,0
"<anonymized_userid>",1,2414,942,"Mark Rutte (VVD)",0.606685096757979,0.375747905863582,0
"<anonymized_userid>",1,2415,943,"Mark Rutte (VVD)",0.606936416184971,0.376146788990826,0
"<anonymized_userid>",1,2416,944,"Mark Rutte (VVD)",0.607187735611963,0.376545672118069,0
"<anonymized_userid>",1,2417,945,"Mark Rutte (VVD)",0.607439055038954,0.376944555245313,0
"<anonymized_userid>",1,2418,946,"Mark Rutte (VVD)",0.607690374465946,0.377343438372557,0
"<anonymized_userid>",1,2419,947,"Mark Rutte (VVD)",0.607941693892938,0.377742321499801,0
"<anonymized_userid>",1,2420,948,"Mark Rutte (VVD)",0.60819301331993,0.378141204627044,0
"<anonymized_userid>",1,2421,949,"Mark Rutte (VVD)",0.608444332746921,0.378540087754288,0
"<anonymized_userid>",1,2422,950,"Mark Rutte (VVD)",0.608695652173913,0.378938970881532,0
"<anonymized_userid>",1,2423,951,"Mark Rutte (VVD)",0.608946971600905,0.379337854008775,0
"<anonymized_userid>",1,2424,952,"Mark Rutte (VVD)",0.609198291027896,0.379736737136019,0
"<anonymized_userid>",1,2425,953,"Mark Rutte (VVD)",0.609449610454888,0.380135620263263,0
"<anonymized_userid>",1,2426,954,"Mark Rutte (VVD)",0.60970092988188,0.380534503390507,0
"<anonymized_userid>",1,2427,955,"Mark Rutte (VVD)",0.609952249308872,0.38093338651775,0
"<anonymized_userid>",1,2428,956,"Mark Rutte (VVD)",0.610203568735863,0.381332269644994,0
"<anonymized_userid>",1,2429,957,"Mark Rutte (VVD)",0.610454888162855,0.381731152772238,0
"<anonymized_userid>",1,2430,958,"Mark Rutte (VVD)",0.610706207589847,0.382130035899481,0
"<anonymized_userid>",1,2431,959,"Mark Rutte (VVD)",0.610957527016838,0.382528919026725,0
"<anonymized_userid>",1,2432,960,"Mark Rutte (VVD)",0.61120884644383,0.382927802153969,0
"<anonymized_userid>",1,2433,961,"Mark Rutte (VVD)",0.611460165870822,0.383326685281213,0
"<anonymized_userid>",1,2434,962,"Mark Rutte (VVD)",0.611711485297813,0.383725568408456,0
"<anonymized_userid>",1,2435,963,"Mark Rutte (VVD)",0.611962804724805,0.3841244515357,0
"<anonymized_userid>",1,2436,964,"Mark Rutte (VVD)",0.612214124151797,0.384523334662944,0
"<anonymized_userid>",1,2437,965,"Mark Rutte (VVD)",0.612465443578789,0.384922217790187,0
"<anonymized_userid>",1,2438,966,"Mark Rutte (VVD)",0.61271676300578,0.385321100917431,0
"<anonymized_userid>",1,2439,967,"Mark Rutte (VVD)",0.612968082432772,0.385719984044675,0
"<anonymized_userid>",1,2440,968,"Mark Rutte (VVD)",0.613219401859764,0.386118867171919,0
"<anonymized_userid>",1,2441,969,"Mark Rutte (VVD)",0.613470721286756,0.386517750299162,0
"<anonymized_userid>",1,2442,970,"Mark Rutte (VVD)",0.613722040713747,0.386916633426406,0
"<anonymized_userid>",1,2443,971,"Mark Rutte (VVD)",0.613973360140739,0.38731551655365,0
"<anonymized_userid>",1,2444,972,"Mark Rutte (VVD)",0.614224679567731,0.387714399680893,0
"<anonymized_userid>",1,2445,973,"Mark Rutte (VVD)",0.614475998994722,0.388113282808137,0
"<anonymized_userid>",1,2446,974,"Mark Rutte (VVD)",0.614727318421714,0.388512165935381,0
"<anonymized_userid>",1,2447,975,"Mark Rutte (VVD)",0.614978637848706,0.388911049062625,0
"<anonymized_userid>",1,2448,976,"Mark Rutte (VVD)",0.615229957275697,0.389309932189868,0
"<anonymized_userid>",1,2449,977,"Mark Rutte (VVD)",0.615481276702689,0.389708815317112,0
"<anonymized_userid>",1,2450,978,"Mark Rutte (VVD)",0.615732596129681,0.390107698444356,0
"<anonymized_userid>",1,2451,979,"Mark Rutte (VVD)",0.615983915556673,0.3905065815716,0
"<anonymized_userid>",1,2452,980,"Mark Rutte (VVD)",0.616235234983664,0.390905464698843,0
"<anonymized_userid>",1,2453,981,"Mark Rutte (VVD)",0.616486554410656,0.391304347826087,0
"<anonymized_userid>",1,2454,982,"Mark Rutte (VVD)",0.616737873837648,0.391703230953331,0
"<anonymized_userid>",1,2455,983,"Mark Rutte (VVD)",0.616989193264639,0.392102114080574,0
"<anonymized_userid>",1,2456,984,"Mark Rutte (VVD)",0.617240512691631,0.392500997207818,0
"<anonymized_userid>",1,2457,985,"Mark Rutte (VVD)",0.617491832118623,0.392899880335062,0
"<anonymized_userid>",1,2458,986,"Mark Rutte (VVD)",0.617743151545614,0.393298763462306,0
"<anonymized_userid>",1,2459,987,"Mark Rutte (VVD)",0.617994470972606,0.393697646589549,0
"<anonymized_userid>",1,2460,988,"Mark Rutte (VVD)",0.618245790399598,0.394096529716793,0
"<anonymized_userid>",1,2461,989,"Mark Rutte (VVD)",0.61849710982659,0.394495412844037,0
"<anonymized_userid>",1,2462,990,"Mark Rutte (VVD)",0.618748429253581,0.39489429597128,0
"<anonymized_userid>",1,2463,991,"Mark Rutte (VVD)",0.618999748680573,0.395293179098524,0
"<anonymized_userid>",1,2464,992,"Mark Rutte (VVD)",0.619251068107565,0.395692062225768,0
"<anonymized_userid>",1,2465,993,"Mark Rutte (VVD)",0.619502387534556,0.396090945353012,0
"<anonymized_userid>",1,2466,994,"Mark Rutte (VVD)",0.619753706961548,0.396489828480255,0
"<anonymized_userid>",1,2467,995,"Mark Rutte (VVD)",0.62000502638854,0.396888711607499,0
"<anonymized_userid>",1,2468,996,"Mark Rutte (VVD)",0.620256345815532,0.397287594734743,0
"<anonymized_userid>",1,2469,997,"Mark Rutte (VVD)",0.620507665242523,0.397686477861986,0
"<anonymized_userid>",1,2470,998,"Mark Rutte (VVD)",0.620758984669515,0.39808536098923,0
"<anonymized_userid>",1,2471,999,"Mark Rutte (VVD)",0.621010304096507,0.398484244116474,0
"<anonymized_userid>",1,2472,1000,"Mark Rutte (VVD)",0.621261623523498,0.398883127243718,0
"<anonymized_userid>",1,2473,1001,"Mark Rutte (VVD)",0.62151294295049,0.399282010370961,0
"<anonymized_userid>",1,2474,1002,"Mark Rutte (VVD)",0.621764262377482,0.399680893498205,0
"<anonymized_userid>",1,2475,1003,"Mark Rutte (VVD)",0.622015581804473,0.400079776625449,0
"<anonymized_userid>",1,2476,1004,"Mark Rutte (VVD)",0.622266901231465,0.400478659752692,0
"<anonymized_userid>",1,2477,1005,"Mark Rutte (VVD)",0.622518220658457,0.400877542879936,0
"<anonymized_userid>",1,2478,1006,"Mark Rutte (VVD)",0.622769540085449,0.40127642600718,0
"<anonymized_userid>",1,2479,1007,"Mark Rutte (VVD)",0.62302085951244,0.401675309134424,0
"<anonymized_userid>",1,2480,1008,"Mark Rutte (VVD)",0.623272178939432,0.402074192261667,0
"<anonymized_userid>",1,2481,1009,"Mark Rutte (VVD)",0.623523498366424,0.402473075388911,0
"<anonymized_userid>",1,2482,1010,"Mark Rutte (VVD)",0.623774817793415,0.402871958516155,0
"<anonymized_userid>",1,2483,1011,"Mark Rutte (VVD)",0.624026137220407,0.403270841643398,0
"<anonymized_userid>",1,2484,1012,"Mark Rutte (VVD)",0.624277456647399,0.403669724770642,0
"<anonymized_userid>",1,2485,1013,"Mark Rutte (VVD)",0.624528776074391,0.404068607897886,0
"<anonymized_userid>",1,2486,1014,"Mark Rutte (VVD)",0.624780095501382,0.40446749102513,0
"<anonymized_userid>",1,2487,1015,"Mark Rutte (VVD)",0.625031414928374,0.404866374152373,0
"<anonymized_userid>",1,2488,1016,"Mark Rutte (VVD)",0.625282734355366,0.405265257279617,0
"<anonymized_userid>",1,2489,1017,"Mark Rutte (VVD)",0.625534053782357,0.405664140406861,0
"<anonymized_userid>",1,2490,1018,"Mark Rutte (VVD)",0.625785373209349,0.406063023534105,0
"<anonymized_userid>",1,2491,1019,"Mark Rutte (VVD)",0.626036692636341,0.406461906661348,0
"<anonymized_userid>",1,2492,1020,"Mark Rutte (VVD)",0.626288012063333,0.406860789788592,0
"<anonymized_userid>",1,2493,1021,"Mark Rutte (VVD)",0.626539331490324,0.407259672915836,0
"<anonymized_userid>",1,2494,1022,"Mark Rutte (VVD)",0.626790650917316,0.407658556043079,0
"<anonymized_userid>",1,2495,1023,"Mark Rutte (VVD)",0.627041970344308,0.408057439170323,0
"<anonymized_userid>",1,2496,1024,"Mark Rutte (VVD)",0.627293289771299,0.408456322297567,0
"<anonymized_userid>",1,2497,1025,"Mark Rutte (VVD)",0.627544609198291,0.408855205424811,0
"<anonymized_userid>",1,2498,1026,"Mark Rutte (VVD)",0.627795928625283,0.409254088552054,0
"<anonymized_userid>",1,2499,1027,"Mark Rutte (VVD)",0.628047248052274,0.409652971679298,0
"<anonymized_userid>",1,2500,1028,"Mark Rutte (VVD)",0.628298567479266,0.410051854806542,0
"<anonymized_userid>",1,2501,1029,"Mark Rutte (VVD)",0.628549886906258,0.410450737933785,0
"<anonymized_userid>",1,2502,1030,"Mark Rutte (VVD)",0.62880120633325,0.410849621061029,0
"<anonymized_userid>",1,2503,1031,"Mark Rutte (VVD)",0.629052525760241,0.411248504188273,0
"<anonymized_userid>",1,2504,1032,"Mark Rutte (VVD)",0.629303845187233,0.411647387315517,0
"<anonymized_userid>",1,2505,1033,"Mark Rutte (VVD)",0.629555164614225,0.41204627044276,0
"<anonymized_userid>",1,2506,1034,"Mark Rutte (VVD)",0.629806484041216,0.412445153570004,0
"<anonymized_userid>",1,2507,1035,"Mark Rutte (VVD)",0.630057803468208,0.412844036697248,0
"<anonymized_userid>",1,2508,1036,"Mark Rutte (VVD)",0.6303091228952,0.413242919824491,0
"<anonymized_userid>",1,2509,1037,"Mark Rutte (VVD)",0.630560442322192,0.413641802951735,0
"<anonymized_userid>",1,2510,1038,"Mark Rutte (VVD)",0.630811761749183,0.414040686078979,0
"<anonymized_userid>",1,2511,1039,"Mark Rutte (VVD)",0.631063081176175,0.414439569206223,0
"<anonymized_userid>",1,2512,1040,"Mark Rutte (VVD)",0.631314400603167,0.414838452333466,0
"<anonymized_userid>",1,2513,1041,"Mark Rutte (VVD)",0.631565720030158,0.41523733546071,0
"<anonymized_userid>",1,2514,1042,"Mark Rutte (VVD)",0.63181703945715,0.415636218587954,0
"<anonymized_userid>",1,2515,1043,"Mark Rutte (VVD)",0.632068358884142,0.416035101715197,0
"<anonymized_userid>",1,2516,1044,"Mark Rutte (VVD)",0.632319678311133,0.416433984842441,0
"<anonymized_userid>",1,2517,1045,"Mark Rutte (VVD)",0.632570997738125,0.416832867969685,0
"<anonymized_userid>",1,2518,1046,"Mark Rutte (VVD)",0.632822317165117,0.417231751096929,0
"<anonymized_userid>",1,2519,1047,"Mark Rutte (VVD)",0.633073636592109,0.417630634224172,0
"<anonymized_userid>",1,2520,1048,"Mark Rutte (VVD)",0.6333249560191,0.418029517351416,0
"<anonymized_userid>",1,2521,1049,"Mark Rutte (VVD)",0.633576275446092,0.41842840047866,0
"<anonymized_userid>",1,2522,1050,"Mark Rutte (VVD)",0.633827594873084,0.418827283605903,0
"<anonymized_userid>",1,2523,1051,"Mark Rutte (VVD)",0.634078914300075,0.419226166733147,0
"<anonymized_userid>",1,2524,1052,"Mark Rutte (VVD)",0.634330233727067,0.419625049860391,0
"<anonymized_userid>",1,2525,1053,"Mark Rutte (VVD)",0.634581553154059,0.420023932987635,0
"<anonymized_userid>",1,2526,1054,"Mark Rutte (VVD)",0.63483287258105,0.420422816114878,0
"<anonymized_userid>",1,2527,1055,"Mark Rutte (VVD)",0.635084192008042,0.420821699242122,0
"<anonymized_userid>",1,2528,1056,"Mark Rutte (VVD)",0.635335511435034,0.421220582369366,0
"<anonymized_userid>",1,2529,1057,"Mark Rutte (VVD)",0.635586830862026,0.42161946549661,0
"<anonymized_userid>",1,2530,1058,"Mark Rutte (VVD)",0.635838150289017,0.422018348623853,0
"<anonymized_userid>",1,2531,1059,"Mark Rutte (VVD)",0.636089469716009,0.422417231751097,0
"<anonymized_userid>",1,2532,1060,"Mark Rutte (VVD)",0.636340789143001,0.422816114878341,0
"<anonymized_userid>",1,2533,1061,"Mark Rutte (VVD)",0.636592108569992,0.423214998005584,0
"<anonymized_userid>",1,2534,1062,"Mark Rutte (VVD)",0.636843427996984,0.423613881132828,0
"<anonymized_userid>",1,2535,1063,"Mark Rutte (VVD)",0.637094747423976,0.424012764260072,0
"<anonymized_userid>",1,2536,1064,"Mark Rutte (VVD)",0.637346066850968,0.424411647387316,0
"<anonymized_userid>",1,2537,1065,"Mark Rutte (VVD)",0.637597386277959,0.424810530514559,0
"<anonymized_userid>",1,2538,1066,"Mark Rutte (VVD)",0.637848705704951,0.425209413641803,0
"<anonymized_userid>",1,2539,1067,"Mark Rutte (VVD)",0.638100025131943,0.425608296769047,0
"<anonymized_userid>",1,2540,1068,"Mark Rutte (VVD)",0.638351344558934,0.42600717989629,0
"<anonymized_userid>",1,2541,1069,"Mark Rutte (VVD)",0.638602663985926,0.426406063023534,0
"<anonymized_userid>",1,2542,1070,"Mark Rutte (VVD)",0.638853983412918,0.426804946150778,0
"<anonymized_userid>",1,2543,1071,"Mark Rutte (VVD)",0.63910530283991,0.427203829278022,0
"<anonymized_userid>",1,2544,1072,"Mark Rutte (VVD)",0.639356622266901,0.427602712405265,0
"<anonymized_userid>",1,2545,1073,"Mark Rutte (VVD)",0.639607941693893,0.428001595532509,0
"<anonymized_userid>",1,2546,1074,"Mark Rutte (VVD)",0.639859261120885,0.428400478659753,0
"<anonymized_userid>",1,2547,1075,"Mark Rutte (VVD)",0.640110580547876,0.428799361786996,0
"<anonymized_userid>",1,2548,1076,"Mark Rutte (VVD)",0.640361899974868,0.42919824491424,0
"<anonymized_userid>",1,2549,1077,"Mark Rutte (VVD)",0.64061321940186,0.429597128041484,0
"<anonymized_userid>",1,2550,1078,"Mark Rutte (VVD)",0.640864538828851,0.429996011168728,0
"<anonymized_userid>",1,2551,1079,"Mark Rutte (VVD)",0.641115858255843,0.430394894295971,0
"<anonymized_userid>",1,2552,1080,"Mark Rutte (VVD)",0.641367177682835,0.430793777423215,0
"<anonymized_userid>",1,2553,1081,"Mark Rutte (VVD)",0.641618497109827,0.431192660550459,0
"<anonymized_userid>",1,2554,1082,"Mark Rutte (VVD)",0.641869816536818,0.431591543677702,0
"<anonymized_userid>",1,2555,1083,"Mark Rutte (VVD)",0.64212113596381,0.431990426804946,0
"<anonymized_userid>",1,2556,1084,"Mark Rutte (VVD)",0.642372455390802,0.43238930993219,0
"<anonymized_userid>",1,2557,1085,"Mark Rutte (VVD)",0.642623774817793,0.432788193059434,0
"<anonymized_userid>",1,2558,1086,"Mark Rutte (VVD)",0.642875094244785,0.433187076186677,0
"<anonymized_userid>",1,2559,1087,"Mark Rutte (VVD)",0.643126413671777,0.433585959313921,0
"<anonymized_userid>",1,2560,1088,"Mark Rutte (VVD)",0.643377733098769,0.433984842441165,0
"<anonymized_userid>",1,2561,1089,"Mark Rutte (VVD)",0.64362905252576,0.434383725568408,0
"<anonymized_userid>",1,2562,1090,"Mark Rutte (VVD)",0.643880371952752,0.434782608695652,0
"<anonymized_userid>",1,2563,1091,"Mark Rutte (VVD)",0.644131691379744,0.435181491822896,0
"<anonymized_userid>",1,2564,1092,"Mark Rutte (VVD)",0.644383010806735,0.43558037495014,0
"<anonymized_userid>",1,2565,1093,"Mark Rutte (VVD)",0.644634330233727,0.435979258077383,0
"<anonymized_userid>",1,2566,1094,"Mark Rutte (VVD)",0.644885649660719,0.436378141204627,0
"<anonymized_userid>",1,2567,1095,"Mark Rutte (VVD)",0.64513696908771,0.436777024331871,0
"<anonymized_userid>",1,2568,1096,"Mark Rutte (VVD)",0.645388288514702,0.437175907459114,0
"<anonymized_userid>",1,2569,1097,"Mark Rutte (VVD)",0.645639607941694,0.437574790586358,0
"<anonymized_userid>",1,2570,1098,"Mark Rutte (VVD)",0.645890927368686,0.437973673713602,0
"<anonymized_userid>",1,2571,1099,"Mark Rutte (VVD)",0.646142246795677,0.438372556840846,0
"<anonymized_userid>",1,2572,1100,"Mark Rutte (VVD)",0.646393566222669,0.438771439968089,0
"<anonymized_userid>",1,2573,1101,"Mark Rutte (VVD)",0.646644885649661,0.439170323095333,0
"<anonymized_userid>",1,2574,1102,"Mark Rutte (VVD)",0.646896205076652,0.439569206222577,0
"<anonymized_userid>",1,2575,1103,"Mark Rutte (VVD)",0.647147524503644,0.439968089349821,0
"<anonymized_userid>",1,2576,1104,"Mark Rutte (VVD)",0.647398843930636,0.440366972477064,0
"<anonymized_userid>",1,2577,1105,"Mark Rutte (VVD)",0.647650163357628,0.440765855604308,0
"<anonymized_userid>",1,2578,1106,"Mark Rutte (VVD)",0.647901482784619,0.441164738731552,0
"<anonymized_userid>",1,2579,1107,"Mark Rutte (VVD)",0.648152802211611,0.441563621858795,0
"<anonymized_userid>",1,2580,1108,"Mark Rutte (VVD)",0.648404121638603,0.441962504986039,0
"<anonymized_userid>",1,2581,1109,"Mark Rutte (VVD)",0.648655441065594,0.442361388113283,0
"<anonymized_userid>",1,2582,1110,"Mark Rutte (VVD)",0.648906760492586,0.442760271240527,0
"<anonymized_userid>",1,2583,1111,"Mark Rutte (VVD)",0.649158079919578,0.44315915436777,0
"<anonymized_userid>",1,2584,1112,"Mark Rutte (VVD)",0.649409399346569,0.443558037495014,0
"<anonymized_userid>",1,2585,1113,"Mark Rutte (VVD)",0.649660718773561,0.443956920622258,0
"<anonymized_userid>",1,2586,1114,"Mark Rutte (VVD)",0.649912038200553,0.444355803749501,0
"<anonymized_userid>",1,2587,1115,"Mark Rutte (VVD)",0.650163357627545,0.444754686876745,0
"<anonymized_userid>",1,2588,1116,"Mark Rutte (VVD)",0.650414677054536,0.445153570003989,0
"<anonymized_userid>",1,2589,1117,"Mark Rutte (VVD)",0.650665996481528,0.445552453131233,0
"<anonymized_userid>",1,2590,1118,"Mark Rutte (VVD)",0.65091731590852,0.445951336258476,0
"<anonymized_userid>",1,2591,1119,"Mark Rutte (VVD)",0.651168635335511,0.44635021938572,0
"<anonymized_userid>",1,2592,1120,"Mark Rutte (VVD)",0.651419954762503,0.446749102512964,0
"<anonymized_userid>",1,2593,1121,"Mark Rutte (VVD)",0.651671274189495,0.447147985640207,0
"<anonymized_userid>",1,2594,1122,"Mark Rutte (VVD)",0.651922593616487,0.447546868767451,0
"<anonymized_userid>",1,2595,1123,"Mark Rutte (VVD)",0.652173913043478,0.447945751894695,0
"<anonymized_userid>",1,2596,1124,"Mark Rutte (VVD)",0.65242523247047,0.448344635021939,0
"<anonymized_userid>",1,2597,1125,"Mark Rutte (VVD)",0.652676551897462,0.448743518149182,0
"<anonymized_userid>",1,2598,1126,"Mark Rutte (VVD)",0.652927871324453,0.449142401276426,0
"<anonymized_userid>",1,2599,1127,"Mark Rutte (VVD)",0.653179190751445,0.44954128440367,0
"<anonymized_userid>",1,2600,1128,"Mark Rutte (VVD)",0.653430510178437,0.449940167530913,0
"<anonymized_userid>",1,2601,1129,"Mark Rutte (VVD)",0.653681829605429,0.450339050658157,0
"<anonymized_userid>",1,2602,1130,"Mark Rutte (VVD)",0.65393314903242,0.450737933785401,0
"<anonymized_userid>",1,2603,1131,"Mark Rutte (VVD)",0.654184468459412,0.451136816912645,0
"<anonymized_userid>",1,2604,1132,"Mark Rutte (VVD)",0.654435787886404,0.451535700039888,0
"<anonymized_userid>",1,2605,1133,"Mark Rutte (VVD)",0.654687107313395,0.451934583167132,0
"<anonymized_userid>",1,2606,1134,"Mark Rutte (VVD)",0.654938426740387,0.452333466294376,0
"<anonymized_userid>",1,2607,1135,"Mark Rutte (VVD)",0.655189746167379,0.452732349421619,0
"<anonymized_userid>",1,2608,1136,"Mark Rutte (VVD)",0.65544106559437,0.453131232548863,0
"<anonymized_userid>",1,2609,1137,"Mark Rutte (VVD)",0.655692385021362,0.453530115676107,0
"<anonymized_userid>",1,2610,1138,"Mark Rutte (VVD)",0.655943704448354,0.453928998803351,0
"<anonymized_userid>",1,2611,1139,"Mark Rutte (VVD)",0.656195023875346,0.454327881930594,0
"<anonymized_userid>",1,2612,1140,"Mark Rutte (VVD)",0.656446343302337,0.454726765057838,0
"<anonymized_userid>",1,2613,1141,"Mark Rutte (VVD)",0.656697662729329,0.455125648185082,0
"<anonymized_userid>",1,2614,1142,"Mark Rutte (VVD)",0.656948982156321,0.455524531312326,0
"<anonymized_userid>",1,2615,1143,"Mark Rutte (VVD)",0.657200301583312,0.455923414439569,0
"<anonymized_userid>",1,2616,1144,"Mark Rutte (VVD)",0.657451621010304,0.456322297566813,0
"<anonymized_userid>",1,2617,1145,"Mark Rutte (VVD)",0.657702940437296,0.456721180694057,0
"<anonymized_userid>",1,2618,1146,"Mark Rutte (VVD)",0.657954259864287,0.4571200638213,0
"<anonymized_userid>",1,2619,1147,"Mark Rutte (VVD)",0.658205579291279,0.457518946948544,0
"<anonymized_userid>",1,2620,1148,"Mark Rutte (VVD)",0.658456898718271,0.457917830075788,0
"<anonymized_userid>",1,2621,1149,"Mark Rutte (VVD)",0.658708218145263,0.458316713203032,0
"<anonymized_userid>",1,2622,1150,"Mark Rutte (VVD)",0.658959537572254,0.458715596330275,0
"<anonymized_userid>",1,2623,1151,"Mark Rutte (VVD)",0.659210856999246,0.459114479457519,0
"<anonymized_userid>",1,2624,1152,"Mark Rutte (VVD)",0.659462176426238,0.459513362584763,0
"<anonymized_userid>",1,2625,1153,"Mark Rutte (VVD)",0.659713495853229,0.459912245712006,0
"<anonymized_userid>",1,2626,1154,"Mark Rutte (VVD)",0.659964815280221,0.46031112883925,0
"<anonymized_userid>",1,2627,1155,"Mark Rutte (VVD)",0.660216134707213,0.460710011966494,0
"<anonymized_userid>",1,2628,1156,"Mark Rutte (VVD)",0.660467454134205,0.461108895093738,0
"<anonymized_userid>",1,2629,1157,"Mark Rutte (VVD)",0.660718773561196,0.461507778220981,0
"<anonymized_userid>",1,2630,1158,"Mark Rutte (VVD)",0.660970092988188,0.461906661348225,0
"<anonymized_userid>",1,2631,1159,"Mark Rutte (VVD)",0.66122141241518,0.462305544475469,0
"<anonymized_userid>",1,2632,1160,"Mark Rutte (VVD)",0.661472731842171,0.462704427602712,0
"<anonymized_userid>",1,2633,1161,"Mark Rutte (VVD)",0.661724051269163,0.463103310729956,0
"<anonymized_userid>",1,2634,1162,"Mark Rutte (VVD)",0.661975370696155,0.4635021938572,0
"<anonymized_userid>",1,2635,1163,"Mark Rutte (VVD)",0.662226690123146,0.463901076984444,0
"<anonymized_userid>",1,2636,1164,"Mark Rutte (VVD)",0.662478009550138,0.464299960111687,0
"<anonymized_userid>",1,2637,1165,"Mark Rutte (VVD)",0.66272932897713,0.464698843238931,0
"<anonymized_userid>",1,2638,1166,"Mark Rutte (VVD)",0.662980648404122,0.465097726366175,0
"<anonymized_userid>",1,2639,1167,"Mark Rutte (VVD)",0.663231967831113,0.465496609493418,0
"<anonymized_userid>",1,2640,1168,"Mark Rutte (VVD)",0.663483287258105,0.465895492620662,0
"<anonymized_userid>",1,2641,1169,"Mark Rutte (VVD)",0.663734606685097,0.466294375747906,0
"<anonymized_userid>",1,2642,1170,"Mark Rutte (VVD)",0.663985926112089,0.46669325887515,0
"<anonymized_userid>",1,2643,1171,"Mark Rutte (VVD)",0.66423724553908,0.467092142002393,0
"<anonymized_userid>",1,2644,1172,"Mark Rutte (VVD)",0.664488564966072,0.467491025129637,0
"<anonymized_userid>",1,2645,1173,"Mark Rutte (VVD)",0.664739884393064,0.467889908256881,0
"<anonymized_userid>",1,2646,1174,"Mark Rutte (VVD)",0.664991203820055,0.468288791384124,0
"<anonymized_userid>",1,2647,1175,"Mark Rutte (VVD)",0.665242523247047,0.468687674511368,0
"<anonymized_userid>",1,2648,1176,"Mark Rutte (VVD)",0.665493842674039,0.469086557638612,0
"<anonymized_userid>",1,2649,1177,"Mark Rutte (VVD)",0.66574516210103,0.469485440765856,0
"<anonymized_userid>",1,2650,1178,"Mark Rutte (VVD)",0.665996481528022,0.469884323893099,0
"<anonymized_userid>",1,2651,1179,"Mark Rutte (VVD)",0.666247800955014,0.470283207020343,0
"<anonymized_userid>",1,2652,1180,"Mark Rutte (VVD)",0.666499120382006,0.470682090147587,0
"<anonymized_userid>",1,2653,1181,"Mark Rutte (VVD)",0.666750439808997,0.47108097327483,0
"<anonymized_userid>",1,2654,1182,"Mark Rutte (VVD)",0.667001759235989,0.471479856402074,0
"<anonymized_userid>",1,2655,1183,"Mark Rutte (VVD)",0.667253078662981,0.471878739529318,0
"<anonymized_userid>",1,2656,1184,"Mark Rutte (VVD)",0.667504398089972,0.472277622656562,0
"<anonymized_userid>",1,2657,1185,"Mark Rutte (VVD)",0.667755717516964,0.472676505783805,0
"<anonymized_userid>",1,2658,1186,"Mark Rutte (VVD)",0.668007036943956,0.473075388911049,0
"<anonymized_userid>",1,2659,1187,"Mark Rutte (VVD)",0.668258356370947,0.473474272038293,0
"<anonymized_userid>",1,2660,1188,"Mark Rutte (VVD)",0.668509675797939,0.473873155165537,0
"<anonymized_userid>",1,2661,1189,"Mark Rutte (VVD)",0.668760995224931,0.47427203829278,0
"<anonymized_userid>",1,2662,1190,"Mark Rutte (VVD)",0.669012314651923,0.474670921420024,0
"<anonymized_userid>",1,2663,1191,"Mark Rutte (VVD)",0.669263634078914,0.475069804547268,0
"<anonymized_userid>",1,2664,1192,"Mark Rutte (VVD)",0.669514953505906,0.475468687674511,0
"<anonymized_userid>",1,2665,1193,"Mark Rutte (VVD)",0.669766272932898,0.475867570801755,0
"<anonymized_userid>",1,2666,1194,"Mark Rutte (VVD)",0.670017592359889,0.476266453928999,0
"<anonymized_userid>",1,2667,1195,"Mark Rutte (VVD)",0.670268911786881,0.476665337056243,0
"<anonymized_userid>",1,2668,1196,"Mark Rutte (VVD)",0.670520231213873,0.477064220183486,0
"<anonymized_userid>",1,2669,1197,"Mark Rutte (VVD)",0.670771550640865,0.47746310331073,0
"<anonymized_userid>",1,2670,1198,"Mark Rutte (VVD)",0.671022870067856,0.477861986437974,0
"<anonymized_userid>",1,2671,1199,"Mark Rutte (VVD)",0.671274189494848,0.478260869565217,0
"<anonymized_userid>",1,2672,1200,"Mark Rutte (VVD)",0.67152550892184,0.478659752692461,0
"<anonymized_userid>",1,2673,1201,"Mark Rutte (VVD)",0.671776828348831,0.479058635819705,0
"<anonymized_userid>",1,2674,1202,"Mark Rutte (VVD)",0.672028147775823,0.479457518946949,0
"<anonymized_userid>",1,2675,1203,"Mark Rutte (VVD)",0.672279467202815,0.479856402074192,0
"<anonymized_userid>",1,2676,1204,"Mark Rutte (VVD)",0.672530786629806,0.480255285201436,0
"<anonymized_userid>",1,2677,1205,"Mark Rutte (VVD)",0.672782106056798,0.48065416832868,0
"<anonymized_userid>",1,2678,1206,"Mark Rutte (VVD)",0.67303342548379,0.481053051455923,0
"<anonymized_userid>",1,2679,1207,"Mark Rutte (VVD)",0.673284744910782,0.481451934583167,0
"<anonymized_userid>",1,2680,1208,"Mark Rutte (VVD)",0.673536064337773,0.481850817710411,0
"<anonymized_userid>",1,2681,1209,"Mark Rutte (VVD)",0.673787383764765,0.482249700837655,0
"<anonymized_userid>",1,2682,1210,"Mark Rutte (VVD)",0.674038703191757,0.482648583964898,0
"<anonymized_userid>",1,2683,1211,"Mark Rutte (VVD)",0.674290022618748,0.483047467092142,0
"<anonymized_userid>",1,2684,1212,"Mark Rutte (VVD)",0.67454134204574,0.483446350219386,0
"<anonymized_userid>",1,2685,1213,"Mark Rutte (VVD)",0.674792661472732,0.483845233346629,0
"<anonymized_userid>",1,2686,1214,"Mark Rutte (VVD)",0.675043980899724,0.484244116473873,0
"<anonymized_userid>",1,2687,1215,"Mark Rutte (VVD)",0.675295300326715,0.484642999601117,0
"<anonymized_userid>",1,2688,1216,"Mark Rutte (VVD)",0.675546619753707,0.485041882728361,0
"<anonymized_userid>",1,2689,1217,"Mark Rutte (VVD)",0.675797939180699,0.485440765855604,0
"<anonymized_userid>",1,2690,1218,"Mark Rutte (VVD)",0.67604925860769,0.485839648982848,0
"<anonymized_userid>",1,2691,1219,"Mark Rutte (VVD)",0.676300578034682,0.486238532110092,0
"<anonymized_userid>",1,2692,1220,"Mark Rutte (VVD)",0.676551897461674,0.486637415237335,0
"<anonymized_userid>",1,2693,1221,"Mark Rutte (VVD)",0.676803216888666,0.487036298364579,0
"<anonymized_userid>",1,2694,1222,"Mark Rutte (VVD)",0.677054536315657,0.487435181491823,0
"<anonymized_userid>",1,2695,1223,"Mark Rutte (VVD)",0.677305855742649,0.487834064619067,0
"<anonymized_userid>",1,2696,1224,"Mark Rutte (VVD)",0.677557175169641,0.48823294774631,0
"<anonymized_userid>",1,2697,1225,"Mark Rutte (VVD)",0.677808494596632,0.488631830873554,0
"<anonymized_userid>",1,2698,1226,"Mark Rutte (VVD)",0.678059814023624,0.489030714000798,0
"<anonymized_userid>",1,2699,1227,"Mark Rutte (VVD)",0.678311133450616,0.489429597128041,0
"<anonymized_userid>",1,2700,1228,"Mark Rutte (VVD)",0.678562452877607,0.489828480255285,0
"<anonymized_userid>",1,2701,1229,"Mark Rutte (VVD)",0.678813772304599,0.490227363382529,0
"<anonymized_userid>",1,2702,1230,"Mark Rutte (VVD)",0.679065091731591,0.490626246509773,0
"<anonymized_userid>",1,2703,1231,"Mark Rutte (VVD)",0.679316411158583,0.491025129637016,0
"<anonymized_userid>",1,2704,1232,"Mark Rutte (VVD)",0.679567730585574,0.49142401276426,0
"<anonymized_userid>",1,2705,1233,"Mark Rutte (VVD)",0.679819050012566,0.491822895891504,0
"<anonymized_userid>",1,2706,1234,"Mark Rutte (VVD)",0.680070369439558,0.492221779018748,0
"<anonymized_userid>",1,2707,1235,"Mark Rutte (VVD)",0.680321688866549,0.492620662145991,0
"<anonymized_userid>",1,2708,1236,"Mark Rutte (VVD)",0.680573008293541,0.493019545273235,0
"<anonymized_userid>",1,2709,1237,"Mark Rutte (VVD)",0.680824327720533,0.493418428400479,0
"<anonymized_userid>",1,2710,1238,"Mark Rutte (VVD)",0.681075647147525,0.493817311527722,0
"<anonymized_userid>",1,2711,1239,"Mark Rutte (VVD)",0.681326966574516,0.494216194654966,0
"<anonymized_userid>",1,2712,1240,"Mark Rutte (VVD)",0.681578286001508,0.49461507778221,0
"<anonymized_userid>",1,2713,1241,"Mark Rutte (VVD)",0.6818296054285,0.495013960909454,0
"<anonymized_userid>",1,2714,1242,"Mark Rutte (VVD)",0.682080924855491,0.495412844036697,0
"<anonymized_userid>",1,2715,1243,"Mark Rutte (VVD)",0.682332244282483,0.495811727163941,0
"<anonymized_userid>",1,2716,1244,"Mark Rutte (VVD)",0.682583563709475,0.496210610291185,0
"<anonymized_userid>",1,2717,1245,"Mark Rutte (VVD)",0.682834883136466,0.496609493418428,0
"<anonymized_userid>",1,2718,1246,"Mark Rutte (VVD)",0.683086202563458,0.497008376545672,0
"<anonymized_userid>",1,2719,1247,"Mark Rutte (VVD)",0.68333752199045,0.497407259672916,0
"<anonymized_userid>",1,2720,1248,"Mark Rutte (VVD)",0.683588841417442,0.49780614280016,0
"<anonymized_userid>",1,2721,1249,"Mark Rutte (VVD)",0.683840160844433,0.498205025927403,0
"<anonymized_userid>",1,2722,1250,"Mark Rutte (VVD)",0.684091480271425,0.498603909054647,0
"<anonymized_userid>",1,2723,1251,"Mark Rutte (VVD)",0.684342799698417,0.499002792181891,0
"<anonymized_userid>",1,2724,1252,"Mark Rutte (VVD)",0.684594119125408,0.499401675309134,0
"<anonymized_userid>",1,2725,1253,"Mark Rutte (VVD)",0.6848454385524,0.499800558436378,0
"<anonymized_userid>",1,2726,1254,"Mark Rutte (VVD)",0.685096757979392,0.500199441563622,1
"<anonymized_userid>",1,2727,1255,"Mark Rutte (VVD)",0.685348077406383,0.500598324690866,0
"<anonymized_userid>",1,2728,1256,"Mark Rutte (VVD)",0.685599396833375,0.500997207818109,0
"<anonymized_userid>",1,2729,1257,"Mark Rutte (VVD)",0.685850716260367,0.501396090945353,0
"<anonymized_userid>",1,2730,1258,"Mark Rutte (VVD)",0.686102035687359,0.501794974072597,0
"<anonymized_userid>",1,2731,1259,"Mark Rutte (VVD)",0.68635335511435,0.50219385719984,0
"<anonymized_userid>",1,2732,1260,"Mark Rutte (VVD)",0.686604674541342,0.502592740327084,0
"<anonymized_userid>",1,2733,1261,"Mark Rutte (VVD)",0.686855993968334,0.502991623454328,0
"<anonymized_userid>",1,2734,1262,"Mark Rutte (VVD)",0.687107313395325,0.503390506581572,0
"<anonymized_userid>",1,2735,1263,"Mark Rutte (VVD)",0.687358632822317,0.503789389708815,0
"<anonymized_userid>",1,2736,1264,"Mark Rutte (VVD)",0.687609952249309,0.504188272836059,0
"<anonymized_userid>",1,2737,1265,"Mark Rutte (VVD)",0.687861271676301,0.504587155963303,0
"<anonymized_userid>",1,2738,1266,"Mark Rutte (VVD)",0.688112591103292,0.504986039090547,0
"<anonymized_userid>",1,2739,1267,"Mark Rutte (VVD)",0.688363910530284,0.50538492221779,0
"<anonymized_userid>",1,2740,1268,"Mark Rutte (VVD)",0.688615229957276,0.505783805345034,0
"<anonymized_userid>",1,2741,1269,"Mark Rutte (VVD)",0.688866549384267,0.506182688472278,0
"<anonymized_userid>",1,2742,1270,"Mark Rutte (VVD)",0.689117868811259,0.506581571599521,0
"<anonymized_userid>",1,2743,1271,"Mark Rutte (VVD)",0.689369188238251,0.506980454726765,0
"<anonymized_userid>",1,2744,1272,"Mark Rutte (VVD)",0.689620507665243,0.507379337854009,0
"<anonymized_userid>",1,2745,1273,"Mark Rutte (VVD)",0.689871827092234,0.507778220981252,0
"<anonymized_userid>",1,2746,1274,"Mark Rutte (VVD)",0.690123146519226,0.508177104108496,0
"<anonymized_userid>",1,2747,1275,"Mark Rutte (VVD)",0.690374465946218,0.50857598723574,0
"<anonymized_userid>",1,2748,1276,"Mark Rutte (VVD)",0.690625785373209,0.508974870362984,0
"<anonymized_userid>",1,2749,1277,"Mark Rutte (VVD)",0.690877104800201,0.509373753490227,0
"<anonymized_userid>",1,2750,1278,"Mark Rutte (VVD)",0.691128424227193,0.509772636617471,0
"<anonymized_userid>",1,2751,1279,"Mark Rutte (VVD)",0.691379743654184,0.510171519744715,0
"<anonymized_userid>",1,2752,1280,"Mark Rutte (VVD)",0.691631063081176,0.510570402871959,0
"<anonymized_userid>",1,2753,1281,"Mark Rutte (VVD)",0.691882382508168,0.510969285999202,0
"<anonymized_userid>",1,2754,1282,"Mark Rutte (VVD)",0.69213370193516,0.511368169126446,0
"<anonymized_userid>",1,2755,1283,"Mark Rutte (VVD)",0.692385021362151,0.51176705225369,0
"<anonymized_userid>",1,2756,1284,"Mark Rutte (VVD)",0.692636340789143,0.512165935380933,0
"<anonymized_userid>",1,2757,1285,"Mark Rutte (VVD)",0.692887660216135,0.512564818508177,0
"<anonymized_userid>",1,2758,1286,"Mark Rutte (VVD)",0.693138979643126,0.512963701635421,0
"<anonymized_userid>",1,2759,1287,"Mark Rutte (VVD)",0.693390299070118,0.513362584762664,0
"<anonymized_userid>",1,2760,1288,"Mark Rutte (VVD)",0.69364161849711,0.513761467889908,0
"<anonymized_userid>",1,2761,1289,"Mark Rutte (VVD)",0.693892937924102,0.514160351017152,0
"<anonymized_userid>",1,2762,1290,"Mark Rutte (VVD)",0.694144257351093,0.514559234144396,0
"<anonymized_userid>",1,2763,1291,"Mark Rutte (VVD)",0.694395576778085,0.514958117271639,0
"<anonymized_userid>",1,2764,1292,"Mark Rutte (VVD)",0.694646896205077,0.515357000398883,0
"<anonymized_userid>",1,2765,1293,"Mark Rutte (VVD)",0.694898215632068,0.515755883526127,0
"<anonymized_userid>",1,2766,1294,"Mark Rutte (VVD)",0.69514953505906,0.516154766653371,0
"<anonymized_userid>",1,2767,1295,"Mark Rutte (VVD)",0.695400854486052,0.516553649780614,0
"<anonymized_userid>",1,2768,1296,"Mark Rutte (VVD)",0.695652173913043,0.516952532907858,0
"<anonymized_userid>",1,2769,1297,"Mark Rutte (VVD)",0.695903493340035,0.517351416035102,0
"<anonymized_userid>",1,2770,1298,"Mark Rutte (VVD)",0.696154812767027,0.517750299162345,0
"<anonymized_userid>",1,2771,1299,"Mark Rutte (VVD)",0.696406132194019,0.518149182289589,0
"<anonymized_userid>",1,2772,1300,"Mark Rutte (VVD)",0.69665745162101,0.518548065416833,0
"<anonymized_userid>",1,2773,1301,"Mark Rutte (VVD)",0.696908771048002,0.518946948544077,0
"<anonymized_userid>",1,2774,1302,"Mark Rutte (VVD)",0.697160090474994,0.51934583167132,0
"<anonymized_userid>",1,2775,1303,"Mark Rutte (VVD)",0.697411409901985,0.519744714798564,0
"<anonymized_userid>",1,2776,1304,"Mark Rutte (VVD)",0.697662729328977,0.520143597925808,0
"<anonymized_userid>",1,2777,1305,"Mark Rutte (VVD)",0.697914048755969,0.520542481053051,0
"<anonymized_userid>",1,2778,1306,"Mark Rutte (VVD)",0.69816536818296,0.520941364180295,0
"<anonymized_userid>",1,2779,1307,"Mark Rutte (VVD)",0.698416687609952,0.521340247307539,0
"<anonymized_userid>",1,2780,1308,"Mark Rutte (VVD)",0.698668007036944,0.521739130434783,0
"<anonymized_userid>",1,2781,1309,"Mark Rutte (VVD)",0.698919326463936,0.522138013562026,0
"<anonymized_userid>",1,2782,1310,"Mark Rutte (VVD)",0.699170645890927,0.52253689668927,0
"<anonymized_userid>",1,2783,1311,"Mark Rutte (VVD)",0.699421965317919,0.522935779816514,0
"<anonymized_userid>",1,2784,1312,"Mark Rutte (VVD)",0.699673284744911,0.523334662943758,0
"<anonymized_userid>",1,2785,1313,"Mark Rutte (VVD)",0.699924604171902,0.523733546071001,0
"<anonymized_userid>",1,2786,1314,"Mark Rutte (VVD)",0.700175923598894,0.524132429198245,0
"<anonymized_userid>",1,2787,1315,"Mark Rutte (VVD)",0.700427243025886,0.524531312325489,0
"<anonymized_userid>",1,2788,1316,"Mark Rutte (VVD)",0.700678562452878,0.524930195452732,0
"<anonymized_userid>",1,2789,1317,"Mark Rutte (VVD)",0.700929881879869,0.525329078579976,0
"<anonymized_userid>",1,2790,1318,"Mark Rutte (VVD)",0.701181201306861,0.52572796170722,0
"<anonymized_userid>",1,2791,1319,"Mark Rutte (VVD)",0.701432520733853,0.526126844834463,0
"<anonymized_userid>",1,2792,1320,"Mark Rutte (VVD)",0.701683840160844,0.526525727961707,0
"<anonymized_userid>",1,2793,1321,"Mark Rutte (VVD)",0.701935159587836,0.526924611088951,0
"<anonymized_userid>",1,2794,1322,"Mark Rutte (VVD)",0.702186479014828,0.527323494216195,0
"<anonymized_userid>",1,2795,1323,"Mark Rutte (VVD)",0.70243779844182,0.527722377343438,0
"<anonymized_userid>",1,2796,1324,"Mark Rutte (VVD)",0.702689117868811,0.528121260470682,0
"<anonymized_userid>",1,2797,1325,"Mark Rutte (VVD)",0.702940437295803,0.528520143597926,0
"<anonymized_userid>",1,2798,1326,"Mark Rutte (VVD)",0.703191756722795,0.52891902672517,0
"<anonymized_userid>",1,2799,1327,"Mark Rutte (VVD)",0.703443076149786,0.529317909852413,0
"<anonymized_userid>",1,2800,1328,"Mark Rutte (VVD)",0.703694395576778,0.529716792979657,0
"<anonymized_userid>",1,2801,1329,"Mark Rutte (VVD)",0.70394571500377,0.530115676106901,0
"<anonymized_userid>",1,2802,1330,"Mark Rutte (VVD)",0.704197034430762,0.530514559234144,0
"<anonymized_userid>",1,2803,1331,"Mark Rutte (VVD)",0.704448353857753,0.530913442361388,0
"<anonymized_userid>",1,2804,1332,"Mark Rutte (VVD)",0.704699673284745,0.531312325488632,0
"<anonymized_userid>",1,2805,1333,"Mark Rutte (VVD)",0.704950992711737,0.531711208615876,0
"<anonymized_userid>",1,2806,1334,"Mark Rutte (VVD)",0.705202312138728,0.532110091743119,0
"<anonymized_userid>",1,2807,1335,"Mark Rutte (VVD)",0.70545363156572,0.532508974870363,0
"<anonymized_userid>",1,2808,1336,"Mark Rutte (VVD)",0.705704950992712,0.532907857997607,0
"<anonymized_userid>",1,2809,1337,"Mark Rutte (VVD)",0.705956270419703,0.53330674112485,0
"<anonymized_userid>",1,2810,1338,"Mark Rutte (VVD)",0.706207589846695,0.533705624252094,0
"<anonymized_userid>",1,2811,1339,"Mark Rutte (VVD)",0.706458909273687,0.534104507379338,0
"<anonymized_userid>",1,2812,1340,"Mark Rutte (VVD)",0.706710228700679,0.534503390506582,0
"<anonymized_userid>",1,2813,1341,"Mark Rutte (VVD)",0.70696154812767,0.534902273633825,0
"<anonymized_userid>",1,2814,1342,"Mark Rutte (VVD)",0.707212867554662,0.535301156761069,0
"<anonymized_userid>",1,2815,1343,"Mark Rutte (VVD)",0.707464186981654,0.535700039888313,0
"<anonymized_userid>",1,2816,1344,"Mark Rutte (VVD)",0.707715506408645,0.536098923015556,0
"<anonymized_userid>",1,2817,1345,"Mark Rutte (VVD)",0.707966825835637,0.5364978061428,0
"<anonymized_userid>",1,2818,1346,"Mark Rutte (VVD)",0.708218145262629,0.536896689270044,0
"<anonymized_userid>",1,2819,1347,"Mark Rutte (VVD)",0.70846946468962,0.537295572397288,0
"<anonymized_userid>",1,2820,1348,"Mark Rutte (VVD)",0.708720784116612,0.537694455524531,0
"<anonymized_userid>",1,2821,1349,"Mark Rutte (VVD)",0.708972103543604,0.538093338651775,0
"<anonymized_userid>",1,2822,1350,"Mark Rutte (VVD)",0.709223422970596,0.538492221779019,0
"<anonymized_userid>",1,2823,1351,"Mark Rutte (VVD)",0.709474742397587,0.538891104906262,0
"<anonymized_userid>",1,2824,1352,"Mark Rutte (VVD)",0.709726061824579,0.539289988033506,0
"<anonymized_userid>",1,2825,1353,"Mark Rutte (VVD)",0.709977381251571,0.53968887116075,0
"<anonymized_userid>",1,2826,1354,"Mark Rutte (VVD)",0.710228700678562,0.540087754287994,0
"<anonymized_userid>",1,2827,1355,"Mark Rutte (VVD)",0.710480020105554,0.540486637415237,0
"<anonymized_userid>",1,2828,1356,"Mark Rutte (VVD)",0.710731339532546,0.540885520542481,0
"<anonymized_userid>",1,2829,1357,"Mark Rutte (VVD)",0.710982658959538,0.541284403669725,0
"<anonymized_userid>",1,2830,1358,"Mark Rutte (VVD)",0.711233978386529,0.541683286796969,0
"<anonymized_userid>",1,2831,1359,"Mark Rutte (VVD)",0.711485297813521,0.542082169924212,0
"<anonymized_userid>",1,2832,1360,"Mark Rutte (VVD)",0.711736617240513,0.542481053051456,0
"<anonymized_userid>",1,2833,1361,"Mark Rutte (VVD)",0.711987936667504,0.5428799361787,0
"<anonymized_userid>",1,2834,1362,"Mark Rutte (VVD)",0.712239256094496,0.543278819305943,0
"<anonymized_userid>",1,2835,1363,"Mark Rutte (VVD)",0.712490575521488,0.543677702433187,0
"<anonymized_userid>",1,2836,1364,"Mark Rutte (VVD)",0.71274189494848,0.544076585560431,0
"<anonymized_userid>",1,2837,1365,"Mark Rutte (VVD)",0.712993214375471,0.544475468687674,0
"<anonymized_userid>",1,2838,1366,"Mark Rutte (VVD)",0.713244533802463,0.544874351814918,0
"<anonymized_userid>",1,2839,1367,"Mark Rutte (VVD)",0.713495853229455,0.545273234942162,0
"<anonymized_userid>",1,2840,1368,"Mark Rutte (VVD)",0.713747172656446,0.545672118069406,0
"<anonymized_userid>",1,2841,1369,"Mark Rutte (VVD)",0.713998492083438,0.546071001196649,0
"<anonymized_userid>",1,2842,1370,"Mark Rutte (VVD)",0.71424981151043,0.546469884323893,0
"<anonymized_userid>",1,2843,1371,"Mark Rutte (VVD)",0.714501130937422,0.546868767451137,0
"<anonymized_userid>",1,2844,1372,"Mark Rutte (VVD)",0.714752450364413,0.547267650578381,0
"<anonymized_userid>",1,2845,1373,"Mark Rutte (VVD)",0.715003769791405,0.547666533705624,0
"<anonymized_userid>",1,2846,1374,"Mark Rutte (VVD)",0.715255089218397,0.548065416832868,0
"<anonymized_userid>",1,2847,1375,"Mark Rutte (VVD)",0.715506408645388,0.548464299960112,0
"<anonymized_userid>",1,2848,1376,"Mark Rutte (VVD)",0.71575772807238,0.548863183087355,0
"<anonymized_userid>",1,2849,1377,"Mark Rutte (VVD)",0.716009047499372,0.549262066214599,0
"<anonymized_userid>",1,2850,1378,"Mark Rutte (VVD)",0.716260366926363,0.549660949341843,0
"<anonymized_userid>",1,2851,1379,"Mark Rutte (VVD)",0.716511686353355,0.550059832469087,0
"<anonymized_userid>",1,2852,1380,"Mark Rutte (VVD)",0.716763005780347,0.55045871559633,0
"<anonymized_userid>",1,2853,1381,"Mark Rutte (VVD)",0.717014325207339,0.550857598723574,0
"<anonymized_userid>",1,2854,1382,"Mark Rutte (VVD)",0.71726564463433,0.551256481850818,0
"<anonymized_userid>",1,2855,1383,"Mark Rutte (VVD)",0.717516964061322,0.551655364978061,0
"<anonymized_userid>",1,2856,1384,"Mark Rutte (VVD)",0.717768283488314,0.552054248105305,0
"<anonymized_userid>",1,2857,1385,"Mark Rutte (VVD)",0.718019602915305,0.552453131232549,0
"<anonymized_userid>",1,2858,1386,"Mark Rutte (VVD)",0.718270922342297,0.552852014359793,0
"<anonymized_userid>",1,2859,1387,"Mark Rutte (VVD)",0.718522241769289,0.553250897487036,0
"<anonymized_userid>",1,2860,1388,"Mark Rutte (VVD)",0.71877356119628,0.55364978061428,0
"<anonymized_userid>",1,2861,1389,"Mark Rutte (VVD)",0.719024880623272,0.554048663741524,0
"<anonymized_userid>",1,2862,1390,"Mark Rutte (VVD)",0.719276200050264,0.554447546868767,0
"<anonymized_userid>",1,2863,1391,"Mark Rutte (VVD)",0.719527519477256,0.554846429996011,0
"<anonymized_userid>",1,2864,1392,"Mark Rutte (VVD)",0.719778838904247,0.555245313123255,0
"<anonymized_userid>",1,2865,1393,"Mark Rutte (VVD)",0.720030158331239,0.555644196250499,0
"<anonymized_userid>",1,2866,1394,"Mark Rutte (VVD)",0.720281477758231,0.556043079377742,0
"<anonymized_userid>",1,2867,1395,"Mark Rutte (VVD)",0.720532797185222,0.556441962504986,0
"<anonymized_userid>",1,2868,1396,"Mark Rutte (VVD)",0.720784116612214,0.55684084563223,0
"<anonymized_userid>",1,2869,1397,"Mark Rutte (VVD)",0.721035436039206,0.557239728759473,0
"<anonymized_userid>",1,2870,1398,"Mark Rutte (VVD)",0.721286755466198,0.557638611886717,0
"<anonymized_userid>",1,2871,1399,"Mark Rutte (VVD)",0.721538074893189,0.558037495013961,0
"<anonymized_userid>",1,2872,1400,"Mark Rutte (VVD)",0.721789394320181,0.558436378141205,0
"<anonymized_userid>",1,2873,1401,"Mark Rutte (VVD)",0.722040713747173,0.558835261268448,0
"<anonymized_userid>",1,2874,1402,"Mark Rutte (VVD)",0.722292033174164,0.559234144395692,0
"<anonymized_userid>",1,2875,1403,"Mark Rutte (VVD)",0.722543352601156,0.559633027522936,0
"<anonymized_userid>",1,2876,1404,"Mark Rutte (VVD)",0.722794672028148,0.56003191065018,0
"<anonymized_userid>",1,2877,1405,"Mark Rutte (VVD)",0.723045991455139,0.560430793777423,0
"<anonymized_userid>",1,2878,1406,"Mark Rutte (VVD)",0.723297310882131,0.560829676904667,0
"<anonymized_userid>",1,2879,1407,"Mark Rutte (VVD)",0.723548630309123,0.561228560031911,0
"<anonymized_userid>",1,2880,1408,"Mark Rutte (VVD)",0.723799949736115,0.561627443159154,0
"<anonymized_userid>",1,2881,1409,"Mark Rutte (VVD)",0.724051269163106,0.562026326286398,0
"<anonymized_userid>",1,2882,1410,"Mark Rutte (VVD)",0.724302588590098,0.562425209413642,0
"<anonymized_userid>",1,2883,1411,"Mark Rutte (VVD)",0.72455390801709,0.562824092540886,0
"<anonymized_userid>",1,2884,1412,"Mark Rutte (VVD)",0.724805227444081,0.563222975668129,0
"<anonymized_userid>",1,2885,1413,"Mark Rutte (VVD)",0.725056546871073,0.563621858795373,0
"<anonymized_userid>",1,2886,1414,"Mark Rutte (VVD)",0.725307866298065,0.564020741922617,0
"<anonymized_userid>",1,2887,1415,"Mark Rutte (VVD)",0.725559185725057,0.56441962504986,0
"<anonymized_userid>",1,2888,1416,"Mark Rutte (VVD)",0.725810505152048,0.564818508177104,0
"<anonymized_userid>",1,2889,1417,"Mark Rutte (VVD)",0.72606182457904,0.565217391304348,0
"<anonymized_userid>",1,2890,1418,"Mark Rutte (VVD)",0.726313144006032,0.565616274431592,0
"<anonymized_userid>",1,2891,1419,"Mark Rutte (VVD)",0.726564463433023,0.566015157558835,0
"<anonymized_userid>",1,2892,1420,"Mark Rutte (VVD)",0.726815782860015,0.566414040686079,0
"<anonymized_userid>",1,2893,1421,"Mark Rutte (VVD)",0.727067102287007,0.566812923813323,0
"<anonymized_userid>",1,2894,1422,"Mark Rutte (VVD)",0.727318421713999,0.567211806940566,0
"<anonymized_userid>",1,2895,1423,"Mark Rutte (VVD)",0.72756974114099,0.56761069006781,0
"<anonymized_userid>",1,2896,1424,"Mark Rutte (VVD)",0.727821060567982,0.568009573195054,0
"<anonymized_userid>",1,2897,1425,"Mark Rutte (VVD)",0.728072379994974,0.568408456322298,0
"<anonymized_userid>",1,2898,1426,"Mark Rutte (VVD)",0.728323699421965,0.568807339449541,0
"<anonymized_userid>",1,2899,1427,"Mark Rutte (VVD)",0.728575018848957,0.569206222576785,0
"<anonymized_userid>",1,2900,1428,"Mark Rutte (VVD)",0.728826338275949,0.569605105704029,0
"<anonymized_userid>",1,2901,1429,"Mark Rutte (VVD)",0.72907765770294,0.570003988831272,0
"<anonymized_userid>",1,2902,1430,"Mark Rutte (VVD)",0.729328977129932,0.570402871958516,0
"<anonymized_userid>",1,2903,1431,"Mark Rutte (VVD)",0.729580296556924,0.57080175508576,0
"<anonymized_userid>",1,2904,1432,"Mark Rutte (VVD)",0.729831615983916,0.571200638213004,0
"<anonymized_userid>",1,2905,1433,"Mark Rutte (VVD)",0.730082935410907,0.571599521340247,0
"<anonymized_userid>",1,2906,1434,"Mark Rutte (VVD)",0.730334254837899,0.571998404467491,0
"<anonymized_userid>",1,2907,1435,"Mark Rutte (VVD)",0.730585574264891,0.572397287594735,0
"<anonymized_userid>",1,2908,1436,"Mark Rutte (VVD)",0.730836893691882,0.572796170721978,0
"<anonymized_userid>",1,2909,1437,"Mark Rutte (VVD)",0.731088213118874,0.573195053849222,0
"<anonymized_userid>",1,2910,1438,"Mark Rutte (VVD)",0.731339532545866,0.573593936976466,0
"<anonymized_userid>",1,2911,1439,"Mark Rutte (VVD)",0.731590851972857,0.57399282010371,0
"<anonymized_userid>",1,2912,1440,"Mark Rutte (VVD)",0.731842171399849,0.574391703230953,0
"<anonymized_userid>",1,2913,1441,"Mark Rutte (VVD)",0.732093490826841,0.574790586358197,0
"<anonymized_userid>",1,2914,1442,"Mark Rutte (VVD)",0.732344810253833,0.575189469485441,0
"<anonymized_userid>",1,2915,1443,"Mark Rutte (VVD)",0.732596129680824,0.575588352612684,0
"<anonymized_userid>",1,2916,1444,"Mark Rutte (VVD)",0.732847449107816,0.575987235739928,0
"<anonymized_userid>",1,2917,1445,"Mark Rutte (VVD)",0.733098768534808,0.576386118867172,0
"<anonymized_userid>",1,2918,1446,"Mark Rutte (VVD)",0.733350087961799,0.576785001994416,0
"<anonymized_userid>",1,2919,1447,"Mark Rutte (VVD)",0.733601407388791,0.577183885121659,0
"<anonymized_userid>",1,2920,1448,"Mark Rutte (VVD)",0.733852726815783,0.577582768248903,0
"<anonymized_userid>",1,2921,1449,"Mark Rutte (VVD)",0.734104046242775,0.577981651376147,0
"<anonymized_userid>",1,2922,1450,"Mark Rutte (VVD)",0.734355365669766,0.578380534503391,0
"<anonymized_userid>",1,2923,1451,"Mark Rutte (VVD)",0.734606685096758,0.578779417630634,0
"<anonymized_userid>",1,2924,1452,"Mark Rutte (VVD)",0.73485800452375,0.579178300757878,0
"<anonymized_userid>",1,2925,1453,"Mark Rutte (VVD)",0.735109323950741,0.579577183885122,0
"<anonymized_userid>",1,2926,1454,"Mark Rutte (VVD)",0.735360643377733,0.579976067012365,0
"<anonymized_userid>",1,2927,1455,"Mark Rutte (VVD)",0.735611962804725,0.580374950139609,0
"<anonymized_userid>",1,2928,1456,"Mark Rutte (VVD)",0.735863282231716,0.580773833266853,0
"<anonymized_userid>",1,2929,1457,"Mark Rutte (VVD)",0.736114601658708,0.581172716394097,0
"<anonymized_userid>",1,2930,1458,"Mark Rutte (VVD)",0.7363659210857,0.58157159952134,0
"<anonymized_userid>",1,2931,1459,"Mark Rutte (VVD)",0.736617240512692,0.581970482648584,0
"<anonymized_userid>",1,2932,1460,"Mark Rutte (VVD)",0.736868559939683,0.582369365775828,0
"<anonymized_userid>",1,2933,1461,"Mark Rutte (VVD)",0.737119879366675,0.582768248903071,0
"<anonymized_userid>",1,2934,1462,"Mark Rutte (VVD)",0.737371198793667,0.583167132030315,0
"<anonymized_userid>",1,2935,1463,"Mark Rutte (VVD)",0.737622518220658,0.583566015157559,0
"<anonymized_userid>",1,2936,1464,"Mark Rutte (VVD)",0.73787383764765,0.583964898284803,0
"<anonymized_userid>",1,2937,1465,"Mark Rutte (VVD)",0.738125157074642,0.584363781412046,0
"<anonymized_userid>",1,2938,1466,"Mark Rutte (VVD)",0.738376476501634,0.58476266453929,0
"<anonymized_userid>",1,2939,1467,"Mark Rutte (VVD)",0.738627795928625,0.585161547666534,0
"<anonymized_userid>",1,2940,1468,"Mark Rutte (VVD)",0.738879115355617,0.585560430793777,0
"<anonymized_userid>",1,2941,1469,"Mark Rutte (VVD)",0.739130434782609,0.585959313921021,0
"<anonymized_userid>",1,2942,1470,"Mark Rutte (VVD)",0.7393817542096,0.586358197048265,0
"<anonymized_userid>",1,2943,1471,"Mark Rutte (VVD)",0.739633073636592,0.586757080175509,0
"<anonymized_userid>",1,2944,1472,"Mark Rutte (VVD)",0.739884393063584,0.587155963302752,0
"<anonymized_userid>",1,2945,1473,"Mark Rutte (VVD)",0.740135712490576,0.587554846429996,0
"<anonymized_userid>",1,2946,1474,"Mark Rutte (VVD)",0.740387031917567,0.58795372955724,0
"<anonymized_userid>",1,2947,1475,"Mark Rutte (VVD)",0.740638351344559,0.588352612684483,0
"<anonymized_userid>",1,2948,1476,"Mark Rutte (VVD)",0.740889670771551,0.588751495811727,0
"<anonymized_userid>",1,2949,1477,"Mark Rutte (VVD)",0.741140990198542,0.589150378938971,0
"<anonymized_userid>",1,2950,1478,"Mark Rutte (VVD)",0.741392309625534,0.589549262066215,0
"<anonymized_userid>",1,2951,1479,"Mark Rutte (VVD)",0.741643629052526,0.589948145193458,0
"<anonymized_userid>",1,2952,1480,"Mark Rutte (VVD)",0.741894948479517,0.590347028320702,0
"<anonymized_userid>",1,2953,1481,"Mark Rutte (VVD)",0.742146267906509,0.590745911447946,0
"<anonymized_userid>",1,2954,1482,"Mark Rutte (VVD)",0.742397587333501,0.591144794575189,0
"<anonymized_userid>",1,2955,1483,"Mark Rutte (VVD)",0.742648906760493,0.591543677702433,0
"<anonymized_userid>",1,2956,1484,"Mark Rutte (VVD)",0.742900226187484,0.591942560829677,0
"<anonymized_userid>",1,2957,1485,"Mark Rutte (VVD)",0.743151545614476,0.592341443956921,0
"<anonymized_userid>",1,2958,1486,"Mark Rutte (VVD)",0.743402865041468,0.592740327084164,0
"<anonymized_userid>",1,2959,1487,"Mark Rutte (VVD)",0.743654184468459,0.593139210211408,0
"<anonymized_userid>",1,2960,1488,"Mark Rutte (VVD)",0.743905503895451,0.593538093338652,0
"<anonymized_userid>",1,2961,1489,"Mark Rutte (VVD)",0.744156823322443,0.593936976465895,0
"<anonymized_userid>",1,2962,1490,"Mark Rutte (VVD)",0.744408142749435,0.594335859593139,0
"<anonymized_userid>",1,2963,1491,"Mark Rutte (VVD)",0.744659462176426,0.594734742720383,0
"<anonymized_userid>",1,2964,1492,"Mark Rutte (VVD)",0.744910781603418,0.595133625847627,0
"<anonymized_userid>",1,2965,1493,"Mark Rutte (VVD)",0.74516210103041,0.59553250897487,0
"<anonymized_userid>",1,2966,1494,"Mark Rutte (VVD)",0.745413420457401,0.595931392102114,0
"<anonymized_userid>",1,2967,1495,"Mark Rutte (VVD)",0.745664739884393,0.596330275229358,0
"<anonymized_userid>",1,2968,1496,"Mark Rutte (VVD)",0.745916059311385,0.596729158356602,0
"<anonymized_userid>",1,2969,1497,"Mark Rutte (VVD)",0.746167378738376,0.597128041483845,0
"<anonymized_userid>",1,2970,1498,"Mark Rutte (VVD)",0.746418698165368,0.597526924611089,0
"<anonymized_userid>",1,2971,1499,"Mark Rutte (VVD)",0.74667001759236,0.597925807738333,0
"<anonymized_userid>",1,2972,1500,"Mark Rutte (VVD)",0.746921337019352,0.598324690865576,0
"<anonymized_userid>",1,2973,1501,"Mark Rutte (VVD)",0.747172656446343,0.59872357399282,0
"<anonymized_userid>",1,2974,1502,"Mark Rutte (VVD)",0.747423975873335,0.599122457120064,0
"<anonymized_userid>",1,2975,1503,"Mark Rutte (VVD)",0.747675295300327,0.599521340247308,0
"<anonymized_userid>",1,2976,1504,"Mark Rutte (VVD)",0.747926614727318,0.599920223374551,0
"<anonymized_userid>",1,2977,1505,"Mark Rutte (VVD)",0.74817793415431,0.600319106501795,0
"<anonymized_userid>",1,2978,1506,"Mark Rutte (VVD)",0.748429253581302,0.600717989629039,0
"<anonymized_userid>",1,2979,1507,"Mark Rutte (VVD)",0.748680573008293,0.601116872756282,0
"<anonymized_userid>",1,2980,1508,"Mark Rutte (VVD)",0.748931892435285,0.601515755883526,0
"<anonymized_userid>",1,2981,1509,"Mark Rutte (VVD)",0.749183211862277,0.60191463901077,0
"<anonymized_userid>",1,2982,1510,"Mark Rutte (VVD)",0.749434531289269,0.602313522138014,0
"<anonymized_userid>",1,2983,1511,"Mark Rutte (VVD)",0.74968585071626,0.602712405265257,0
"<anonymized_userid>",1,2984,1512,"Mark Rutte (VVD)",0.749937170143252,0.603111288392501,0
"<anonymized_userid>",1,2985,1513,"Mark Rutte (VVD)",0.750188489570244,0.603510171519745,0
"<anonymized_userid>",1,2986,1514,"Mark Rutte (VVD)",0.750439808997236,0.603909054646988,0
"<anonymized_userid>",1,2987,1515,"Mark Rutte (VVD)",0.750691128424227,0.604307937774232,0
"<anonymized_userid>",1,2988,1516,"Mark Rutte (VVD)",0.750942447851219,0.604706820901476,0
"<anonymized_userid>",1,2989,1517,"Mark Rutte (VVD)",0.751193767278211,0.60510570402872,0
"<anonymized_userid>",1,2990,1518,"Mark Rutte (VVD)",0.751445086705202,0.605504587155963,0
"<anonymized_userid>",1,2991,1519,"Mark Rutte (VVD)",0.751696406132194,0.605903470283207,0
"<anonymized_userid>",1,2992,1520,"Mark Rutte (VVD)",0.751947725559186,0.606302353410451,0
"<anonymized_userid>",1,2993,1521,"Mark Rutte (VVD)",0.752199044986177,0.606701236537694,0
"<anonymized_userid>",1,2994,1522,"Mark Rutte (VVD)",0.752450364413169,0.607100119664938,0
"<anonymized_userid>",1,2995,1523,"Mark Rutte (VVD)",0.752701683840161,0.607499002792182,0
"<anonymized_userid>",1,2996,1524,"Mark Rutte (VVD)",0.752953003267153,0.607897885919426,0
"<anonymized_userid>",1,2997,1525,"Mark Rutte (VVD)",0.753204322694144,0.608296769046669,0
"<anonymized_userid>",1,2998,1526,"Mark Rutte (VVD)",0.753455642121136,0.608695652173913,0
"<anonymized_userid>",1,2999,1527,"Mark Rutte (VVD)",0.753706961548128,0.609094535301157,0
"<anonymized_userid>",1,3000,1528,"Mark Rutte (VVD)",0.753958280975119,0.6094934184284,0
"<anonymized_userid>",1,3001,1529,"Mark Rutte (VVD)",0.754209600402111,0.609892301555644,0
"<anonymized_userid>",1,3002,1530,"Mark Rutte (VVD)",0.754460919829103,0.610291184682888,0
"<anonymized_userid>",1,3003,1531,"Mark Rutte (VVD)",0.754712239256095,0.610690067810132,0
"<anonymized_userid>",1,3004,1532,"Mark Rutte (VVD)",0.754963558683086,0.611088950937375,0
"<anonymized_userid>",1,3005,1533,"Mark Rutte (VVD)",0.755214878110078,0.611487834064619,0
"<anonymized_userid>",1,3006,1534,"Mark Rutte (VVD)",0.75546619753707,0.611886717191863,0
"<anonymized_userid>",1,3007,1535,"Mark Rutte (VVD)",0.755717516964061,0.612285600319107,0
"<anonymized_userid>",1,3008,1536,"Mark Rutte (VVD)",0.755968836391053,0.61268448344635,0
"<anonymized_userid>",1,3009,1537,"Mark Rutte (VVD)",0.756220155818045,0.613083366573594,0
"<anonymized_userid>",1,3010,1538,"Mark Rutte (VVD)",0.756471475245036,0.613482249700838,0
"<anonymized_userid>",1,3011,1539,"Mark Rutte (VVD)",0.756722794672028,0.613881132828081,0
"<anonymized_userid>",1,3012,1540,"Mark Rutte (VVD)",0.75697411409902,0.614280015955325,0
"<anonymized_userid>",1,3013,1541,"Mark Rutte (VVD)",0.757225433526012,0.614678899082569,0
"<anonymized_userid>",1,3014,1542,"Mark Rutte (VVD)",0.757476752953003,0.615077782209813,0
"<anonymized_userid>",1,3015,1543,"Mark Rutte (VVD)",0.757728072379995,0.615476665337056,0
"<anonymized_userid>",1,3016,1544,"Mark Rutte (VVD)",0.757979391806987,0.6158755484643,0
"<anonymized_userid>",1,3017,1545,"Mark Rutte (VVD)",0.758230711233978,0.616274431591544,0
"<anonymized_userid>",1,3018,1546,"Mark Rutte (VVD)",0.75848203066097,0.616673314718787,0
"<anonymized_userid>",1,3019,1547,"Mark Rutte (VVD)",0.758733350087962,0.617072197846031,0
"<anonymized_userid>",1,3020,1548,"Mark Rutte (VVD)",0.758984669514953,0.617471080973275,0
"<anonymized_userid>",1,3021,1549,"Mark Rutte (VVD)",0.759235988941945,0.617869964100519,0
"<anonymized_userid>",1,3022,1550,"Mark Rutte (VVD)",0.759487308368937,0.618268847227762,0
"<anonymized_userid>",1,3023,1551,"Mark Rutte (VVD)",0.759738627795929,0.618667730355006,0
"<anonymized_userid>",1,3024,1552,"Mark Rutte (VVD)",0.75998994722292,0.61906661348225,0
"<anonymized_userid>",1,3025,1553,"Mark Rutte (VVD)",0.760241266649912,0.619465496609493,0
"<anonymized_userid>",1,3026,1554,"Mark Rutte (VVD)",0.760492586076904,0.619864379736737,0
"<anonymized_userid>",1,3027,1555,"Mark Rutte (VVD)",0.760743905503895,0.620263262863981,0
"<anonymized_userid>",1,3028,1556,"Mark Rutte (VVD)",0.760995224930887,0.620662145991225,0
"<anonymized_userid>",1,3029,1557,"Mark Rutte (VVD)",0.761246544357879,0.621061029118468,0
"<anonymized_userid>",1,3030,1558,"Mark Rutte (VVD)",0.761497863784871,0.621459912245712,0
"<anonymized_userid>",1,3031,1559,"Mark Rutte (VVD)",0.761749183211862,0.621858795372956,0
"<anonymized_userid>",1,3032,1560,"Mark Rutte (VVD)",0.762000502638854,0.622257678500199,0
"<anonymized_userid>",1,3033,1561,"Mark Rutte (VVD)",0.762251822065846,0.622656561627443,0
"<anonymized_userid>",1,3034,1562,"Mark Rutte (VVD)",0.762503141492837,0.623055444754687,0
"<anonymized_userid>",1,3035,1563,"Mark Rutte (VVD)",0.762754460919829,0.623454327881931,0
"<anonymized_userid>",1,3036,1564,"Mark Rutte (VVD)",0.763005780346821,0.623853211009174,0
"<anonymized_userid>",1,3037,1565,"Mark Rutte (VVD)",0.763257099773813,0.624252094136418,0
"<anonymized_userid>",1,3038,1566,"Mark Rutte (VVD)",0.763508419200804,0.624650977263662,0
"<anonymized_userid>",1,3039,1567,"Mark Rutte (VVD)",0.763759738627796,0.625049860390905,0
"<anonymized_userid>",1,3040,1568,"Mark Rutte (VVD)",0.764011058054788,0.625448743518149,0
"<anonymized_userid>",1,3041,1569,"Mark Rutte (VVD)",0.764262377481779,0.625847626645393,0
"<anonymized_userid>",1,3042,1570,"Mark Rutte (VVD)",0.764513696908771,0.626246509772637,0
"<anonymized_userid>",1,3043,1571,"Mark Rutte (VVD)",0.764765016335763,0.62664539289988,0
"<anonymized_userid>",1,3044,1572,"Mark Rutte (VVD)",0.765016335762754,0.627044276027124,0
"<anonymized_userid>",1,3045,1573,"Mark Rutte (VVD)",0.765267655189746,0.627443159154368,0
"<anonymized_userid>",1,3046,1574,"Mark Rutte (VVD)",0.765518974616738,0.627842042281611,0
"<anonymized_userid>",1,3047,1575,"Mark Rutte (VVD)",0.76577029404373,0.628240925408855,0
"<anonymized_userid>",1,3048,1576,"Mark Rutte (VVD)",0.766021613470721,0.628639808536099,0
"<anonymized_userid>",1,3049,1577,"Mark Rutte (VVD)",0.766272932897713,0.629038691663343,0
"<anonymized_userid>",1,3050,1578,"Mark Rutte (VVD)",0.766524252324705,0.629437574790586,0
"<anonymized_userid>",1,3051,1579,"Mark Rutte (VVD)",0.766775571751696,0.62983645791783,0
"<anonymized_userid>",1,3052,1580,"Mark Rutte (VVD)",0.767026891178688,0.630235341045074,0
"<anonymized_userid>",1,3053,1581,"Mark Rutte (VVD)",0.76727821060568,0.630634224172318,0
"<anonymized_userid>",1,3054,1582,"Mark Rutte (VVD)",0.767529530032672,0.631033107299561,0
"<anonymized_userid>",1,3055,1583,"Mark Rutte (VVD)",0.767780849459663,0.631431990426805,0
"<anonymized_userid>",1,3056,1584,"Mark Rutte (VVD)",0.768032168886655,0.631830873554049,0
"<anonymized_userid>",1,3057,1585,"Mark Rutte (VVD)",0.768283488313647,0.632229756681292,0
"<anonymized_userid>",1,3058,1586,"Mark Rutte (VVD)",0.768534807740638,0.632628639808536,0
"<anonymized_userid>",1,3059,1587,"Mark Rutte (VVD)",0.76878612716763,0.63302752293578,0
"<anonymized_userid>",1,3060,1588,"Mark Rutte (VVD)",0.769037446594622,0.633426406063024,0
"<anonymized_userid>",1,3061,1589,"Mark Rutte (VVD)",0.769288766021613,0.633825289190267,0
"<anonymized_userid>",1,3062,1590,"Mark Rutte (VVD)",0.769540085448605,0.634224172317511,0
"<anonymized_userid>",1,3063,1591,"Mark Rutte (VVD)",0.769791404875597,0.634623055444755,0
"<anonymized_userid>",1,3064,1592,"Mark Rutte (VVD)",0.770042724302589,0.635021938571998,0
"<anonymized_userid>",1,3065,1593,"Mark Rutte (VVD)",0.77029404372958,0.635420821699242,0
"<anonymized_userid>",1,3066,1594,"Mark Rutte (VVD)",0.770545363156572,0.635819704826486,0
"<anonymized_userid>",1,3067,1595,"Mark Rutte (VVD)",0.770796682583564,0.63621858795373,0
"<anonymized_userid>",1,3068,1596,"Mark Rutte (VVD)",0.771048002010555,0.636617471080973,0
"<anonymized_userid>",1,3069,1597,"Mark Rutte (VVD)",0.771299321437547,0.637016354208217,0
"<anonymized_userid>",1,3070,1598,"Mark Rutte (VVD)",0.771550640864539,0.637415237335461,0
"<anonymized_userid>",1,3071,1599,"Mark Rutte (VVD)",0.771801960291531,0.637814120462704,0
"<anonymized_userid>",1,3072,1600,"Mark Rutte (VVD)",0.772053279718522,0.638213003589948,0
"<anonymized_userid>",1,3073,1601,"Mark Rutte (VVD)",0.772304599145514,0.638611886717192,0
"<anonymized_userid>",1,3074,1602,"Mark Rutte (VVD)",0.772555918572506,0.639010769844436,0
"<anonymized_userid>",1,3075,1603,"Mark Rutte (VVD)",0.772807237999497,0.639409652971679,0
"<anonymized_userid>",1,3076,1604,"Mark Rutte (VVD)",0.773058557426489,0.639808536098923,0
"<anonymized_userid>",1,3077,1605,"Mark Rutte (VVD)",0.773309876853481,0.640207419226167,0
"<anonymized_userid>",1,3078,1606,"Mark Rutte (VVD)",0.773561196280472,0.64060630235341,0
"<anonymized_userid>",1,3079,1607,"Mark Rutte (VVD)",0.773812515707464,0.641005185480654,0
"<anonymized_userid>",1,3080,1608,"Mark Rutte (VVD)",0.774063835134456,0.641404068607898,0
"<anonymized_userid>",1,3081,1609,"Mark Rutte (VVD)",0.774315154561448,0.641802951735142,0
"<anonymized_userid>",1,3082,1610,"Mark Rutte (VVD)",0.774566473988439,0.642201834862385,0
"<anonymized_userid>",1,3083,1611,"Mark Rutte (VVD)",0.774817793415431,0.642600717989629,0
"<anonymized_userid>",1,3084,1612,"Mark Rutte (VVD)",0.775069112842423,0.642999601116873,0
"<anonymized_userid>",1,3085,1613,"Mark Rutte (VVD)",0.775320432269414,0.643398484244116,0
"<anonymized_userid>",1,3086,1614,"Mark Rutte (VVD)",0.775571751696406,0.64379736737136,0
"<anonymized_userid>",1,3087,1615,"Mark Rutte (VVD)",0.775823071123398,0.644196250498604,0
"<anonymized_userid>",1,3088,1616,"Mark Rutte (VVD)",0.77607439055039,0.644595133625848,0
"<anonymized_userid>",1,3089,1617,"Mark Rutte (VVD)",0.776325709977381,0.644994016753091,0
"<anonymized_userid>",1,3090,1618,"Mark Rutte (VVD)",0.776577029404373,0.645392899880335,0
"<anonymized_userid>",1,3091,1619,"Mark Rutte (VVD)",0.776828348831365,0.645791783007579,0
"<anonymized_userid>",1,3092,1620,"Mark Rutte (VVD)",0.777079668258356,0.646190666134822,0
"<anonymized_userid>",1,3093,1621,"Mark Rutte (VVD)",0.777330987685348,0.646589549262066,0
"<anonymized_userid>",1,3094,1622,"Mark Rutte (VVD)",0.77758230711234,0.64698843238931,0
"<anonymized_userid>",1,3095,1623,"Mark Rutte (VVD)",0.777833626539332,0.647387315516554,0
"<anonymized_userid>",1,3096,1624,"Mark Rutte (VVD)",0.778084945966323,0.647786198643797,0
"<anonymized_userid>",1,3097,1625,"Mark Rutte (VVD)",0.778336265393315,0.648185081771041,0
"<anonymized_userid>",1,3098,1626,"Mark Rutte (VVD)",0.778587584820307,0.648583964898285,0
"<anonymized_userid>",1,3099,1627,"Mark Rutte (VVD)",0.778838904247298,0.648982848025529,0
"<anonymized_userid>",1,3100,1628,"Mark Rutte (VVD)",0.77909022367429,0.649381731152772,0
"<anonymized_userid>",1,3101,1629,"Mark Rutte (VVD)",0.779341543101282,0.649780614280016,0
"<anonymized_userid>",1,3102,1630,"Mark Rutte (VVD)",0.779592862528273,0.65017949740726,0
"<anonymized_userid>",1,3103,1631,"Mark Rutte (VVD)",0.779844181955265,0.650578380534503,0
"<anonymized_userid>",1,3104,1632,"Mark Rutte (VVD)",0.780095501382257,0.650977263661747,0
"<anonymized_userid>",1,3105,1633,"Mark Rutte (VVD)",0.780346820809249,0.651376146788991,0
"<anonymized_userid>",1,3106,1634,"Mark Rutte (VVD)",0.78059814023624,0.651775029916235,0
"<anonymized_userid>",1,3107,1635,"Mark Rutte (VVD)",0.780849459663232,0.652173913043478,0
"<anonymized_userid>",1,3108,1636,"Mark Rutte (VVD)",0.781100779090224,0.652572796170722,0
"<anonymized_userid>",1,3109,1637,"Mark Rutte (VVD)",0.781352098517215,0.652971679297966,0
"<anonymized_userid>",1,3110,1638,"Mark Rutte (VVD)",0.781603417944207,0.653370562425209,0
"<anonymized_userid>",1,3111,1639,"Mark Rutte (VVD)",0.781854737371199,0.653769445552453,0
"<anonymized_userid>",1,3112,1640,"Mark Rutte (VVD)",0.78210605679819,0.654168328679697,0
"<anonymized_userid>",1,3113,1641,"Mark Rutte (VVD)",0.782357376225182,0.654567211806941,0
"<anonymized_userid>",1,3114,1642,"Mark Rutte (VVD)",0.782608695652174,0.654966094934184,0
"<anonymized_userid>",1,3115,1643,"Mark Rutte (VVD)",0.782860015079166,0.655364978061428,0
"<anonymized_userid>",1,3116,1644,"Mark Rutte (VVD)",0.783111334506157,0.655763861188672,0
"<anonymized_userid>",1,3117,1645,"Mark Rutte (VVD)",0.783362653933149,0.656162744315915,0
"<anonymized_userid>",1,3118,1646,"Mark Rutte (VVD)",0.783613973360141,0.656561627443159,0
"<anonymized_userid>",1,3119,1647,"Mark Rutte (VVD)",0.783865292787132,0.656960510570403,0
"<anonymized_userid>",1,3120,1648,"Mark Rutte (VVD)",0.784116612214124,0.657359393697647,0
"<anonymized_userid>",1,3121,1649,"Mark Rutte (VVD)",0.784367931641116,0.65775827682489,0
"<anonymized_userid>",1,3122,1650,"Mark Rutte (VVD)",0.784619251068108,0.658157159952134,0
"<anonymized_userid>",1,3123,1651,"Mark Rutte (VVD)",0.784870570495099,0.658556043079378,0
"<anonymized_userid>",1,3124,1652,"Mark Rutte (VVD)",0.785121889922091,0.658954926206621,0
"<anonymized_userid>",1,3125,1653,"Mark Rutte (VVD)",0.785373209349083,0.659353809333865,0
"<anonymized_userid>",1,3126,1654,"Mark Rutte (VVD)",0.785624528776074,0.659752692461109,0
"<anonymized_userid>",1,3127,1655,"Mark Rutte (VVD)",0.785875848203066,0.660151575588353,0
"<anonymized_userid>",1,3128,1656,"Mark Rutte (VVD)",0.786127167630058,0.660550458715596,0
"<anonymized_userid>",1,3129,1657,"Mark Rutte (VVD)",0.786378487057049,0.66094934184284,0
"<anonymized_userid>",1,3130,1658,"Mark Rutte (VVD)",0.786629806484041,0.661348224970084,0
"<anonymized_userid>",1,3131,1659,"Mark Rutte (VVD)",0.786881125911033,0.661747108097328,0
"<anonymized_userid>",1,3132,1660,"Mark Rutte (VVD)",0.787132445338025,0.662145991224571,0
"<anonymized_userid>",1,3133,1661,"Mark Rutte (VVD)",0.787383764765016,0.662544874351815,0
"<anonymized_userid>",1,3134,1662,"Mark Rutte (VVD)",0.787635084192008,0.662943757479059,0
"<anonymized_userid>",1,3135,1663,"Mark Rutte (VVD)",0.787886403619,0.663342640606302,0
"<anonymized_userid>",1,3136,1664,"Mark Rutte (VVD)",0.788137723045992,0.663741523733546,0
"<anonymized_userid>",1,3137,1665,"Mark Rutte (VVD)",0.788389042472983,0.66414040686079,0
"<anonymized_userid>",1,3138,1666,"Mark Rutte (VVD)",0.788640361899975,0.664539289988033,0
"<anonymized_userid>",1,3139,1667,"Mark Rutte (VVD)",0.788891681326967,0.664938173115277,0
"<anonymized_userid>",1,3140,1668,"Mark Rutte (VVD)",0.789143000753958,0.665337056242521,0
"<anonymized_userid>",1,3141,1669,"Mark Rutte (VVD)",0.78939432018095,0.665735939369765,0
"<anonymized_userid>",1,3142,1670,"Mark Rutte (VVD)",0.789645639607942,0.666134822497008,0
"<anonymized_userid>",1,3143,1671,"Mark Rutte (VVD)",0.789896959034933,0.666533705624252,0
"<anonymized_userid>",1,3144,1672,"Mark Rutte (VVD)",0.790148278461925,0.666932588751496,0
"<anonymized_userid>",1,3145,1673,"Mark Rutte (VVD)",0.790399597888917,0.66733147187874,0
"<anonymized_userid>",1,3146,1674,"Mark Rutte (VVD)",0.790650917315909,0.667730355005983,0
"<anonymized_userid>",1,3147,1675,"Mark Rutte (VVD)",0.7909022367429,0.668129238133227,0
"<anonymized_userid>",1,3148,1676,"Mark Rutte (VVD)",0.791153556169892,0.668528121260471,0
"<anonymized_userid>",1,3149,1677,"Mark Rutte (VVD)",0.791404875596884,0.668927004387714,0
"<anonymized_userid>",1,3150,1678,"Mark Rutte (VVD)",0.791656195023875,0.669325887514958,0
"<anonymized_userid>",1,3151,1679,"Mark Rutte (VVD)",0.791907514450867,0.669724770642202,0
"<anonymized_userid>",1,3152,1680,"Mark Rutte (VVD)",0.792158833877859,0.670123653769446,0
"<anonymized_userid>",1,3153,1681,"Mark Rutte (VVD)",0.79241015330485,0.670522536896689,0
"<anonymized_userid>",1,3154,1682,"Mark Rutte (VVD)",0.792661472731842,0.670921420023933,0
"<anonymized_userid>",1,3155,1683,"Mark Rutte (VVD)",0.792912792158834,0.671320303151177,0
"<anonymized_userid>",1,3156,1684,"Mark Rutte (VVD)",0.793164111585826,0.67171918627842,0
"<anonymized_userid>",1,3157,1685,"Mark Rutte (VVD)",0.793415431012817,0.672118069405664,0
"<anonymized_userid>",1,3158,1686,"Mark Rutte (VVD)",0.793666750439809,0.672516952532908,0
"<anonymized_userid>",1,3159,1687,"Mark Rutte (VVD)",0.793918069866801,0.672915835660152,0
"<anonymized_userid>",1,3160,1688,"Mark Rutte (VVD)",0.794169389293792,0.673314718787395,0
"<anonymized_userid>",1,3161,1689,"Mark Rutte (VVD)",0.794420708720784,0.673713601914639,0
"<anonymized_userid>",1,3162,1690,"Mark Rutte (VVD)",0.794672028147776,0.674112485041883,0
"<anonymized_userid>",1,3163,1691,"Mark Rutte (VVD)",0.794923347574768,0.674511368169126,0
"<anonymized_userid>",1,3164,1692,"Mark Rutte (VVD)",0.795174667001759,0.67491025129637,0
"<anonymized_userid>",1,3165,1693,"Mark Rutte (VVD)",0.795425986428751,0.675309134423614,0
"<anonymized_userid>",1,3166,1694,"Mark Rutte (VVD)",0.795677305855743,0.675708017550858,0
"<anonymized_userid>",1,3167,1695,"Mark Rutte (VVD)",0.795928625282734,0.676106900678101,0
"<anonymized_userid>",1,3168,1696,"Mark Rutte (VVD)",0.796179944709726,0.676505783805345,0
"<anonymized_userid>",1,3169,1697,"Mark Rutte (VVD)",0.796431264136718,0.676904666932589,0
"<anonymized_userid>",1,3170,1698,"Mark Rutte (VVD)",0.796682583563709,0.677303550059832,0
"<anonymized_userid>",1,3171,1699,"Mark Rutte (VVD)",0.796933902990701,0.677702433187076,0
"<anonymized_userid>",1,3172,1700,"Mark Rutte (VVD)",0.797185222417693,0.67810131631432,0
"<anonymized_userid>",1,3173,1701,"Mark Rutte (VVD)",0.797436541844685,0.678500199441564,0
"<anonymized_userid>",1,3174,1702,"Mark Rutte (VVD)",0.797687861271676,0.678899082568807,0
"<anonymized_userid>",1,3175,1703,"Mark Rutte (VVD)",0.797939180698668,0.679297965696051,0
"<anonymized_userid>",1,3176,1704,"Mark Rutte (VVD)",0.79819050012566,0.679696848823295,0
"<anonymized_userid>",1,3177,1705,"Mark Rutte (VVD)",0.798441819552651,0.680095731950539,0
"<anonymized_userid>",1,3178,1706,"Mark Rutte (VVD)",0.798693138979643,0.680494615077782,0
"<anonymized_userid>",1,3179,1707,"Mark Rutte (VVD)",0.798944458406635,0.680893498205026,0
"<anonymized_userid>",1,3180,1708,"Mark Rutte (VVD)",0.799195777833626,0.68129238133227,0
"<anonymized_userid>",1,3181,1709,"Mark Rutte (VVD)",0.799447097260618,0.681691264459513,0
"<anonymized_userid>",1,3182,1710,"Mark Rutte (VVD)",0.79969841668761,0.682090147586757,0
"<anonymized_userid>",1,3183,1711,"Mark Rutte (VVD)",0.799949736114602,0.682489030714001,0
"<anonymized_userid>",1,3184,1712,"Mark Rutte (VVD)",0.800201055541593,0.682887913841244,0
"<anonymized_userid>",1,3185,1713,"Mark Rutte (VVD)",0.800452374968585,0.683286796968488,0
"<anonymized_userid>",1,3186,1714,"Mark Rutte (VVD)",0.800703694395577,0.683685680095732,0
"<anonymized_userid>",1,3187,1715,"Mark Rutte (VVD)",0.800955013822569,0.684084563222976,0
"<anonymized_userid>",1,3188,1716,"Mark Rutte (VVD)",0.80120633324956,0.684483446350219,0
"<anonymized_userid>",1,3189,1717,"Mark Rutte (VVD)",0.801457652676552,0.684882329477463,0
"<anonymized_userid>",1,3190,1718,"Mark Rutte (VVD)",0.801708972103544,0.685281212604707,0
"<anonymized_userid>",1,3191,1719,"Mark Rutte (VVD)",0.801960291530535,0.685680095731951,0
"<anonymized_userid>",1,3192,1720,"Mark Rutte (VVD)",0.802211610957527,0.686078978859194,0
"<anonymized_userid>",1,3193,1721,"Mark Rutte (VVD)",0.802462930384519,0.686477861986438,0
"<anonymized_userid>",1,3194,1722,"Mark Rutte (VVD)",0.80271424981151,0.686876745113682,0
"<anonymized_userid>",1,3195,1723,"Mark Rutte (VVD)",0.802965569238502,0.687275628240925,0
"<anonymized_userid>",1,3196,1724,"Mark Rutte (VVD)",0.803216888665494,0.687674511368169,0
"<anonymized_userid>",1,3197,1725,"Mark Rutte (VVD)",0.803468208092486,0.688073394495413,0
"<anonymized_userid>",1,3198,1726,"Mark Rutte (VVD)",0.803719527519477,0.688472277622657,0
"<anonymized_userid>",1,3199,1727,"Mark Rutte (VVD)",0.803970846946469,0.6888711607499,0
"<anonymized_userid>",1,3200,1728,"Mark Rutte (VVD)",0.804222166373461,0.689270043877144,0
"<anonymized_userid>",1,3201,1729,"Mark Rutte (VVD)",0.804473485800452,0.689668927004388,0
"<anonymized_userid>",1,3202,1730,"Mark Rutte (VVD)",0.804724805227444,0.690067810131631,0
"<anonymized_userid>",1,3203,1731,"Mark Rutte (VVD)",0.804976124654436,0.690466693258875,0
"<anonymized_userid>",1,3204,1732,"Mark Rutte (VVD)",0.805227444081428,0.690865576386119,0
"<anonymized_userid>",1,3205,1733,"Mark Rutte (VVD)",0.805478763508419,0.691264459513363,0
"<anonymized_userid>",1,3206,1734,"Mark Rutte (VVD)",0.805730082935411,0.691663342640606,0
"<anonymized_userid>",1,3207,1735,"Mark Rutte (VVD)",0.805981402362403,0.69206222576785,0
"<anonymized_userid>",1,3208,1736,"Mark Rutte (VVD)",0.806232721789394,0.692461108895094,0
"<anonymized_userid>",1,3209,1737,"Mark Rutte (VVD)",0.806484041216386,0.692859992022338,0
"<anonymized_userid>",1,3210,1738,"Mark Rutte (VVD)",0.806735360643378,0.693258875149581,0
"<anonymized_userid>",1,3211,1739,"Mark Rutte (VVD)",0.806986680070369,0.693657758276825,0
"<anonymized_userid>",1,3212,1740,"Mark Rutte (VVD)",0.807237999497361,0.694056641404069,0
"<anonymized_userid>",1,3213,1741,"Mark Rutte (VVD)",0.807489318924353,0.694455524531312,0
"<anonymized_userid>",1,3214,1742,"Mark Rutte (VVD)",0.807740638351345,0.694854407658556,0
"<anonymized_userid>",1,3215,1743,"Mark Rutte (VVD)",0.807991957778336,0.6952532907858,0
"<anonymized_userid>",1,3216,1744,"Mark Rutte (VVD)",0.808243277205328,0.695652173913043,0
"<anonymized_userid>",1,3217,1745,"Mark Rutte (VVD)",0.80849459663232,0.696051057040287,0
"<anonymized_userid>",1,3218,1746,"Mark Rutte (VVD)",0.808745916059311,0.696449940167531,0
"<anonymized_userid>",1,3219,1747,"Mark Rutte (VVD)",0.808997235486303,0.696848823294775,0
"<anonymized_userid>",1,3220,1748,"Mark Rutte (VVD)",0.809248554913295,0.697247706422018,0
"<anonymized_userid>",1,3221,1749,"Mark Rutte (VVD)",0.809499874340286,0.697646589549262,0
"<anonymized_userid>",1,3222,1750,"Mark Rutte (VVD)",0.809751193767278,0.698045472676506,0
"<anonymized_userid>",1,3223,1751,"Mark Rutte (VVD)",0.81000251319427,0.69844435580375,0
"<anonymized_userid>",1,3224,1752,"Mark Rutte (VVD)",0.810253832621262,0.698843238930993,0
"<anonymized_userid>",1,3225,1753,"Mark Rutte (VVD)",0.810505152048253,0.699242122058237,0
"<anonymized_userid>",1,3226,1754,"Mark Rutte (VVD)",0.810756471475245,0.699641005185481,0
"<anonymized_userid>",1,3227,1755,"Mark Rutte (VVD)",0.811007790902237,0.700039888312724,0
"<anonymized_userid>",1,3228,1756,"Mark Rutte (VVD)",0.811259110329228,0.700438771439968,0
"<anonymized_userid>",1,3229,1757,"Mark Rutte (VVD)",0.81151042975622,0.700837654567212,0
"<anonymized_userid>",1,3230,1758,"Mark Rutte (VVD)",0.811761749183212,0.701236537694455,0
"<anonymized_userid>",1,3231,1759,"Mark Rutte (VVD)",0.812013068610204,0.701635420821699,0
"<anonymized_userid>",1,3232,1760,"Mark Rutte (VVD)",0.812264388037195,0.702034303948943,0
"<anonymized_userid>",1,3233,1761,"Mark Rutte (VVD)",0.812515707464187,0.702433187076187,0
"<anonymized_userid>",1,3234,1762,"Mark Rutte (VVD)",0.812767026891179,0.70283207020343,0
"<anonymized_userid>",1,3235,1763,"Mark Rutte (VVD)",0.81301834631817,0.703230953330674,0
"<anonymized_userid>",1,3236,1764,"Mark Rutte (VVD)",0.813269665745162,0.703629836457918,0
"<anonymized_userid>",1,3237,1765,"Mark Rutte (VVD)",0.813520985172154,0.704028719585162,0
"<anonymized_userid>",1,3238,1766,"Mark Rutte (VVD)",0.813772304599146,0.704427602712405,0
"<anonymized_userid>",1,3239,1767,"Mark Rutte (VVD)",0.814023624026137,0.704826485839649,0
"<anonymized_userid>",1,3240,1768,"Mark Rutte (VVD)",0.814274943453129,0.705225368966893,0
"<anonymized_userid>",1,3241,1769,"Mark Rutte (VVD)",0.814526262880121,0.705624252094136,0
"<anonymized_userid>",1,3242,1770,"Mark Rutte (VVD)",0.814777582307112,0.70602313522138,0
"<anonymized_userid>",1,3243,1771,"Mark Rutte (VVD)",0.815028901734104,0.706422018348624,0
"<anonymized_userid>",1,3244,1772,"Mark Rutte (VVD)",0.815280221161096,0.706820901475868,0
"<anonymized_userid>",1,3245,1773,"Mark Rutte (VVD)",0.815531540588087,0.707219784603111,0
"<anonymized_userid>",1,3246,1774,"Mark Rutte (VVD)",0.815782860015079,0.707618667730355,0
"<anonymized_userid>",1,3247,1775,"Mark Rutte (VVD)",0.816034179442071,0.708017550857599,0
"<anonymized_userid>",1,3248,1776,"Mark Rutte (VVD)",0.816285498869063,0.708416433984842,0
"<anonymized_userid>",1,3249,1777,"Mark Rutte (VVD)",0.816536818296054,0.708815317112086,0
"<anonymized_userid>",1,3250,1778,"Mark Rutte (VVD)",0.816788137723046,0.70921420023933,0
"<anonymized_userid>",1,3251,1779,"Mark Rutte (VVD)",0.817039457150038,0.709613083366574,0
"<anonymized_userid>",1,3252,1780,"Mark Rutte (VVD)",0.817290776577029,0.710011966493817,0
"<anonymized_userid>",1,3253,1781,"Mark Rutte (VVD)",0.817542096004021,0.710410849621061,0
"<anonymized_userid>",1,3254,1782,"Mark Rutte (VVD)",0.817793415431013,0.710809732748305,0
"<anonymized_userid>",1,3255,1783,"Mark Rutte (VVD)",0.818044734858005,0.711208615875549,0
"<anonymized_userid>",1,3256,1784,"Mark Rutte (VVD)",0.818296054284996,0.711607499002792,0
"<anonymized_userid>",1,3257,1785,"Mark Rutte (VVD)",0.818547373711988,0.712006382130036,0
"<anonymized_userid>",1,3258,1786,"Mark Rutte (VVD)",0.81879869313898,0.71240526525728,0
"<anonymized_userid>",1,3259,1787,"Mark Rutte (VVD)",0.819050012565971,0.712804148384523,0
"<anonymized_userid>",1,3260,1788,"Mark Rutte (VVD)",0.819301331992963,0.713203031511767,0
"<anonymized_userid>",1,3261,1789,"Mark Rutte (VVD)",0.819552651419955,0.713601914639011,0
"<anonymized_userid>",1,3262,1790,"Mark Rutte (VVD)",0.819803970846946,0.714000797766254,0
"<anonymized_userid>",1,3263,1791,"Mark Rutte (VVD)",0.820055290273938,0.714399680893498,0
"<anonymized_userid>",1,3264,1792,"Mark Rutte (VVD)",0.82030660970093,0.714798564020742,0
"<anonymized_userid>",1,3265,1793,"Mark Rutte (VVD)",0.820557929127922,0.715197447147986,0
"<anonymized_userid>",1,3266,1794,"Mark Rutte (VVD)",0.820809248554913,0.715596330275229,0
"<anonymized_userid>",1,3267,1795,"Mark Rutte (VVD)",0.821060567981905,0.715995213402473,0
"<anonymized_userid>",1,3268,1796,"Mark Rutte (VVD)",0.821311887408897,0.716394096529717,0
"<anonymized_userid>",1,3269,1797,"Mark Rutte (VVD)",0.821563206835888,0.716792979656961,0
"<anonymized_userid>",1,3270,1798,"Mark Rutte (VVD)",0.82181452626288,0.717191862784204,0
"<anonymized_userid>",1,3271,1799,"Mark Rutte (VVD)",0.822065845689872,0.717590745911448,0
"<anonymized_userid>",1,3272,1800,"Mark Rutte (VVD)",0.822317165116863,0.717989629038692,0
"<anonymized_userid>",1,3273,1801,"Mark Rutte (VVD)",0.822568484543855,0.718388512165935,0
"<anonymized_userid>",1,3274,1802,"Mark Rutte (VVD)",0.822819803970847,0.718787395293179,0
"<anonymized_userid>",1,3275,1803,"Mark Rutte (VVD)",0.823071123397839,0.719186278420423,0
"<anonymized_userid>",1,3276,1804,"Mark Rutte (VVD)",0.82332244282483,0.719585161547666,0
"<anonymized_userid>",1,3277,1805,"Mark Rutte (VVD)",0.823573762251822,0.71998404467491,0
"<anonymized_userid>",1,3278,1806,"Mark Rutte (VVD)",0.823825081678814,0.720382927802154,0
"<anonymized_userid>",1,3279,1807,"Mark Rutte (VVD)",0.824076401105805,0.720781810929398,0
"<anonymized_userid>",1,3280,1808,"Mark Rutte (VVD)",0.824327720532797,0.721180694056641,0
"<anonymized_userid>",1,3281,1809,"Mark Rutte (VVD)",0.824579039959789,0.721579577183885,0
"<anonymized_userid>",1,3282,1810,"Mark Rutte (VVD)",0.824830359386781,0.721978460311129,0
"<anonymized_userid>",1,3283,1811,"Mark Rutte (VVD)",0.825081678813772,0.722377343438373,0
"<anonymized_userid>",1,3284,1812,"Mark Rutte (VVD)",0.825332998240764,0.722776226565616,0
"<anonymized_userid>",1,3285,1813,"Mark Rutte (VVD)",0.825584317667756,0.72317510969286,0
"<anonymized_userid>",1,3286,1814,"Mark Rutte (VVD)",0.825835637094747,0.723573992820104,0
"<anonymized_userid>",1,3287,1815,"Mark Rutte (VVD)",0.826086956521739,0.723972875947347,0
"<anonymized_userid>",1,3288,1816,"Mark Rutte (VVD)",0.826338275948731,0.724371759074591,0
"<anonymized_userid>",1,3289,1817,"Mark Rutte (VVD)",0.826589595375723,0.724770642201835,0
"<anonymized_userid>",1,3290,1818,"Mark Rutte (VVD)",0.826840914802714,0.725169525329079,0
"<anonymized_userid>",1,3291,1819,"Mark Rutte (VVD)",0.827092234229706,0.725568408456322,0
"<anonymized_userid>",1,3292,1820,"Mark Rutte (VVD)",0.827343553656698,0.725967291583566,0
"<anonymized_userid>",1,3293,1821,"Mark Rutte (VVD)",0.827594873083689,0.72636617471081,0
"<anonymized_userid>",1,3294,1822,"Mark Rutte (VVD)",0.827846192510681,0.726765057838053,0
"<anonymized_userid>",1,3295,1823,"Mark Rutte (VVD)",0.828097511937673,0.727163940965297,0
"<anonymized_userid>",1,3296,1824,"Mark Rutte (VVD)",0.828348831364665,0.727562824092541,0
"<anonymized_userid>",1,3297,1825,"Mark Rutte (VVD)",0.828600150791656,0.727961707219785,0
"<anonymized_userid>",1,3298,1826,"Mark Rutte (VVD)",0.828851470218648,0.728360590347028,0
"<anonymized_userid>",1,3299,1827,"Mark Rutte (VVD)",0.82910278964564,0.728759473474272,0
"<anonymized_userid>",1,3300,1828,"Mark Rutte (VVD)",0.829354109072631,0.729158356601516,0
"<anonymized_userid>",1,3301,1829,"Mark Rutte (VVD)",0.829605428499623,0.72955723972876,0
"<anonymized_userid>",1,3302,1830,"Mark Rutte (VVD)",0.829856747926615,0.729956122856003,0
"<anonymized_userid>",1,3303,1831,"Mark Rutte (VVD)",0.830108067353606,0.730355005983247,0
"<anonymized_userid>",1,3304,1832,"Mark Rutte (VVD)",0.830359386780598,0.730753889110491,0
"<anonymized_userid>",1,3305,1833,"Mark Rutte (VVD)",0.83061070620759,0.731152772237734,0
"<anonymized_userid>",1,3306,1834,"Mark Rutte (VVD)",0.830862025634582,0.731551655364978,0
"<anonymized_userid>",1,3307,1835,"Mark Rutte (VVD)",0.831113345061573,0.731950538492222,0
"<anonymized_userid>",1,3308,1836,"Mark Rutte (VVD)",0.831364664488565,0.732349421619465,0
"<anonymized_userid>",1,3309,1837,"Mark Rutte (VVD)",0.831615983915557,0.732748304746709,0
"<anonymized_userid>",1,3310,1838,"Mark Rutte (VVD)",0.831867303342548,0.733147187873953,0
"<anonymized_userid>",1,3311,1839,"Mark Rutte (VVD)",0.83211862276954,0.733546071001197,0
"<anonymized_userid>",1,3312,1840,"Mark Rutte (VVD)",0.832369942196532,0.73394495412844,0
"<anonymized_userid>",1,3313,1841,"Mark Rutte (VVD)",0.832621261623523,0.734343837255684,0
"<anonymized_userid>",1,3314,1842,"Mark Rutte (VVD)",0.832872581050515,0.734742720382928,0
"<anonymized_userid>",1,3315,1843,"Mark Rutte (VVD)",0.833123900477507,0.735141603510172,0
"<anonymized_userid>",1,3316,1844,"Mark Rutte (VVD)",0.833375219904499,0.735540486637415,0
"<anonymized_userid>",1,3317,1845,"Mark Rutte (VVD)",0.83362653933149,0.735939369764659,0
"<anonymized_userid>",1,3318,1846,"Mark Rutte (VVD)",0.833877858758482,0.736338252891903,0
"<anonymized_userid>",1,3319,1847,"Mark Rutte (VVD)",0.834129178185474,0.736737136019146,0
"<anonymized_userid>",1,3320,1848,"Mark Rutte (VVD)",0.834380497612465,0.73713601914639,0
"<anonymized_userid>",1,3321,1849,"Mark Rutte (VVD)",0.834631817039457,0.737534902273634,0
"<anonymized_userid>",1,3322,1850,"Mark Rutte (VVD)",0.834883136466449,0.737933785400878,0
"<anonymized_userid>",1,3323,1851,"Mark Rutte (VVD)",0.835134455893441,0.738332668528121,0
"<anonymized_userid>",1,3324,1852,"Mark Rutte (VVD)",0.835385775320432,0.738731551655365,0
"<anonymized_userid>",1,3325,1853,"Mark Rutte (VVD)",0.835637094747424,0.739130434782609,0
"<anonymized_userid>",1,3326,1854,"Mark Rutte (VVD)",0.835888414174416,0.739529317909852,0
"<anonymized_userid>",1,3327,1855,"Mark Rutte (VVD)",0.836139733601407,0.739928201037096,0
"<anonymized_userid>",1,3328,1856,"Mark Rutte (VVD)",0.836391053028399,0.74032708416434,0
"<anonymized_userid>",1,3329,1857,"Mark Rutte (VVD)",0.836642372455391,0.740725967291584,0
"<anonymized_userid>",1,3330,1858,"Mark Rutte (VVD)",0.836893691882382,0.741124850418827,0
"<anonymized_userid>",1,3331,1859,"Mark Rutte (VVD)",0.837145011309374,0.741523733546071,0
"<anonymized_userid>",1,3332,1860,"Mark Rutte (VVD)",0.837396330736366,0.741922616673315,0
"<anonymized_userid>",1,3333,1861,"Mark Rutte (VVD)",0.837647650163358,0.742321499800558,0
"<anonymized_userid>",1,3334,1862,"Mark Rutte (VVD)",0.837898969590349,0.742720382927802,0
"<anonymized_userid>",1,3335,1863,"Mark Rutte (VVD)",0.838150289017341,0.743119266055046,0
"<anonymized_userid>",1,3336,1864,"Mark Rutte (VVD)",0.838401608444333,0.74351814918229,0
"<anonymized_userid>",1,3337,1865,"Mark Rutte (VVD)",0.838652927871325,0.743917032309533,0
"<anonymized_userid>",1,3338,1866,"Mark Rutte (VVD)",0.838904247298316,0.744315915436777,0
"<anonymized_userid>",1,3339,1867,"Mark Rutte (VVD)",0.839155566725308,0.744714798564021,0
"<anonymized_userid>",1,3340,1868,"Mark Rutte (VVD)",0.8394068861523,0.745113681691264,0
"<anonymized_userid>",1,3341,1869,"Mark Rutte (VVD)",0.839658205579291,0.745512564818508,0
"<anonymized_userid>",1,3342,1870,"Mark Rutte (VVD)",0.839909525006283,0.745911447945752,0
"<anonymized_userid>",1,3343,1871,"Mark Rutte (VVD)",0.840160844433275,0.746310331072996,0
"<anonymized_userid>",1,3344,1872,"Mark Rutte (VVD)",0.840412163860266,0.746709214200239,0
"<anonymized_userid>",1,3345,1873,"Mark Rutte (VVD)",0.840663483287258,0.747108097327483,0
"<anonymized_userid>",1,3346,1874,"Mark Rutte (VVD)",0.84091480271425,0.747506980454727,0
"<anonymized_userid>",1,3347,1875,"Mark Rutte (VVD)",0.841166122141242,0.747905863581971,0
"<anonymized_userid>",1,3348,1876,"Mark Rutte (VVD)",0.841417441568233,0.748304746709214,0
"<anonymized_userid>",1,3349,1877,"Mark Rutte (VVD)",0.841668760995225,0.748703629836458,0
"<anonymized_userid>",1,3350,1878,"Mark Rutte (VVD)",0.841920080422217,0.749102512963702,0
"<anonymized_userid>",1,3351,1879,"Mark Rutte (VVD)",0.842171399849208,0.749501396090945,0
"<anonymized_userid>",1,3352,1880,"Mark Rutte (VVD)",0.8424227192762,0.749900279218189,0
"<anonymized_userid>",1,3353,1881,"Mark Rutte (VVD)",0.842674038703192,0.750299162345433,0
"<anonymized_userid>",1,3354,1882,"Mark Rutte (VVD)",0.842925358130183,0.750698045472676,0
"<anonymized_userid>",1,3355,1883,"Mark Rutte (VVD)",0.843176677557175,0.75109692859992,0
"<anonymized_userid>",1,3356,1884,"Mark Rutte (VVD)",0.843427996984167,0.751495811727164,0
"<anonymized_userid>",1,3357,1885,"Mark Rutte (VVD)",0.843679316411159,0.751894694854408,0
"<anonymized_userid>",1,3358,1886,"Mark Rutte (VVD)",0.84393063583815,0.752293577981651,0
"<anonymized_userid>",1,3359,1887,"Mark Rutte (VVD)",0.844181955265142,0.752692461108895,0
"<anonymized_userid>",1,3360,1888,"Mark Rutte (VVD)",0.844433274692134,0.753091344236139,0
"<anonymized_userid>",1,3361,1889,"Mark Rutte (VVD)",0.844684594119125,0.753490227363383,0
"<anonymized_userid>",1,3362,1890,"Mark Rutte (VVD)",0.844935913546117,0.753889110490626,0
"<anonymized_userid>",1,3363,1891,"Mark Rutte (VVD)",0.845187232973109,0.75428799361787,0
"<anonymized_userid>",1,3364,1892,"Mark Rutte (VVD)",0.845438552400101,0.754686876745114,0
"<anonymized_userid>",1,3365,1893,"Mark Rutte (VVD)",0.845689871827092,0.755085759872357,0
"<anonymized_userid>",1,3366,1894,"Mark Rutte (VVD)",0.845941191254084,0.755484642999601,0
"<anonymized_userid>",1,3367,1895,"Mark Rutte (VVD)",0.846192510681076,0.755883526126845,0
"<anonymized_userid>",1,3368,1896,"Mark Rutte (VVD)",0.846443830108067,0.756282409254089,0
"<anonymized_userid>",1,3369,1897,"Mark Rutte (VVD)",0.846695149535059,0.756681292381332,0
"<anonymized_userid>",1,3370,1898,"Mark Rutte (VVD)",0.846946468962051,0.757080175508576,0
"<anonymized_userid>",1,3371,1899,"Mark Rutte (VVD)",0.847197788389042,0.75747905863582,0
"<anonymized_userid>",1,3372,1900,"Mark Rutte (VVD)",0.847449107816034,0.757877941763063,0
"<anonymized_userid>",1,3373,1901,"Mark Rutte (VVD)",0.847700427243026,0.758276824890307,0
"<anonymized_userid>",1,3374,1902,"Mark Rutte (VVD)",0.847951746670018,0.758675708017551,0
"<anonymized_userid>",1,3375,1903,"Mark Rutte (VVD)",0.848203066097009,0.759074591144795,0
"<anonymized_userid>",1,3376,1904,"Mark Rutte (VVD)",0.848454385524001,0.759473474272038,0
"<anonymized_userid>",1,3377,1905,"Mark Rutte (VVD)",0.848705704950993,0.759872357399282,0
"<anonymized_userid>",1,3378,1906,"Mark Rutte (VVD)",0.848957024377984,0.760271240526526,0
"<anonymized_userid>",1,3379,1907,"Mark Rutte (VVD)",0.849208343804976,0.760670123653769,0
"<anonymized_userid>",1,3380,1908,"Mark Rutte (VVD)",0.849459663231968,0.761069006781013,0
"<anonymized_userid>",1,3381,1909,"Mark Rutte (VVD)",0.84971098265896,0.761467889908257,0
"<anonymized_userid>",1,3382,1910,"Mark Rutte (VVD)",0.849962302085951,0.761866773035501,0
"<anonymized_userid>",1,3383,1911,"Mark Rutte (VVD)",0.850213621512943,0.762265656162744,0
"<anonymized_userid>",1,3384,1912,"Mark Rutte (VVD)",0.850464940939935,0.762664539289988,0
"<anonymized_userid>",1,3385,1913,"Mark Rutte (VVD)",0.850716260366926,0.763063422417232,0
"<anonymized_userid>",1,3386,1914,"Mark Rutte (VVD)",0.850967579793918,0.763462305544475,0
"<anonymized_userid>",1,3387,1915,"Mark Rutte (VVD)",0.85121889922091,0.763861188671719,0
"<anonymized_userid>",1,3388,1916,"Mark Rutte (VVD)",0.851470218647902,0.764260071798963,0
"<anonymized_userid>",1,3389,1917,"Mark Rutte (VVD)",0.851721538074893,0.764658954926207,0
"<anonymized_userid>",1,3390,1918,"Mark Rutte (VVD)",0.851972857501885,0.76505783805345,0
"<anonymized_userid>",1,3391,1919,"Mark Rutte (VVD)",0.852224176928877,0.765456721180694,0
"<anonymized_userid>",1,3392,1920,"Mark Rutte (VVD)",0.852475496355868,0.765855604307938,0
"<anonymized_userid>",1,3393,1921,"Mark Rutte (VVD)",0.85272681578286,0.766254487435182,0
"<anonymized_userid>",1,3394,1922,"Mark Rutte (VVD)",0.852978135209852,0.766653370562425,0
"<anonymized_userid>",1,3395,1923,"Mark Rutte (VVD)",0.853229454636843,0.767052253689669,0
"<anonymized_userid>",1,3396,1924,"Mark Rutte (VVD)",0.853480774063835,0.767451136816913,0
"<anonymized_userid>",1,3397,1925,"Mark Rutte (VVD)",0.853732093490827,0.767850019944156,0
"<anonymized_userid>",1,3398,1926,"Mark Rutte (VVD)",0.853983412917819,0.7682489030714,0
"<anonymized_userid>",1,3399,1927,"Mark Rutte (VVD)",0.85423473234481,0.768647786198644,0
"<anonymized_userid>",1,3400,1928,"Mark Rutte (VVD)",0.854486051771802,0.769046669325887,0
"<anonymized_userid>",1,3401,1929,"Mark Rutte (VVD)",0.854737371198794,0.769445552453131,0
"<anonymized_userid>",1,3402,1930,"Mark Rutte (VVD)",0.854988690625785,0.769844435580375,0
"<anonymized_userid>",1,3403,1931,"Mark Rutte (VVD)",0.855240010052777,0.770243318707619,0
"<anonymized_userid>",1,3404,1932,"Mark Rutte (VVD)",0.855491329479769,0.770642201834862,0
"<anonymized_userid>",1,3405,1933,"Mark Rutte (VVD)",0.85574264890676,0.771041084962106,0
"<anonymized_userid>",1,3406,1934,"Mark Rutte (VVD)",0.855993968333752,0.77143996808935,0
"<anonymized_userid>",1,3407,1935,"Mark Rutte (VVD)",0.856245287760744,0.771838851216594,0
"<anonymized_userid>",1,3408,1936,"Mark Rutte (VVD)",0.856496607187736,0.772237734343837,0
"<anonymized_userid>",1,3409,1937,"Mark Rutte (VVD)",0.856747926614727,0.772636617471081,0
"<anonymized_userid>",1,3410,1938,"Mark Rutte (VVD)",0.856999246041719,0.773035500598325,0
"<anonymized_userid>",1,3411,1939,"Mark Rutte (VVD)",0.857250565468711,0.773434383725568,0
"<anonymized_userid>",1,3412,1940,"Mark Rutte (VVD)",0.857501884895702,0.773833266852812,0
"<anonymized_userid>",1,3413,1941,"Mark Rutte (VVD)",0.857753204322694,0.774232149980056,0
"<anonymized_userid>",1,3414,1942,"Mark Rutte (VVD)",0.858004523749686,0.7746310331073,0
"<anonymized_userid>",1,3415,1943,"Mark Rutte (VVD)",0.858255843176678,0.775029916234543,0
"<anonymized_userid>",1,3416,1944,"Mark Rutte (VVD)",0.858507162603669,0.775428799361787,0
"<anonymized_userid>",1,3417,1945,"Mark Rutte (VVD)",0.858758482030661,0.775827682489031,0
"<anonymized_userid>",1,3418,1946,"Mark Rutte (VVD)",0.859009801457653,0.776226565616274,0
"<anonymized_userid>",1,3419,1947,"Mark Rutte (VVD)",0.859261120884644,0.776625448743518,0
"<anonymized_userid>",1,3420,1948,"Mark Rutte (VVD)",0.859512440311636,0.777024331870762,0
"<anonymized_userid>",1,3421,1949,"Mark Rutte (VVD)",0.859763759738628,0.777423214998006,0
"<anonymized_userid>",1,3422,1950,"Mark Rutte (VVD)",0.860015079165619,0.777822098125249,0
"<anonymized_userid>",1,3423,1951,"Mark Rutte (VVD)",0.860266398592611,0.778220981252493,0
"<anonymized_userid>",1,3424,1952,"Mark Rutte (VVD)",0.860517718019603,0.778619864379737,0
"<anonymized_userid>",1,3425,1953,"Mark Rutte (VVD)",0.860769037446595,0.77901874750698,0
"<anonymized_userid>",1,3426,1954,"Mark Rutte (VVD)",0.861020356873586,0.779417630634224,0
"<anonymized_userid>",1,3427,1955,"Mark Rutte (VVD)",0.861271676300578,0.779816513761468,0
"<anonymized_userid>",1,3428,1956,"Mark Rutte (VVD)",0.86152299572757,0.780215396888712,0
"<anonymized_userid>",1,3429,1957,"Mark Rutte (VVD)",0.861774315154561,0.780614280015955,0
"<anonymized_userid>",1,3430,1958,"Mark Rutte (VVD)",0.862025634581553,0.781013163143199,0
"<anonymized_userid>",1,3431,1959,"Mark Rutte (VVD)",0.862276954008545,0.781412046270443,0
"<anonymized_userid>",1,3432,1960,"Mark Rutte (VVD)",0.862528273435537,0.781810929397686,0
"<anonymized_userid>",1,3433,1961,"Mark Rutte (VVD)",0.862779592862528,0.78220981252493,0
"<anonymized_userid>",1,3434,1962,"Mark Rutte (VVD)",0.86303091228952,0.782608695652174,0
"<anonymized_userid>",1,3435,1963,"Mark Rutte (VVD)",0.863282231716512,0.783007578779418,0
"<anonymized_userid>",1,3436,1964,"Mark Rutte (VVD)",0.863533551143503,0.783406461906661,0
"<anonymized_userid>",1,3437,1965,"Mark Rutte (VVD)",0.863784870570495,0.783805345033905,0
"<anonymized_userid>",1,3438,1966,"Mark Rutte (VVD)",0.864036189997487,0.784204228161149,0
"<anonymized_userid>",1,3439,1967,"Mark Rutte (VVD)",0.864287509424479,0.784603111288393,0
"<anonymized_userid>",1,3440,1968,"Mark Rutte (VVD)",0.86453882885147,0.785001994415636,0
"<anonymized_userid>",1,3441,1969,"Mark Rutte (VVD)",0.864790148278462,0.78540087754288,0
"<anonymized_userid>",1,3442,1970,"Mark Rutte (VVD)",0.865041467705454,0.785799760670124,0
"<anonymized_userid>",1,3443,1971,"Mark Rutte (VVD)",0.865292787132445,0.786198643797367,0
"<anonymized_userid>",1,3444,1972,"Mark Rutte (VVD)",0.865544106559437,0.786597526924611,0
"<anonymized_userid>",1,3445,1973,"Mark Rutte (VVD)",0.865795425986429,0.786996410051855,0
"<anonymized_userid>",1,3446,1974,"Mark Rutte (VVD)",0.86604674541342,0.787395293179099,0
"<anonymized_userid>",1,3447,1975,"Mark Rutte (VVD)",0.866298064840412,0.787794176306342,0
"<anonymized_userid>",1,3448,1976,"Mark Rutte (VVD)",0.866549384267404,0.788193059433586,0
"<anonymized_userid>",1,3449,1977,"Mark Rutte (VVD)",0.866800703694396,0.78859194256083,0
"<anonymized_userid>",1,3450,1978,"Mark Rutte (VVD)",0.867052023121387,0.788990825688073,0
"<anonymized_userid>",1,3451,1979,"Mark Rutte (VVD)",0.867303342548379,0.789389708815317,0
"<anonymized_userid>",1,3452,1980,"Mark Rutte (VVD)",0.867554661975371,0.789788591942561,0
"<anonymized_userid>",1,3453,1981,"Mark Rutte (VVD)",0.867805981402362,0.790187475069805,0
"<anonymized_userid>",1,3454,1982,"Mark Rutte (VVD)",0.868057300829354,0.790586358197048,0
"<anonymized_userid>",1,3455,1983,"Mark Rutte (VVD)",0.868308620256346,0.790985241324292,0
"<anonymized_userid>",1,3456,1984,"Mark Rutte (VVD)",0.868559939683338,0.791384124451536,0
"<anonymized_userid>",1,3457,1985,"Mark Rutte (VVD)",0.868811259110329,0.791783007578779,0
"<anonymized_userid>",1,3458,1986,"Mark Rutte (VVD)",0.869062578537321,0.792181890706023,0
"<anonymized_userid>",1,3459,1987,"Mark Rutte (VVD)",0.869313897964313,0.792580773833267,0
"<anonymized_userid>",1,3460,1988,"Mark Rutte (VVD)",0.869565217391304,0.792979656960511,0
"<anonymized_userid>",1,3461,1989,"Mark Rutte (VVD)",0.869816536818296,0.793378540087754,0
"<anonymized_userid>",1,3462,1990,"Mark Rutte (VVD)",0.870067856245288,0.793777423214998,0
"<anonymized_userid>",1,3463,1991,"Mark Rutte (VVD)",0.870319175672279,0.794176306342242,0
"<anonymized_userid>",1,3464,1992,"Mark Rutte (VVD)",0.870570495099271,0.794575189469485,0
"<anonymized_userid>",1,3465,1993,"Mark Rutte (VVD)",0.870821814526263,0.794974072596729,0
"<anonymized_userid>",1,3466,1994,"Mark Rutte (VVD)",0.871073133953255,0.795372955723973,0
"<anonymized_userid>",1,3467,1995,"Mark Rutte (VVD)",0.871324453380246,0.795771838851217,0
"<anonymized_userid>",1,3468,1996,"Mark Rutte (VVD)",0.871575772807238,0.79617072197846,0
"<anonymized_userid>",1,3469,1997,"Mark Rutte (VVD)",0.87182709223423,0.796569605105704,0
"<anonymized_userid>",1,3470,1998,"Mark Rutte (VVD)",0.872078411661221,0.796968488232948,0
"<anonymized_userid>",1,3471,1999,"Mark Rutte (VVD)",0.872329731088213,0.797367371360191,0
"<anonymized_userid>",1,3472,2000,"Mark Rutte (VVD)",0.872581050515205,0.797766254487435,0
"<anonymized_userid>",1,3473,2001,"Mark Rutte (VVD)",0.872832369942196,0.798165137614679,0
"<anonymized_userid>",1,3474,2002,"Mark Rutte (VVD)",0.873083689369188,0.798564020741923,0
"<anonymized_userid>",1,3475,2003,"Mark Rutte (VVD)",0.87333500879618,0.798962903869166,0
"<anonymized_userid>",1,3476,2004,"Mark Rutte (VVD)",0.873586328223172,0.79936178699641,0
"<anonymized_userid>",1,3477,2005,"Mark Rutte (VVD)",0.873837647650163,0.799760670123654,0
"<anonymized_userid>",1,3478,2006,"Mark Rutte (VVD)",0.874088967077155,0.800159553250897,0
"<anonymized_userid>",1,3479,2007,"Mark Rutte (VVD)",0.874340286504147,0.800558436378141,0
"<anonymized_userid>",1,3480,2008,"Mark Rutte (VVD)",0.874591605931138,0.800957319505385,0
"<anonymized_userid>",1,3481,2009,"Mark Rutte (VVD)",0.87484292535813,0.801356202632629,0
"<anonymized_userid>",1,3482,2010,"Mark Rutte (VVD)",0.875094244785122,0.801755085759872,0
"<anonymized_userid>",1,3483,2011,"Mark Rutte (VVD)",0.875345564212114,0.802153968887116,0
"<anonymized_userid>",1,3484,2012,"Mark Rutte (VVD)",0.875596883639105,0.80255285201436,0
"<anonymized_userid>",1,3485,2013,"Mark Rutte (VVD)",0.875848203066097,0.802951735141604,0
"<anonymized_userid>",1,3486,2014,"Mark Rutte (VVD)",0.876099522493089,0.803350618268847,0
"<anonymized_userid>",1,3487,2015,"Mark Rutte (VVD)",0.87635084192008,0.803749501396091,0
"<anonymized_userid>",1,3488,2016,"Mark Rutte (VVD)",0.876602161347072,0.804148384523335,0
"<anonymized_userid>",1,3489,2017,"Mark Rutte (VVD)",0.876853480774064,0.804547267650578,0
"<anonymized_userid>",1,3490,2018,"Mark Rutte (VVD)",0.877104800201056,0.804946150777822,0
"<anonymized_userid>",1,3491,2019,"Mark Rutte (VVD)",0.877356119628047,0.805345033905066,0
"<anonymized_userid>",1,3492,2020,"Mark Rutte (VVD)",0.877607439055039,0.80574391703231,0
"<anonymized_userid>",1,3493,2021,"Mark Rutte (VVD)",0.877858758482031,0.806142800159553,0
"<anonymized_userid>",1,3494,2022,"Mark Rutte (VVD)",0.878110077909022,0.806541683286797,0
"<anonymized_userid>",1,3495,2023,"Mark Rutte (VVD)",0.878361397336014,0.806940566414041,0
"<anonymized_userid>",1,3496,2024,"Mark Rutte (VVD)",0.878612716763006,0.807339449541284,0
"<anonymized_userid>",1,3497,2025,"Mark Rutte (VVD)",0.878864036189998,0.807738332668528,0
"<anonymized_userid>",1,3498,2026,"Mark Rutte (VVD)",0.879115355616989,0.808137215795772,0
"<anonymized_userid>",1,3499,2027,"Mark Rutte (VVD)",0.879366675043981,0.808536098923016,0
"<anonymized_userid>",1,3500,2028,"Mark Rutte (VVD)",0.879617994470973,0.808934982050259,0
"<anonymized_userid>",1,3501,2029,"Mark Rutte (VVD)",0.879869313897964,0.809333865177503,0
"<anonymized_userid>",1,3502,2030,"Mark Rutte (VVD)",0.880120633324956,0.809732748304747,0
"<anonymized_userid>",1,3503,2031,"Mark Rutte (VVD)",0.880371952751948,0.81013163143199,0
"<anonymized_userid>",1,3504,2032,"Mark Rutte (VVD)",0.880623272178939,0.810530514559234,0
"<anonymized_userid>",1,3505,2033,"Mark Rutte (VVD)",0.880874591605931,0.810929397686478,0
"<anonymized_userid>",1,3506,2034,"Mark Rutte (VVD)",0.881125911032923,0.811328280813722,0
"<anonymized_userid>",1,3507,2035,"Mark Rutte (VVD)",0.881377230459915,0.811727163940965,0
"<anonymized_userid>",1,3508,2036,"Mark Rutte (VVD)",0.881628549886906,0.812126047068209,0
"<anonymized_userid>",1,3509,2037,"Mark Rutte (VVD)",0.881879869313898,0.812524930195453,0
"<anonymized_userid>",1,3510,2038,"Mark Rutte (VVD)",0.88213118874089,0.812923813322696,0
"<anonymized_userid>",1,3511,2039,"Mark Rutte (VVD)",0.882382508167881,0.81332269644994,0
"<anonymized_userid>",1,3512,2040,"Mark Rutte (VVD)",0.882633827594873,0.813721579577184,0
"<anonymized_userid>",1,3513,2041,"Mark Rutte (VVD)",0.882885147021865,0.814120462704428,0
"<anonymized_userid>",1,3514,2042,"Mark Rutte (VVD)",0.883136466448856,0.814519345831671,0
"<anonymized_userid>",1,3515,2043,"Mark Rutte (VVD)",0.883387785875848,0.814918228958915,0
"<anonymized_userid>",1,3516,2044,"Mark Rutte (VVD)",0.88363910530284,0.815317112086159,0
"<anonymized_userid>",1,3517,2045,"Mark Rutte (VVD)",0.883890424729832,0.815715995213402,0
"<anonymized_userid>",1,3518,2046,"Mark Rutte (VVD)",0.884141744156823,0.816114878340646,0
"<anonymized_userid>",1,3519,2047,"Mark Rutte (VVD)",0.884393063583815,0.81651376146789,0
"<anonymized_userid>",1,3520,2048,"Mark Rutte (VVD)",0.884644383010807,0.816912644595134,0
"<anonymized_userid>",1,3521,2049,"Mark Rutte (VVD)",0.884895702437798,0.817311527722377,0
"<anonymized_userid>",1,3522,2050,"Mark Rutte (VVD)",0.88514702186479,0.817710410849621,0
"<anonymized_userid>",1,3523,2051,"Mark Rutte (VVD)",0.885398341291782,0.818109293976865,0
"<anonymized_userid>",1,3524,2052,"Mark Rutte (VVD)",0.885649660718774,0.818508177104109,0
"<anonymized_userid>",1,3525,2053,"Mark Rutte (VVD)",0.885900980145765,0.818907060231352,0
"<anonymized_userid>",1,3526,2054,"Mark Rutte (VVD)",0.886152299572757,0.819305943358596,0
"<anonymized_userid>",1,3527,2055,"Mark Rutte (VVD)",0.886403618999749,0.81970482648584,0
"<anonymized_userid>",1,3528,2056,"Mark Rutte (VVD)",0.88665493842674,0.820103709613083,0
"<anonymized_userid>",1,3529,2057,"Mark Rutte (VVD)",0.886906257853732,0.820502592740327,0
"<anonymized_userid>",1,3530,2058,"Mark Rutte (VVD)",0.887157577280724,0.820901475867571,0
"<anonymized_userid>",1,3531,2059,"Mark Rutte (VVD)",0.887408896707715,0.821300358994815,0
"<anonymized_userid>",1,3532,2060,"Mark Rutte (VVD)",0.887660216134707,0.821699242122058,0
"<anonymized_userid>",1,3533,2061,"Mark Rutte (VVD)",0.887911535561699,0.822098125249302,0
"<anonymized_userid>",1,3534,2062,"Mark Rutte (VVD)",0.888162854988691,0.822497008376546,0
"<anonymized_userid>",1,3535,2063,"Mark Rutte (VVD)",0.888414174415682,0.822895891503789,0
"<anonymized_userid>",1,3536,2064,"Mark Rutte (VVD)",0.888665493842674,0.823294774631033,0
"<anonymized_userid>",1,3537,2065,"Mark Rutte (VVD)",0.888916813269666,0.823693657758277,0
"<anonymized_userid>",1,3538,2066,"Mark Rutte (VVD)",0.889168132696657,0.824092540885521,0
"<anonymized_userid>",1,3539,2067,"Mark Rutte (VVD)",0.889419452123649,0.824491424012764,0
"<anonymized_userid>",1,3540,2068,"Mark Rutte (VVD)",0.889670771550641,0.824890307140008,0
"<anonymized_userid>",1,3541,2069,"Mark Rutte (VVD)",0.889922090977633,0.825289190267252,0
"<anonymized_userid>",1,3542,2070,"Mark Rutte (VVD)",0.890173410404624,0.825688073394495,0
"<anonymized_userid>",1,3543,2071,"Mark Rutte (VVD)",0.890424729831616,0.826086956521739,0
"<anonymized_userid>",1,3544,2072,"Mark Rutte (VVD)",0.890676049258608,0.826485839648983,0
"<anonymized_userid>",1,3545,2073,"Mark Rutte (VVD)",0.890927368685599,0.826884722776227,0
"<anonymized_userid>",1,3546,2074,"Mark Rutte (VVD)",0.891178688112591,0.82728360590347,0
"<anonymized_userid>",1,3547,2075,"Mark Rutte (VVD)",0.891430007539583,0.827682489030714,0
"<anonymized_userid>",1,3548,2076,"Mark Rutte (VVD)",0.891681326966575,0.828081372157958,0
"<anonymized_userid>",1,3549,2077,"Mark Rutte (VVD)",0.891932646393566,0.828480255285201,0
"<anonymized_userid>",1,3550,2078,"Mark Rutte (VVD)",0.892183965820558,0.828879138412445,0
"<anonymized_userid>",1,3551,2079,"Mark Rutte (VVD)",0.89243528524755,0.829278021539689,0
"<anonymized_userid>",1,3552,2080,"Mark Rutte (VVD)",0.892686604674541,0.829676904666933,0
"<anonymized_userid>",1,3553,2081,"Mark Rutte (VVD)",0.892937924101533,0.830075787794176,0
"<anonymized_userid>",1,3554,2082,"Mark Rutte (VVD)",0.893189243528525,0.83047467092142,0
"<anonymized_userid>",1,3555,2083,"Mark Rutte (VVD)",0.893440562955516,0.830873554048664,0
"<anonymized_userid>",1,3556,2084,"Mark Rutte (VVD)",0.893691882382508,0.831272437175907,0
"<anonymized_userid>",1,3557,2085,"Mark Rutte (VVD)",0.8939432018095,0.831671320303151,0
"<anonymized_userid>",1,3558,2086,"Mark Rutte (VVD)",0.894194521236492,0.832070203430395,0
"<anonymized_userid>",1,3559,2087,"Mark Rutte (VVD)",0.894445840663483,0.832469086557639,0
"<anonymized_userid>",1,3560,2088,"Mark Rutte (VVD)",0.894697160090475,0.832867969684882,0
"<anonymized_userid>",1,3561,2089,"Mark Rutte (VVD)",0.894948479517467,0.833266852812126,0
"<anonymized_userid>",1,3562,2090,"Mark Rutte (VVD)",0.895199798944458,0.83366573593937,0
"<anonymized_userid>",1,3563,2091,"Mark Rutte (VVD)",0.89545111837145,0.834064619066613,0
"<anonymized_userid>",1,3564,2092,"Mark Rutte (VVD)",0.895702437798442,0.834463502193857,0
"<anonymized_userid>",1,3565,2093,"Mark Rutte (VVD)",0.895953757225434,0.834862385321101,0
"<anonymized_userid>",1,3566,2094,"Mark Rutte (VVD)",0.896205076652425,0.835261268448345,0
"<anonymized_userid>",1,3567,2095,"Mark Rutte (VVD)",0.896456396079417,0.835660151575588,0
"<anonymized_userid>",1,3568,2096,"Mark Rutte (VVD)",0.896707715506409,0.836059034702832,0
"<anonymized_userid>",1,3569,2097,"Mark Rutte (VVD)",0.8969590349334,0.836457917830076,0
"<anonymized_userid>",1,3570,2098,"Mark Rutte (VVD)",0.897210354360392,0.83685680095732,0
"<anonymized_userid>",1,3571,2099,"Mark Rutte (VVD)",0.897461673787384,0.837255684084563,0
"<anonymized_userid>",1,3572,2100,"Mark Rutte (VVD)",0.897712993214375,0.837654567211807,0
"<anonymized_userid>",1,3573,2101,"Mark Rutte (VVD)",0.897964312641367,0.838053450339051,0
"<anonymized_userid>",1,3574,2102,"Mark Rutte (VVD)",0.898215632068359,0.838452333466294,0
"<anonymized_userid>",1,3575,2103,"Mark Rutte (VVD)",0.898466951495351,0.838851216593538,0
"<anonymized_userid>",1,3576,2104,"Mark Rutte (VVD)",0.898718270922342,0.839250099720782,0
"<anonymized_userid>",1,3577,2105,"Mark Rutte (VVD)",0.898969590349334,0.839648982848026,0
"<anonymized_userid>",1,3578,2106,"Mark Rutte (VVD)",0.899220909776326,0.840047865975269,0
"<anonymized_userid>",1,3579,2107,"Mark Rutte (VVD)",0.899472229203317,0.840446749102513,0
"<anonymized_userid>",1,3580,2108,"Mark Rutte (VVD)",0.899723548630309,0.840845632229757,0
"<anonymized_userid>",1,3581,2109,"Mark Rutte (VVD)",0.899974868057301,0.841244515357,0
"<anonymized_userid>",1,3582,2110,"Mark Rutte (VVD)",0.900226187484293,0.841643398484244,0
"<anonymized_userid>",1,3583,2111,"Mark Rutte (VVD)",0.900477506911284,0.842042281611488,0
"<anonymized_userid>",1,3584,2112,"Mark Rutte (VVD)",0.900728826338276,0.842441164738732,0
"<anonymized_userid>",1,3585,2113,"Mark Rutte (VVD)",0.900980145765268,0.842840047865975,0
"<anonymized_userid>",1,3586,2114,"Mark Rutte (VVD)",0.901231465192259,0.843238930993219,0
"<anonymized_userid>",1,3587,2115,"Mark Rutte (VVD)",0.901482784619251,0.843637814120463,0
"<anonymized_userid>",1,3588,2116,"Mark Rutte (VVD)",0.901734104046243,0.844036697247706,0
"<anonymized_userid>",1,3589,2117,"Mark Rutte (VVD)",0.901985423473235,0.84443558037495,0
"<anonymized_userid>",1,3590,2118,"Mark Rutte (VVD)",0.902236742900226,0.844834463502194,0
"<anonymized_userid>",1,3591,2119,"Mark Rutte (VVD)",0.902488062327218,0.845233346629438,0
"<anonymized_userid>",1,3592,2120,"Mark Rutte (VVD)",0.90273938175421,0.845632229756681,0
"<anonymized_userid>",1,3593,2121,"Mark Rutte (VVD)",0.902990701181201,0.846031112883925,0
"<anonymized_userid>",1,3594,2122,"Mark Rutte (VVD)",0.903242020608193,0.846429996011169,0
"<anonymized_userid>",1,3595,2123,"Mark Rutte (VVD)",0.903493340035185,0.846828879138412,0
"<anonymized_userid>",1,3596,2124,"Mark Rutte (VVD)",0.903744659462176,0.847227762265656,0
"<anonymized_userid>",1,3597,2125,"Mark Rutte (VVD)",0.903995978889168,0.8476266453929,0
"<anonymized_userid>",1,3598,2126,"Mark Rutte (VVD)",0.90424729831616,0.848025528520144,0
"<anonymized_userid>",1,3599,2127,"Mark Rutte (VVD)",0.904498617743152,0.848424411647387,0
"<anonymized_userid>",1,3600,2128,"Mark Rutte (VVD)",0.904749937170143,0.848823294774631,0
"<anonymized_userid>",1,3601,2129,"Mark Rutte (VVD)",0.905001256597135,0.849222177901875,0
"<anonymized_userid>",1,3602,2130,"Mark Rutte (VVD)",0.905252576024127,0.849621061029118,0
"<anonymized_userid>",1,3603,2131,"Mark Rutte (VVD)",0.905503895451118,0.850019944156362,0
"<anonymized_userid>",1,3604,2132,"Mark Rutte (VVD)",0.90575521487811,0.850418827283606,0
"<anonymized_userid>",1,3605,2133,"Mark Rutte (VVD)",0.906006534305102,0.85081771041085,0
"<anonymized_userid>",1,3606,2134,"Mark Rutte (VVD)",0.906257853732093,0.851216593538093,0
"<anonymized_userid>",1,3607,2135,"Mark Rutte (VVD)",0.906509173159085,0.851615476665337,0
"<anonymized_userid>",1,3608,2136,"Mark Rutte (VVD)",0.906760492586077,0.852014359792581,0
"<anonymized_userid>",1,3609,2137,"Mark Rutte (VVD)",0.907011812013069,0.852413242919824,0
"<anonymized_userid>",1,3610,2138,"Mark Rutte (VVD)",0.90726313144006,0.852812126047068,0
"<anonymized_userid>",1,3611,2139,"Mark Rutte (VVD)",0.907514450867052,0.853211009174312,0
"<anonymized_userid>",1,3612,2140,"Mark Rutte (VVD)",0.907765770294044,0.853609892301556,0
"<anonymized_userid>",1,3613,2141,"Mark Rutte (VVD)",0.908017089721035,0.854008775428799,0
"<anonymized_userid>",1,3614,2142,"Mark Rutte (VVD)",0.908268409148027,0.854407658556043,0
"<anonymized_userid>",1,3615,2143,"Mark Rutte (VVD)",0.908519728575019,0.854806541683287,0
"<anonymized_userid>",1,3616,2144,"Mark Rutte (VVD)",0.908771048002011,0.855205424810531,0
"<anonymized_userid>",1,3617,2145,"Mark Rutte (VVD)",0.909022367429002,0.855604307937774,0
"<anonymized_userid>",1,3618,2146,"Mark Rutte (VVD)",0.909273686855994,0.856003191065018,0
"<anonymized_userid>",1,3619,2147,"Mark Rutte (VVD)",0.909525006282986,0.856402074192262,0
"<anonymized_userid>",1,3620,2148,"Mark Rutte (VVD)",0.909776325709977,0.856800957319505,0
"<anonymized_userid>",1,3621,2149,"Mark Rutte (VVD)",0.910027645136969,0.857199840446749,0
"<anonymized_userid>",1,3622,2150,"Mark Rutte (VVD)",0.910278964563961,0.857598723573993,0
"<anonymized_userid>",1,3623,2151,"Mark Rutte (VVD)",0.910530283990952,0.857997606701237,0
"<anonymized_userid>",1,3624,2152,"Mark Rutte (VVD)",0.910781603417944,0.85839648982848,0
"<anonymized_userid>",1,3625,2153,"Mark Rutte (VVD)",0.911032922844936,0.858795372955724,0
"<anonymized_userid>",1,3626,2154,"Mark Rutte (VVD)",0.911284242271928,0.859194256082968,0
"<anonymized_userid>",1,3627,2155,"Mark Rutte (VVD)",0.911535561698919,0.859593139210211,0
"<anonymized_userid>",1,3628,2156,"Mark Rutte (VVD)",0.911786881125911,0.859992022337455,0
"<anonymized_userid>",1,3629,2157,"Mark Rutte (VVD)",0.912038200552903,0.860390905464699,0
"<anonymized_userid>",1,3630,2158,"Mark Rutte (VVD)",0.912289519979894,0.860789788591943,0
"<anonymized_userid>",1,3631,2159,"Mark Rutte (VVD)",0.912540839406886,0.861188671719186,0
"<anonymized_userid>",1,3632,2160,"Mark Rutte (VVD)",0.912792158833878,0.86158755484643,0
"<anonymized_userid>",1,3633,2161,"Mark Rutte (VVD)",0.91304347826087,0.861986437973674,0
"<anonymized_userid>",1,3634,2162,"Mark Rutte (VVD)",0.913294797687861,0.862385321100917,0
"<anonymized_userid>",1,3635,2163,"Mark Rutte (VVD)",0.913546117114853,0.862784204228161,0
"<anonymized_userid>",1,3636,2164,"Mark Rutte (VVD)",0.913797436541845,0.863183087355405,0
"<anonymized_userid>",1,3637,2165,"Mark Rutte (VVD)",0.914048755968836,0.863581970482649,0
"<anonymized_userid>",1,3638,2166,"Mark Rutte (VVD)",0.914300075395828,0.863980853609892,0
"<anonymized_userid>",1,3639,2167,"Mark Rutte (VVD)",0.91455139482282,0.864379736737136,0
"<anonymized_userid>",1,3640,2168,"Mark Rutte (VVD)",0.914802714249812,0.86477861986438,0
"<anonymized_userid>",1,3641,2169,"Mark Rutte (VVD)",0.915054033676803,0.865177502991623,0
"<anonymized_userid>",1,3642,2170,"Mark Rutte (VVD)",0.915305353103795,0.865576386118867,0
"<anonymized_userid>",1,3643,2171,"Mark Rutte (VVD)",0.915556672530787,0.865975269246111,0
"<anonymized_userid>",1,3644,2172,"Mark Rutte (VVD)",0.915807991957778,0.866374152373355,0
"<anonymized_userid>",1,3645,2173,"Mark Rutte (VVD)",0.91605931138477,0.866773035500598,0
"<anonymized_userid>",1,3646,2174,"Mark Rutte (VVD)",0.916310630811762,0.867171918627842,0
"<anonymized_userid>",1,3647,2175,"Mark Rutte (VVD)",0.916561950238753,0.867570801755086,0
"<anonymized_userid>",1,3648,2176,"Mark Rutte (VVD)",0.916813269665745,0.86796968488233,0
"<anonymized_userid>",1,3649,2177,"Mark Rutte (VVD)",0.917064589092737,0.868368568009573,0
"<anonymized_userid>",1,3650,2178,"Mark Rutte (VVD)",0.917315908519729,0.868767451136817,0
"<anonymized_userid>",1,3651,2179,"Mark Rutte (VVD)",0.91756722794672,0.869166334264061,0
"<anonymized_userid>",1,3652,2180,"Mark Rutte (VVD)",0.917818547373712,0.869565217391304,0
"<anonymized_userid>",1,3653,2181,"Mark Rutte (VVD)",0.918069866800704,0.869964100518548,0
"<anonymized_userid>",1,3654,2182,"Mark Rutte (VVD)",0.918321186227695,0.870362983645792,0
"<anonymized_userid>",1,3655,2183,"Mark Rutte (VVD)",0.918572505654687,0.870761866773035,0
"<anonymized_userid>",1,3656,2184,"Mark Rutte (VVD)",0.918823825081679,0.871160749900279,0
"<anonymized_userid>",1,3657,2185,"Mark Rutte (VVD)",0.919075144508671,0.871559633027523,0
"<anonymized_userid>",1,3658,2186,"Mark Rutte (VVD)",0.919326463935662,0.871958516154767,0
"<anonymized_userid>",1,3659,2187,"Mark Rutte (VVD)",0.919577783362654,0.87235739928201,0
"<anonymized_userid>",1,3660,2188,"Mark Rutte (VVD)",0.919829102789646,0.872756282409254,0
"<anonymized_userid>",1,3661,2189,"Mark Rutte (VVD)",0.920080422216637,0.873155165536498,0
"<anonymized_userid>",1,3662,2190,"Mark Rutte (VVD)",0.920331741643629,0.873554048663742,0
"<anonymized_userid>",1,3663,2191,"Mark Rutte (VVD)",0.920583061070621,0.873952931790985,0
"<anonymized_userid>",1,3664,2192,"Mark Rutte (VVD)",0.920834380497612,0.874351814918229,0
"<anonymized_userid>",1,3665,2193,"Mark Rutte (VVD)",0.921085699924604,0.874750698045473,0
"<anonymized_userid>",1,3666,2194,"Mark Rutte (VVD)",0.921337019351596,0.875149581172716,0
"<anonymized_userid>",1,3667,2195,"Mark Rutte (VVD)",0.921588338778588,0.87554846429996,0
"<anonymized_userid>",1,3668,2196,"Mark Rutte (VVD)",0.921839658205579,0.875947347427204,0
"<anonymized_userid>",1,3669,2197,"Mark Rutte (VVD)",0.922090977632571,0.876346230554447,0
"<anonymized_userid>",1,3670,2198,"Mark Rutte (VVD)",0.922342297059563,0.876745113681691,0
"<anonymized_userid>",1,3671,2199,"Mark Rutte (VVD)",0.922593616486554,0.877143996808935,0
"<anonymized_userid>",1,3672,2200,"Mark Rutte (VVD)",0.922844935913546,0.877542879936179,0
"<anonymized_userid>",1,3673,2201,"Mark Rutte (VVD)",0.923096255340538,0.877941763063422,0
"<anonymized_userid>",1,3674,2202,"Mark Rutte (VVD)",0.923347574767529,0.878340646190666,0
"<anonymized_userid>",1,3675,2203,"Mark Rutte (VVD)",0.923598894194521,0.87873952931791,0
"<anonymized_userid>",1,3676,2204,"Mark Rutte (VVD)",0.923850213621513,0.879138412445154,0
"<anonymized_userid>",1,3677,2205,"Mark Rutte (VVD)",0.924101533048505,0.879537295572397,0
"<anonymized_userid>",1,3678,2206,"Mark Rutte (VVD)",0.924352852475496,0.879936178699641,0
"<anonymized_userid>",1,3679,2207,"Mark Rutte (VVD)",0.924604171902488,0.880335061826885,0
"<anonymized_userid>",1,3680,2208,"Mark Rutte (VVD)",0.92485549132948,0.880733944954128,0
"<anonymized_userid>",1,3681,2209,"Mark Rutte (VVD)",0.925106810756471,0.881132828081372,0
"<anonymized_userid>",1,3682,2210,"Mark Rutte (VVD)",0.925358130183463,0.881531711208616,0
"<anonymized_userid>",1,3683,2211,"Mark Rutte (VVD)",0.925609449610455,0.88193059433586,0
"<anonymized_userid>",1,3684,2212,"Mark Rutte (VVD)",0.925860769037447,0.882329477463103,0
"<anonymized_userid>",1,3685,2213,"Mark Rutte (VVD)",0.926112088464438,0.882728360590347,0
"<anonymized_userid>",1,3686,2214,"Mark Rutte (VVD)",0.92636340789143,0.883127243717591,0
"<anonymized_userid>",1,3687,2215,"Mark Rutte (VVD)",0.926614727318422,0.883526126844834,0
"<anonymized_userid>",1,3688,2216,"Mark Rutte (VVD)",0.926866046745413,0.883925009972078,0
"<anonymized_userid>",1,3689,2217,"Mark Rutte (VVD)",0.927117366172405,0.884323893099322,0
"<anonymized_userid>",1,3690,2218,"Mark Rutte (VVD)",0.927368685599397,0.884722776226566,0
"<anonymized_userid>",1,3691,2219,"Mark Rutte (VVD)",0.927620005026389,0.885121659353809,0
"<anonymized_userid>",1,3692,2220,"Mark Rutte (VVD)",0.92787132445338,0.885520542481053,0
"<anonymized_userid>",1,3693,2221,"Mark Rutte (VVD)",0.928122643880372,0.885919425608297,0
"<anonymized_userid>",1,3694,2222,"Mark Rutte (VVD)",0.928373963307364,0.886318308735541,0
"<anonymized_userid>",1,3695,2223,"Mark Rutte (VVD)",0.928625282734355,0.886717191862784,0
"<anonymized_userid>",1,3696,2224,"Mark Rutte (VVD)",0.928876602161347,0.887116074990028,0
"<anonymized_userid>",1,3697,2225,"Mark Rutte (VVD)",0.929127921588339,0.887514958117272,0
"<anonymized_userid>",1,3698,2226,"Mark Rutte (VVD)",0.929379241015331,0.887913841244515,0
"<anonymized_userid>",1,3699,2227,"Mark Rutte (VVD)",0.929630560442322,0.888312724371759,0
"<anonymized_userid>",1,3700,2228,"Mark Rutte (VVD)",0.929881879869314,0.888711607499003,0
"<anonymized_userid>",1,3701,2229,"Mark Rutte (VVD)",0.930133199296306,0.889110490626246,0
"<anonymized_userid>",1,3702,2230,"Mark Rutte (VVD)",0.930384518723297,0.88950937375349,0
"<anonymized_userid>",1,3703,2231,"Mark Rutte (VVD)",0.930635838150289,0.889908256880734,0
"<anonymized_userid>",1,3704,2232,"Mark Rutte (VVD)",0.930887157577281,0.890307140007978,0
"<anonymized_userid>",1,3705,2233,"Mark Rutte (VVD)",0.931138477004272,0.890706023135221,0
"<anonymized_userid>",1,3706,2234,"Mark Rutte (VVD)",0.931389796431264,0.891104906262465,0
"<anonymized_userid>",1,3707,2235,"Mark Rutte (VVD)",0.931641115858256,0.891503789389709,0
"<anonymized_userid>",1,3708,2236,"Mark Rutte (VVD)",0.931892435285248,0.891902672516953,0
"<anonymized_userid>",1,3709,2237,"Mark Rutte (VVD)",0.932143754712239,0.892301555644196,0
"<anonymized_userid>",1,3710,2238,"Mark Rutte (VVD)",0.932395074139231,0.89270043877144,0
"<anonymized_userid>",1,3711,2239,"Mark Rutte (VVD)",0.932646393566223,0.893099321898684,0
"<anonymized_userid>",1,3712,2240,"Mark Rutte (VVD)",0.932897712993214,0.893498205025927,0
"<anonymized_userid>",1,3713,2241,"Mark Rutte (VVD)",0.933149032420206,0.893897088153171,0
"<anonymized_userid>",1,3714,2242,"Mark Rutte (VVD)",0.933400351847198,0.894295971280415,0
"<anonymized_userid>",1,3715,2243,"Mark Rutte (VVD)",0.933651671274189,0.894694854407659,0
"<anonymized_userid>",1,3716,2244,"Mark Rutte (VVD)",0.933902990701181,0.895093737534902,0
"<anonymized_userid>",1,3717,2245,"Mark Rutte (VVD)",0.934154310128173,0.895492620662146,0
"<anonymized_userid>",1,3718,2246,"Mark Rutte (VVD)",0.934405629555165,0.89589150378939,0
"<anonymized_userid>",1,3719,2247,"Mark Rutte (VVD)",0.934656948982156,0.896290386916633,0
"<anonymized_userid>",1,3720,2248,"Mark Rutte (VVD)",0.934908268409148,0.896689270043877,0
"<anonymized_userid>",1,3721,2249,"Mark Rutte (VVD)",0.93515958783614,0.897088153171121,0
"<anonymized_userid>",1,3722,2250,"Mark Rutte (VVD)",0.935410907263131,0.897487036298365,0
"<anonymized_userid>",1,3723,2251,"Mark Rutte (VVD)",0.935662226690123,0.897885919425608,0
"<anonymized_userid>",1,3724,2252,"Mark Rutte (VVD)",0.935913546117115,0.898284802552852,0
"<anonymized_userid>",1,3725,2253,"Mark Rutte (VVD)",0.936164865544107,0.898683685680096,0
"<anonymized_userid>",1,3726,2254,"Mark Rutte (VVD)",0.936416184971098,0.899082568807339,0
"<anonymized_userid>",1,3727,2255,"Mark Rutte (VVD)",0.93666750439809,0.899481451934583,0
"<anonymized_userid>",1,3728,2256,"Mark Rutte (VVD)",0.936918823825082,0.899880335061827,0
"<anonymized_userid>",1,3729,2257,"Mark Rutte (VVD)",0.937170143252073,0.900279218189071,0
"<anonymized_userid>",1,3730,2258,"Mark Rutte (VVD)",0.937421462679065,0.900678101316314,0
"<anonymized_userid>",1,3731,2259,"Mark Rutte (VVD)",0.937672782106057,0.901076984443558,0
"<anonymized_userid>",1,3732,2260,"Mark Rutte (VVD)",0.937924101533049,0.901475867570802,0
"<anonymized_userid>",1,3733,2261,"Mark Rutte (VVD)",0.93817542096004,0.901874750698045,0
"<anonymized_userid>",1,3734,2262,"Mark Rutte (VVD)",0.938426740387032,0.902273633825289,0
"<anonymized_userid>",1,3735,2263,"Mark Rutte (VVD)",0.938678059814024,0.902672516952533,0
"<anonymized_userid>",1,3736,2264,"Mark Rutte (VVD)",0.938929379241015,0.903071400079777,0
"<anonymized_userid>",1,3737,2265,"Mark Rutte (VVD)",0.939180698668007,0.90347028320702,0
"<anonymized_userid>",1,3738,2266,"Mark Rutte (VVD)",0.939432018094999,0.903869166334264,0
"<anonymized_userid>",1,3739,2267,"Mark Rutte (VVD)",0.93968333752199,0.904268049461508,0
"<anonymized_userid>",1,3740,2268,"Mark Rutte (VVD)",0.939934656948982,0.904666932588752,0
"<anonymized_userid>",1,3741,2269,"Mark Rutte (VVD)",0.940185976375974,0.905065815715995,0
"<anonymized_userid>",1,3742,2270,"Mark Rutte (VVD)",0.940437295802966,0.905464698843239,0
"<anonymized_userid>",1,3743,2271,"Mark Rutte (VVD)",0.940688615229957,0.905863581970483,0
"<anonymized_userid>",1,3744,2272,"Mark Rutte (VVD)",0.940939934656949,0.906262465097726,0
"<anonymized_userid>",1,3745,2273,"Mark Rutte (VVD)",0.941191254083941,0.90666134822497,0
"<anonymized_userid>",1,3746,2274,"Mark Rutte (VVD)",0.941442573510932,0.907060231352214,0
"<anonymized_userid>",1,3747,2275,"Mark Rutte (VVD)",0.941693892937924,0.907459114479457,0
"<anonymized_userid>",1,3748,2276,"Mark Rutte (VVD)",0.941945212364916,0.907857997606701,0
"<anonymized_userid>",1,3749,2277,"Mark Rutte (VVD)",0.942196531791908,0.908256880733945,0
"<anonymized_userid>",1,3750,2278,"Mark Rutte (VVD)",0.942447851218899,0.908655763861189,0
"<anonymized_userid>",1,3751,2279,"Mark Rutte (VVD)",0.942699170645891,0.909054646988432,0
"<anonymized_userid>",1,3752,2280,"Mark Rutte (VVD)",0.942950490072883,0.909453530115676,0
"<anonymized_userid>",1,3753,2281,"Mark Rutte (VVD)",0.943201809499874,0.90985241324292,0
"<anonymized_userid>",1,3754,2282,"Mark Rutte (VVD)",0.943453128926866,0.910251296370164,0
"<anonymized_userid>",1,3755,2283,"Mark Rutte (VVD)",0.943704448353858,0.910650179497407,0
"<anonymized_userid>",1,3756,2284,"Mark Rutte (VVD)",0.943955767780849,0.911049062624651,0
"<anonymized_userid>",1,3757,2285,"Mark Rutte (VVD)",0.944207087207841,0.911447945751895,0
"<anonymized_userid>",1,3758,2286,"Mark Rutte (VVD)",0.944458406634833,0.911846828879138,0
"<anonymized_userid>",1,3759,2287,"Mark Rutte (VVD)",0.944709726061825,0.912245712006382,0
"<anonymized_userid>",1,3760,2288,"Mark Rutte (VVD)",0.944961045488816,0.912644595133626,0
"<anonymized_userid>",1,3761,2289,"Mark Rutte (VVD)",0.945212364915808,0.91304347826087,0
"<anonymized_userid>",1,3762,2290,"Mark Rutte (VVD)",0.9454636843428,0.913442361388113,0
"<anonymized_userid>",1,3763,2291,"Mark Rutte (VVD)",0.945715003769791,0.913841244515357,0
"<anonymized_userid>",1,3764,2292,"Mark Rutte (VVD)",0.945966323196783,0.914240127642601,0
"<anonymized_userid>",1,3765,2293,"Mark Rutte (VVD)",0.946217642623775,0.914639010769844,0
"<anonymized_userid>",1,3766,2294,"Mark Rutte (VVD)",0.946468962050766,0.915037893897088,0
"<anonymized_userid>",1,3767,2295,"Mark Rutte (VVD)",0.946720281477758,0.915436777024332,0
"<anonymized_userid>",1,3768,2296,"Mark Rutte (VVD)",0.94697160090475,0.915835660151576,0
"<anonymized_userid>",1,3769,2297,"Mark Rutte (VVD)",0.947222920331742,0.916234543278819,0
"<anonymized_userid>",1,3770,2298,"Mark Rutte (VVD)",0.947474239758733,0.916633426406063,0
"<anonymized_userid>",1,3771,2299,"Mark Rutte (VVD)",0.947725559185725,0.917032309533307,0
"<anonymized_userid>",1,3772,2300,"Mark Rutte (VVD)",0.947976878612717,0.917431192660551,0
"<anonymized_userid>",1,3773,2301,"Mark Rutte (VVD)",0.948228198039708,0.917830075787794,0
"<anonymized_userid>",1,3774,2302,"Mark Rutte (VVD)",0.9484795174667,0.918228958915038,0
"<anonymized_userid>",1,3775,2303,"Mark Rutte (VVD)",0.948730836893692,0.918627842042282,0
"<anonymized_userid>",1,3776,2304,"Mark Rutte (VVD)",0.948982156320684,0.919026725169525,0
"<anonymized_userid>",1,3777,2305,"Mark Rutte (VVD)",0.949233475747675,0.919425608296769,0
"<anonymized_userid>",1,3778,2306,"Mark Rutte (VVD)",0.949484795174667,0.919824491424013,0
"<anonymized_userid>",1,3779,2307,"Mark Rutte (VVD)",0.949736114601659,0.920223374551256,0
"<anonymized_userid>",1,3780,2308,"Mark Rutte (VVD)",0.94998743402865,0.9206222576785,0
"<anonymized_userid>",1,3781,2309,"Mark Rutte (VVD)",0.950238753455642,0.921021140805744,0
"<anonymized_userid>",1,3782,2310,"Mark Rutte (VVD)",0.950490072882634,0.921420023932988,0
"<anonymized_userid>",1,3783,2311,"Mark Rutte (VVD)",0.950741392309626,0.921818907060231,0
"<anonymized_userid>",1,3784,2312,"Mark Rutte (VVD)",0.950992711736617,0.922217790187475,0
"<anonymized_userid>",1,3785,2313,"Mark Rutte (VVD)",0.951244031163609,0.922616673314719,0
"<anonymized_userid>",1,3786,2314,"Mark Rutte (VVD)",0.951495350590601,0.923015556441963,0
"<anonymized_userid>",1,3787,2315,"Mark Rutte (VVD)",0.951746670017592,0.923414439569206,0
"<anonymized_userid>",1,3788,2316,"Mark Rutte (VVD)",0.951997989444584,0.92381332269645,0
"<anonymized_userid>",1,3789,2317,"Mark Rutte (VVD)",0.952249308871576,0.924212205823694,0
"<anonymized_userid>",1,3790,2318,"Mark Rutte (VVD)",0.952500628298568,0.924611088950937,0
"<anonymized_userid>",1,3791,2319,"Mark Rutte (VVD)",0.952751947725559,0.925009972078181,0
"<anonymized_userid>",1,3792,2320,"Mark Rutte (VVD)",0.953003267152551,0.925408855205425,0
"<anonymized_userid>",1,3793,2321,"Mark Rutte (VVD)",0.953254586579543,0.925807738332668,0
"<anonymized_userid>",1,3794,2322,"Mark Rutte (VVD)",0.953505906006534,0.926206621459912,0
"<anonymized_userid>",1,3795,2323,"Mark Rutte (VVD)",0.953757225433526,0.926605504587156,0
"<anonymized_userid>",1,3796,2324,"Mark Rutte (VVD)",0.954008544860518,0.9270043877144,0
"<anonymized_userid>",1,3797,2325,"Mark Rutte (VVD)",0.954259864287509,0.927403270841643,0
"<anonymized_userid>",1,3798,2326,"Mark Rutte (VVD)",0.954511183714501,0.927802153968887,0
"<anonymized_userid>",1,3799,2327,"Mark Rutte (VVD)",0.954762503141493,0.928201037096131,0
"<anonymized_userid>",1,3800,2328,"Mark Rutte (VVD)",0.955013822568485,0.928599920223375,0
"<anonymized_userid>",1,3801,2329,"Mark Rutte (VVD)",0.955265141995476,0.928998803350618,0
"<anonymized_userid>",1,3802,2330,"Mark Rutte (VVD)",0.955516461422468,0.929397686477862,0
"<anonymized_userid>",1,3803,2331,"Mark Rutte (VVD)",0.95576778084946,0.929796569605106,0
"<anonymized_userid>",1,3804,2332,"Mark Rutte (VVD)",0.956019100276451,0.930195452732349,0
"<anonymized_userid>",1,3805,2333,"Mark Rutte (VVD)",0.956270419703443,0.930594335859593,0
"<anonymized_userid>",1,3806,2334,"Mark Rutte (VVD)",0.956521739130435,0.930993218986837,0
"<anonymized_userid>",1,3807,2335,"Mark Rutte (VVD)",0.956773058557426,0.931392102114081,0
"<anonymized_userid>",1,3808,2336,"Mark Rutte (VVD)",0.957024377984418,0.931790985241324,0
"<anonymized_userid>",1,3809,2337,"Mark Rutte (VVD)",0.95727569741141,0.932189868368568,0
"<anonymized_userid>",1,3810,2338,"Mark Rutte (VVD)",0.957527016838402,0.932588751495812,0
"<anonymized_userid>",1,3811,2339,"Mark Rutte (VVD)",0.957778336265393,0.932987634623055,0
"<anonymized_userid>",1,3812,2340,"Mark Rutte (VVD)",0.958029655692385,0.933386517750299,0
"<anonymized_userid>",1,3813,2341,"Mark Rutte (VVD)",0.958280975119377,0.933785400877543,0
"<anonymized_userid>",1,3814,2342,"Mark Rutte (VVD)",0.958532294546368,0.934184284004787,0
"<anonymized_userid>",1,3815,2343,"Mark Rutte (VVD)",0.95878361397336,0.93458316713203,0
"<anonymized_userid>",1,3816,2344,"Mark Rutte (VVD)",0.959034933400352,0.934982050259274,0
"<anonymized_userid>",1,3817,2345,"Mark Rutte (VVD)",0.959286252827344,0.935380933386518,0
"<anonymized_userid>",1,3818,2346,"Mark Rutte (VVD)",0.959537572254335,0.935779816513762,0
"<anonymized_userid>",1,3819,2347,"Mark Rutte (VVD)",0.959788891681327,0.936178699641005,0
"<anonymized_userid>",1,3820,2348,"Mark Rutte (VVD)",0.960040211108319,0.936577582768249,0
"<anonymized_userid>",1,3821,2349,"Mark Rutte (VVD)",0.96029153053531,0.936976465895493,0
"<anonymized_userid>",1,3822,2350,"Mark Rutte (VVD)",0.960542849962302,0.937375349022736,0
"<anonymized_userid>",1,3823,2351,"Mark Rutte (VVD)",0.960794169389294,0.93777423214998,0
"<anonymized_userid>",1,3824,2352,"Mark Rutte (VVD)",0.961045488816285,0.938173115277224,0
"<anonymized_userid>",1,3825,2353,"Mark Rutte (VVD)",0.961296808243277,0.938571998404467,0
"<anonymized_userid>",1,3826,2354,"Mark Rutte (VVD)",0.961548127670269,0.938970881531711,0
"<anonymized_userid>",1,3827,2355,"Mark Rutte (VVD)",0.961799447097261,0.939369764658955,0
"<anonymized_userid>",1,3828,2356,"Mark Rutte (VVD)",0.962050766524252,0.939768647786199,0
"<anonymized_userid>",1,3829,2357,"Mark Rutte (VVD)",0.962302085951244,0.940167530913442,0
"<anonymized_userid>",1,3830,2358,"Mark Rutte (VVD)",0.962553405378236,0.940566414040686,0
"<anonymized_userid>",1,3831,2359,"Mark Rutte (VVD)",0.962804724805227,0.94096529716793,0
"<anonymized_userid>",1,3832,2360,"Mark Rutte (VVD)",0.963056044232219,0.941364180295174,0
"<anonymized_userid>",1,3833,2361,"Mark Rutte (VVD)",0.963307363659211,0.941763063422417,0
"<anonymized_userid>",1,3834,2362,"Mark Rutte (VVD)",0.963558683086203,0.942161946549661,0
"<anonymized_userid>",1,3835,2363,"Mark Rutte (VVD)",0.963810002513194,0.942560829676905,0
"<anonymized_userid>",1,3836,2364,"Mark Rutte (VVD)",0.964061321940186,0.942959712804148,0
"<anonymized_userid>",1,3837,2365,"Mark Rutte (VVD)",0.964312641367178,0.943358595931392,0
"<anonymized_userid>",1,3838,2366,"Mark Rutte (VVD)",0.964563960794169,0.943757479058636,0
"<anonymized_userid>",1,3839,2367,"Mark Rutte (VVD)",0.964815280221161,0.94415636218588,0
"<anonymized_userid>",1,3840,2368,"Mark Rutte (VVD)",0.965066599648153,0.944555245313123,0
"<anonymized_userid>",1,3841,2369,"Mark Rutte (VVD)",0.965317919075145,0.944954128440367,0
"<anonymized_userid>",1,3842,2370,"Mark Rutte (VVD)",0.965569238502136,0.945353011567611,0
"<anonymized_userid>",1,3843,2371,"Mark Rutte (VVD)",0.965820557929128,0.945751894694854,0
"<anonymized_userid>",1,3844,2372,"Mark Rutte (VVD)",0.96607187735612,0.946150777822098,0
"<anonymized_userid>",1,3845,2373,"Mark Rutte (VVD)",0.966323196783111,0.946549660949342,0
"<anonymized_userid>",1,3846,2374,"Mark Rutte (VVD)",0.966574516210103,0.946948544076586,0
"<anonymized_userid>",1,3847,2375,"Mark Rutte (VVD)",0.966825835637095,0.947347427203829,0
"<anonymized_userid>",1,3848,2376,"Mark Rutte (VVD)",0.967077155064086,0.947746310331073,0
"<anonymized_userid>",1,3849,2377,"Mark Rutte (VVD)",0.967328474491078,0.948145193458317,0
"<anonymized_userid>",1,3850,2378,"Mark Rutte (VVD)",0.96757979391807,0.94854407658556,0
"<anonymized_userid>",1,3851,2379,"Mark Rutte (VVD)",0.967831113345062,0.948942959712804,0
"<anonymized_userid>",1,3852,2380,"Mark Rutte (VVD)",0.968082432772053,0.949341842840048,0
"<anonymized_userid>",1,3853,2381,"Mark Rutte (VVD)",0.968333752199045,0.949740725967292,0
"<anonymized_userid>",1,3854,2382,"Mark Rutte (VVD)",0.968585071626037,0.950139609094535,0
"<anonymized_userid>",1,3855,2383,"Mark Rutte (VVD)",0.968836391053028,0.950538492221779,0
"<anonymized_userid>",1,3856,2384,"Mark Rutte (VVD)",0.96908771048002,0.950937375349023,0
"<anonymized_userid>",1,3857,2385,"Mark Rutte (VVD)",0.969339029907012,0.951336258476266,0
"<anonymized_userid>",1,3858,2386,"Mark Rutte (VVD)",0.969590349334004,0.95173514160351,0
"<anonymized_userid>",1,3859,2387,"Mark Rutte (VVD)",0.969841668760995,0.952134024730754,0
"<anonymized_userid>",1,3860,2388,"Mark Rutte (VVD)",0.970092988187987,0.952532907857998,0
"<anonymized_userid>",1,3861,2389,"Mark Rutte (VVD)",0.970344307614979,0.952931790985241,0
"<anonymized_userid>",1,3862,2390,"Mark Rutte (VVD)",0.97059562704197,0.953330674112485,0
"<anonymized_userid>",1,3863,2391,"Mark Rutte (VVD)",0.970846946468962,0.953729557239729,0
"<anonymized_userid>",1,3864,2392,"Mark Rutte (VVD)",0.971098265895954,0.954128440366973,0
"<anonymized_userid>",1,3865,2393,"Mark Rutte (VVD)",0.971349585322945,0.954527323494216,0
"<anonymized_userid>",1,3866,2394,"Mark Rutte (VVD)",0.971600904749937,0.95492620662146,0
"<anonymized_userid>",1,3867,2395,"Mark Rutte (VVD)",0.971852224176929,0.955325089748704,0
"<anonymized_userid>",1,3868,2396,"Mark Rutte (VVD)",0.972103543603921,0.955723972875947,0
"<anonymized_userid>",1,3869,2397,"Mark Rutte (VVD)",0.972354863030912,0.956122856003191,0
"<anonymized_userid>",1,3870,2398,"Mark Rutte (VVD)",0.972606182457904,0.956521739130435,0
"<anonymized_userid>",1,3871,2399,"Mark Rutte (VVD)",0.972857501884896,0.956920622257678,0
"<anonymized_userid>",1,3872,2400,"Mark Rutte (VVD)",0.973108821311887,0.957319505384922,0
"<anonymized_userid>",1,3873,2401,"Mark Rutte (VVD)",0.973360140738879,0.957718388512166,0
"<anonymized_userid>",1,3874,2402,"Mark Rutte (VVD)",0.973611460165871,0.95811727163941,0
"<anonymized_userid>",1,3875,2403,"Mark Rutte (VVD)",0.973862779592862,0.958516154766653,0
"<anonymized_userid>",1,3876,2404,"Mark Rutte (VVD)",0.974114099019854,0.958915037893897,0
"<anonymized_userid>",1,3877,2405,"Mark Rutte (VVD)",0.974365418446846,0.959313921021141,0
"<anonymized_userid>",1,3878,2406,"Mark Rutte (VVD)",0.974616737873838,0.959712804148385,0
"<anonymized_userid>",1,3879,2407,"Mark Rutte (VVD)",0.974868057300829,0.960111687275628,0
"<anonymized_userid>",1,3880,2408,"Mark Rutte (VVD)",0.975119376727821,0.960510570402872,0
"<anonymized_userid>",1,3881,2409,"Mark Rutte (VVD)",0.975370696154813,0.960909453530116,0
"<anonymized_userid>",1,3882,2410,"Mark Rutte (VVD)",0.975622015581805,0.961308336657359,0
"<anonymized_userid>",1,3883,2411,"Mark Rutte (VVD)",0.975873335008796,0.961707219784603,0
"<anonymized_userid>",1,3884,2412,"Mark Rutte (VVD)",0.976124654435788,0.962106102911847,0
"<anonymized_userid>",1,3885,2413,"Mark Rutte (VVD)",0.97637597386278,0.962504986039091,0
"<anonymized_userid>",1,3886,2414,"Mark Rutte (VVD)",0.976627293289771,0.962903869166334,0
"<anonymized_userid>",1,3887,2415,"Mark Rutte (VVD)",0.976878612716763,0.963302752293578,0
"<anonymized_userid>",1,3888,2416,"Mark Rutte (VVD)",0.977129932143755,0.963701635420822,0
"<anonymized_userid>",1,3889,2417,"Mark Rutte (VVD)",0.977381251570746,0.964100518548065,0
"<anonymized_userid>",1,3890,2418,"Mark Rutte (VVD)",0.977632570997738,0.964499401675309,0
"<anonymized_userid>",1,3891,2419,"Mark Rutte (VVD)",0.97788389042473,0.964898284802553,0
"<anonymized_userid>",1,3892,2420,"Mark Rutte (VVD)",0.978135209851722,0.965297167929797,0
"<anonymized_userid>",1,3893,2421,"Mark Rutte (VVD)",0.978386529278713,0.96569605105704,0
"<anonymized_userid>",1,3894,2422,"Mark Rutte (VVD)",0.978637848705705,0.966094934184284,0
"<anonymized_userid>",1,3895,2423,"Mark Rutte (VVD)",0.978889168132697,0.966493817311528,0
"<anonymized_userid>",1,3896,2424,"Mark Rutte (VVD)",0.979140487559688,0.966892700438771,0
"<anonymized_userid>",1,3897,2425,"Mark Rutte (VVD)",0.97939180698668,0.967291583566015,0
"<anonymized_userid>",1,3898,2426,"Mark Rutte (VVD)",0.979643126413672,0.967690466693259,0
"<anonymized_userid>",1,3899,2427,"Mark Rutte (VVD)",0.979894445840663,0.968089349820503,0
"<anonymized_userid>",1,3900,2428,"Mark Rutte (VVD)",0.980145765267655,0.968488232947746,0
"<anonymized_userid>",1,3901,2429,"Mark Rutte (VVD)",0.980397084694647,0.96888711607499,0
"<anonymized_userid>",1,3902,2430,"Mark Rutte (VVD)",0.980648404121639,0.969285999202234,0
"<anonymized_userid>",1,3903,2431,"Mark Rutte (VVD)",0.98089972354863,0.969684882329477,0
"<anonymized_userid>",1,3904,2432,"Mark Rutte (VVD)",0.981151042975622,0.970083765456721,0
"<anonymized_userid>",1,3905,2433,"Mark Rutte (VVD)",0.981402362402614,0.970482648583965,0
"<anonymized_userid>",1,3906,2434,"Mark Rutte (VVD)",0.981653681829605,0.970881531711209,0
"<anonymized_userid>",1,3907,2435,"Mark Rutte (VVD)",0.981905001256597,0.971280414838452,0
"<anonymized_userid>",1,3908,2436,"Mark Rutte (VVD)",0.982156320683589,0.971679297965696,0
"<anonymized_userid>",1,3909,2437,"Mark Rutte (VVD)",0.982407640110581,0.97207818109294,0
"<anonymized_userid>",1,3910,2438,"Mark Rutte (VVD)",0.982658959537572,0.972477064220184,0
"<anonymized_userid>",1,3911,2439,"Mark Rutte (VVD)",0.982910278964564,0.972875947347427,0
"<anonymized_userid>",1,3912,2440,"Mark Rutte (VVD)",0.983161598391556,0.973274830474671,0
"<anonymized_userid>",1,3913,2441,"Mark Rutte (VVD)",0.983412917818547,0.973673713601915,0
"<anonymized_userid>",1,3914,2442,"Mark Rutte (VVD)",0.983664237245539,0.974072596729158,0
"<anonymized_userid>",1,3915,2443,"Mark Rutte (VVD)",0.983915556672531,0.974471479856402,0
"<anonymized_userid>",1,3916,2444,"Mark Rutte (VVD)",0.984166876099522,0.974870362983646,0
"<anonymized_userid>",1,3917,2445,"Mark Rutte (VVD)",0.984418195526514,0.975269246110889,0
"<anonymized_userid>",1,3918,2446,"Mark Rutte (VVD)",0.984669514953506,0.975668129238133,0
"<anonymized_userid>",1,3919,2447,"Mark Rutte (VVD)",0.984920834380498,0.976067012365377,0
"<anonymized_userid>",1,3920,2448,"Mark Rutte (VVD)",0.985172153807489,0.976465895492621,0
"<anonymized_userid>",1,3921,2449,"Mark Rutte (VVD)",0.985423473234481,0.976864778619864,0
"<anonymized_userid>",1,3922,2450,"Mark Rutte (VVD)",0.985674792661473,0.977263661747108,0
"<anonymized_userid>",1,3923,2451,"Mark Rutte (VVD)",0.985926112088464,0.977662544874352,0
"<anonymized_userid>",1,3924,2452,"Mark Rutte (VVD)",0.986177431515456,0.978061428001596,0
"<anonymized_userid>",1,3925,2453,"Mark Rutte (VVD)",0.986428750942448,0.978460311128839,0
"<anonymized_userid>",1,3926,2454,"Mark Rutte (VVD)",0.98668007036944,0.978859194256083,0
"<anonymized_userid>",1,3927,2455,"Mark Rutte (VVD)",0.986931389796431,0.979258077383327,0
"<anonymized_userid>",1,3928,2456,"Mark Rutte (VVD)",0.987182709223423,0.97965696051057,0
"<anonymized_userid>",1,3929,2457,"Mark Rutte (VVD)",0.987434028650415,0.980055843637814,0
"<anonymized_userid>",1,3930,2458,"Mark Rutte (VVD)",0.987685348077406,0.980454726765058,0
"<anonymized_userid>",1,3931,2459,"Mark Rutte (VVD)",0.987936667504398,0.980853609892302,0
"<anonymized_userid>",1,3932,2460,"Mark Rutte (VVD)",0.98818798693139,0.981252493019545,0
"<anonymized_userid>",1,3933,2461,"Mark Rutte (VVD)",0.988439306358382,0.981651376146789,0
"<anonymized_userid>",1,3934,2462,"Mark Rutte (VVD)",0.988690625785373,0.982050259274033,0
"<anonymized_userid>",1,3935,2463,"Mark Rutte (VVD)",0.988941945212365,0.982449142401276,0
"<anonymized_userid>",1,3936,2464,"Mark Rutte (VVD)",0.989193264639357,0.98284802552852,0
"<anonymized_userid>",1,3937,2465,"Mark Rutte (VVD)",0.989444584066348,0.983246908655764,0
"<anonymized_userid>",1,3938,2466,"Mark Rutte (VVD)",0.98969590349334,0.983645791783008,0
"<anonymized_userid>",1,3939,2467,"Mark Rutte (VVD)",0.989947222920332,0.984044674910251,0
"<anonymized_userid>",1,3940,2468,"Mark Rutte (VVD)",0.990198542347323,0.984443558037495,0
"<anonymized_userid>",1,3941,2469,"Mark Rutte (VVD)",0.990449861774315,0.984842441164739,0
"<anonymized_userid>",1,3942,2470,"Mark Rutte (VVD)",0.990701181201307,0.985241324291982,0
"<anonymized_userid>",1,3943,2471,"Mark Rutte (VVD)",0.990952500628299,0.985640207419226,0
"<anonymized_userid>",1,3944,2472,"Mark Rutte (VVD)",0.99120382005529,0.98603909054647,0
"<anonymized_userid>",1,3945,2473,"Mark Rutte (VVD)",0.991455139482282,0.986437973673714,0
"<anonymized_userid>",1,3946,2474,"Mark Rutte (VVD)",0.991706458909274,0.986836856800957,0
"<anonymized_userid>",1,3947,2475,"Mark Rutte (VVD)",0.991957778336265,0.987235739928201,0
"<anonymized_userid>",1,3948,2476,"Mark Rutte (VVD)",0.992209097763257,0.987634623055445,0
"<anonymized_userid>",1,3949,2477,"Mark Rutte (VVD)",0.992460417190249,0.988033506182688,0
"<anonymized_userid>",1,3950,2478,"Mark Rutte (VVD)",0.992711736617241,0.988432389309932,0
"<anonymized_userid>",1,3951,2479,"Mark Rutte (VVD)",0.992963056044232,0.988831272437176,0
"<anonymized_userid>",1,3952,2480,"Mark Rutte (VVD)",0.993214375471224,0.98923015556442,0
"<anonymized_userid>",1,3953,2481,"Mark Rutte (VVD)",0.993465694898216,0.989629038691663,0
"<anonymized_userid>",1,3954,2482,"Mark Rutte (VVD)",0.993717014325207,0.990027921818907,0
"<anonymized_userid>",1,3955,2483,"Mark Rutte (VVD)",0.993968333752199,0.990426804946151,0
"<anonymized_userid>",1,3956,2484,"Mark Rutte (VVD)",0.994219653179191,0.990825688073395,0
"<anonymized_userid>",1,3957,2485,"Mark Rutte (VVD)",0.994470972606182,0.991224571200638,0
"<anonymized_userid>",1,3958,2486,"Mark Rutte (VVD)",0.994722292033174,0.991623454327882,0
"<anonymized_userid>",1,3959,2487,"Mark Rutte (VVD)",0.994973611460166,0.992022337455126,0
"<anonymized_userid>",1,3960,2488,"Mark Rutte (VVD)",0.995224930887158,0.992421220582369,0
"<anonymized_userid>",1,3961,2489,"Mark Rutte (VVD)",0.995476250314149,0.992820103709613,0
"<anonymized_userid>",1,3962,2490,"Mark Rutte (VVD)",0.995727569741141,0.993218986836857,0
"<anonymized_userid>",1,3963,2491,"Mark Rutte (VVD)",0.995978889168133,0.993617869964101,0
"<anonymized_userid>",1,3964,2492,"Mark Rutte (VVD)",0.996230208595124,0.994016753091344,0
"<anonymized_userid>",1,3965,2493,"Mark Rutte (VVD)",0.996481528022116,0.994415636218588,0
"<anonymized_userid>",1,3966,2494,"Mark Rutte (VVD)",0.996732847449108,0.994814519345832,0
"<anonymized_userid>",1,3967,2495,"Mark Rutte (VVD)",0.996984166876099,0.995213402473075,0
"<anonymized_userid>",1,3968,2496,"Mark Rutte (VVD)",0.997235486303091,0.995612285600319,0
"<anonymized_userid>",1,3969,2497,"Mark Rutte (VVD)",0.997486805730083,0.996011168727563,0
"<anonymized_userid>",1,3970,2498,"Mark Rutte (VVD)",0.997738125157075,0.996410051854807,0
"<anonymized_userid>",1,3971,2499,"Mark Rutte (VVD)",0.997989444584066,0.99680893498205,0
"<anonymized_userid>",1,3972,2500,"Mark Rutte (VVD)",0.998240764011058,0.997207818109294,0
"<anonymized_userid>",1,3973,2501,"Mark Rutte (VVD)",0.99849208343805,0.997606701236538,0
"<anonymized_userid>",1,3974,2502,"Mark Rutte (VVD)",0.998743402865041,0.998005584363781,0
"<anonymized_userid>",1,3975,2503,"Mark Rutte (VVD)",0.998994722292033,0.998404467491025,0
"<anonymized_userid>",1,3976,2504,"Mark Rutte (VVD)",0.999246041719025,0.998803350618269,0
"<anonymized_userid>",1,3977,2505,"Mark Rutte (VVD)",0.999497361146017,0.999202233745513,0
"<anonymized_userid>",1,3978,2506,"Mark Rutte (VVD)",0.999748680573008,0.999601116872756,0
"<anonymized_userid>",1,3979,2507,"Mark Rutte (VVD)",1,1,0
"<anonymized_userid>",101,101,1,"Jesse Klaver (GL)",0.0192601067887109,0.000489955903968643,0
"<anonymized_userid>",67,168,2,"Jesse Klaver (GL)",0.0320366132723112,0.000979911807937286,0
"<anonymized_userid>",56,224,3,"Jesse Klaver (GL)",0.0427154843630816,0.00146986771190593,0
"<anonymized_userid>",46,270,4,"Jesse Klaver (GL)",0.051487414187643,0.00195982361587457,0
"<anonymized_userid>",43,313,5,"Jesse Klaver (GL)",0.0596872616323417,0.00244977951984321,0
"<anonymized_userid>",41,354,6,"Jesse Klaver (GL)",0.0675057208237986,0.00293973542381186,0
"<anonymized_userid>",40,394,7,"Jesse Klaver (GL)",0.0751334858886346,0.0034296913277805,0
"<anonymized_userid>",40,434,8,"Jesse Klaver (GL)",0.0827612509534706,0.00391964723174914,0
"<anonymized_userid>",36,470,9,"Jesse Klaver (GL)",0.089626239511823,0.00440960313571779,0
"<anonymized_userid>",34,504,10,"Jesse Klaver (GL)",0.0961098398169336,0.00489955903968643,0
"<anonymized_userid>",32,536,11,"Jesse Klaver (GL)",0.102212051868802,0.00538951494365507,0
"<anonymized_userid>",32,568,12,"Jesse Klaver (GL)",0.108314263920671,0.00587947084762371,0
"<anonymized_userid>",31,599,13,"Jesse Klaver (GL)",0.114225781845919,0.00636942675159236,0
"<anonymized_userid>",30,629,14,"Jesse Klaver (GL)",0.119946605644546,0.006859382655561,0
"<anonymized_userid>",29,658,15,"Jesse Klaver (GL)",0.125476735316552,0.00734933855952964,0
"<anonymized_userid>",28,686,16,"Jesse Klaver (GL)",0.130816170861937,0.00783929446349829,0
"<anonymized_userid>",28,714,17,"Jesse Klaver (GL)",0.136155606407323,0.00832925036746693,0
"<anonymized_userid>",27,741,18,"Jesse Klaver (GL)",0.141304347826087,0.00881920627143557,0
"<anonymized_userid>",27,768,19,"Jesse Klaver (GL)",0.146453089244851,0.00930916217540421,0
"<anonymized_userid>",27,795,20,"Jesse Klaver (GL)",0.151601830663616,0.00979911807937286,0
"<anonymized_userid>",27,822,21,"Jesse Klaver (GL)",0.15675057208238,0.0102890739833415,0
"<anonymized_userid>",27,849,22,"Jesse Klaver (GL)",0.161899313501144,0.0107790298873101,0
"<anonymized_userid>",26,875,23,"Jesse Klaver (GL)",0.166857360793288,0.0112689857912788,0
"<anonymized_userid>",26,901,24,"Jesse Klaver (GL)",0.171815408085431,0.0117589416952474,0
"<anonymized_userid>",24,925,25,"Jesse Klaver (GL)",0.176392067124333,0.0122488975992161,0
"<anonymized_userid>",24,949,26,"Jesse Klaver (GL)",0.180968726163234,0.0127388535031847,0
"<anonymized_userid>",21,970,27,"Jesse Klaver (GL)",0.184973302822273,0.0132288094071534,0
"<anonymized_userid>",21,991,28,"Jesse Klaver (GL)",0.188977879481312,0.013718765311122,0
"<anonymized_userid>",20,1011,29,"Jesse Klaver (GL)",0.19279176201373,0.0142087212150906,0
"<anonymized_userid>",20,1031,30,"Jesse Klaver (GL)",0.196605644546148,0.0146986771190593,0
"<anonymized_userid>",20,1051,31,"Jesse Klaver (GL)",0.200419527078566,0.0151886330230279,0
"<anonymized_userid>",19,1070,32,"Jesse Klaver (GL)",0.204042715484363,0.0156785889269966,0
"<anonymized_userid>",19,1089,33,"Jesse Klaver (GL)",0.20766590389016,0.0161685448309652,0
"<anonymized_userid>",19,1108,34,"Jesse Klaver (GL)",0.211289092295957,0.0166585007349339,0
"<anonymized_userid>",19,1127,35,"Jesse Klaver (GL)",0.214912280701754,0.0171484566389025,0
"<anonymized_userid>",19,1146,36,"Jesse Klaver (GL)",0.218535469107551,0.0176384125428711,0
"<anonymized_userid>",18,1164,37,"Jesse Klaver (GL)",0.221967963386728,0.0181283684468398,0
"<anonymized_userid>",18,1182,38,"Jesse Klaver (GL)",0.225400457665904,0.0186183243508084,0
"<anonymized_userid>",17,1199,39,"Jesse Klaver (GL)",0.228642257818459,0.0191082802547771,0
"<anonymized_userid>",17,1216,40,"Jesse Klaver (GL)",0.231884057971014,0.0195982361587457,0
"<anonymized_userid>",17,1233,41,"Jesse Klaver (GL)",0.23512585812357,0.0200881920627144,0
"<anonymized_userid>",16,1249,42,"Jesse Klaver (GL)",0.238176964149504,0.020578147966683,0
"<anonymized_userid>",16,1265,43,"Jesse Klaver (GL)",0.241228070175439,0.0210681038706516,0
"<anonymized_userid>",16,1281,44,"Jesse Klaver (GL)",0.244279176201373,0.0215580597746203,0
"<anonymized_userid>",15,1296,45,"Jesse Klaver (GL)",0.247139588100687,0.0220480156785889,0
"<anonymized_userid>",15,1311,46,"Jesse Klaver (GL)",0.25,0.0225379715825576,0
"<anonymized_userid>",15,1326,47,"Jesse Klaver (GL)",0.252860411899314,0.0230279274865262,0
"<anonymized_userid>",15,1341,48,"Jesse Klaver (GL)",0.255720823798627,0.0235178833904949,0
"<anonymized_userid>",15,1356,49,"Jesse Klaver (GL)",0.258581235697941,0.0240078392944635,0
"<anonymized_userid>",15,1371,50,"Jesse Klaver (GL)",0.261441647597254,0.0244977951984321,0
"<anonymized_userid>",15,1386,51,"Jesse Klaver (GL)",0.264302059496567,0.0249877511024008,0
"<anonymized_userid>",15,1401,52,"Jesse Klaver (GL)",0.267162471395881,0.0254777070063694,0
"<anonymized_userid>",14,1415,53,"Jesse Klaver (GL)",0.269832189168574,0.0259676629103381,0
"<anonymized_userid>",14,1429,54,"Jesse Klaver (GL)",0.272501906941266,0.0264576188143067,0
"<anonymized_userid>",14,1443,55,"Jesse Klaver (GL)",0.275171624713959,0.0269475747182754,0
"<anonymized_userid>",14,1457,56,"Jesse Klaver (GL)",0.277841342486651,0.027437530622244,0
"<anonymized_userid>",13,1470,57,"Jesse Klaver (GL)",0.280320366132723,0.0279274865262126,0
"<anonymized_userid>",13,1483,58,"Jesse Klaver (GL)",0.282799389778795,0.0284174424301813,0
"<anonymized_userid>",13,1496,59,"Jesse Klaver (GL)",0.285278413424867,0.0289073983341499,0
"<anonymized_userid>",13,1509,60,"Jesse Klaver (GL)",0.287757437070938,0.0293973542381186,0
"<anonymized_userid>",13,1522,61,"Jesse Klaver (GL)",0.29023646071701,0.0298873101420872,0
"<anonymized_userid>",13,1535,62,"Jesse Klaver (GL)",0.292715484363082,0.0303772660460559,0
"<anonymized_userid>",12,1547,63,"Jesse Klaver (GL)",0.295003813882532,0.0308672219500245,0
"<anonymized_userid>",12,1559,64,"Jesse Klaver (GL)",0.297292143401983,0.0313571778539931,0
"<anonymized_userid>",12,1571,65,"Jesse Klaver (GL)",0.299580472921434,0.0318471337579618,0
"<anonymized_userid>",12,1583,66,"Jesse Klaver (GL)",0.301868802440885,0.0323370896619304,0
"<anonymized_userid>",12,1595,67,"Jesse Klaver (GL)",0.304157131960336,0.0328270455658991,0
"<anonymized_userid>",12,1607,68,"Jesse Klaver (GL)",0.306445461479786,0.0333170014698677,0
"<anonymized_userid>",12,1619,69,"Jesse Klaver (GL)",0.308733790999237,0.0338069573738364,0
"<anonymized_userid>",12,1631,70,"Jesse Klaver (GL)",0.311022120518688,0.034296913277805,0
"<anonymized_userid>",12,1643,71,"Jesse Klaver (GL)",0.313310450038139,0.0347868691817736,0
"<anonymized_userid>",12,1655,72,"Jesse Klaver (GL)",0.31559877955759,0.0352768250857423,0
"<anonymized_userid>",12,1667,73,"Jesse Klaver (GL)",0.31788710907704,0.0357667809897109,0
"<anonymized_userid>",11,1678,74,"Jesse Klaver (GL)",0.31998474446987,0.0362567368936796,0
"<anonymized_userid>",11,1689,75,"Jesse Klaver (GL)",0.3220823798627,0.0367466927976482,0
"<anonymized_userid>",11,1700,76,"Jesse Klaver (GL)",0.32418001525553,0.0372366487016169,0
"<anonymized_userid>",11,1711,77,"Jesse Klaver (GL)",0.32627765064836,0.0377266046055855,0
"<anonymized_userid>",11,1722,78,"Jesse Klaver (GL)",0.32837528604119,0.0382165605095541,0
"<anonymized_userid>",11,1733,79,"Jesse Klaver (GL)",0.33047292143402,0.0387065164135228,0
"<anonymized_userid>",11,1744,80,"Jesse Klaver (GL)",0.33257055682685,0.0391964723174914,0
"<anonymized_userid>",11,1755,81,"Jesse Klaver (GL)",0.33466819221968,0.0396864282214601,0
"<anonymized_userid>",11,1766,82,"Jesse Klaver (GL)",0.33676582761251,0.0401763841254287,0
"<anonymized_userid>",11,1777,83,"Jesse Klaver (GL)",0.338863463005339,0.0406663400293974,0
"<anonymized_userid>",11,1788,84,"Jesse Klaver (GL)",0.340961098398169,0.041156295933366,0
"<anonymized_userid>",11,1799,85,"Jesse Klaver (GL)",0.343058733790999,0.0416462518373346,0
"<anonymized_userid>",11,1810,86,"Jesse Klaver (GL)",0.345156369183829,0.0421362077413033,0
"<anonymized_userid>",10,1820,87,"Jesse Klaver (GL)",0.347063310450038,0.0426261636452719,0
"<anonymized_userid>",10,1830,88,"Jesse Klaver (GL)",0.348970251716247,0.0431161195492406,0
"<anonymized_userid>",10,1840,89,"Jesse Klaver (GL)",0.350877192982456,0.0436060754532092,0
"<anonymized_userid>",10,1850,90,"Jesse Klaver (GL)",0.352784134248665,0.0440960313571779,0
"<anonymized_userid>",9,1859,91,"Jesse Klaver (GL)",0.354500381388253,0.0445859872611465,0
"<anonymized_userid>",9,1868,92,"Jesse Klaver (GL)",0.356216628527841,0.0450759431651151,0
"<anonymized_userid>",9,1877,93,"Jesse Klaver (GL)",0.357932875667429,0.0455658990690838,0
"<anonymized_userid>",9,1886,94,"Jesse Klaver (GL)",0.359649122807018,0.0460558549730524,0
"<anonymized_userid>",9,1895,95,"Jesse Klaver (GL)",0.361365369946606,0.0465458108770211,0
"<anonymized_userid>",9,1904,96,"Jesse Klaver (GL)",0.363081617086194,0.0470357667809897,0
"<anonymized_userid>",9,1913,97,"Jesse Klaver (GL)",0.364797864225782,0.0475257226849584,0
"<anonymized_userid>",9,1922,98,"Jesse Klaver (GL)",0.36651411136537,0.048015678588927,0
"<anonymized_userid>",9,1931,99,"Jesse Klaver (GL)",0.368230358504958,0.0485056344928956,0
"<anonymized_userid>",9,1940,100,"Jesse Klaver (GL)",0.369946605644546,0.0489955903968643,0
"<anonymized_userid>",9,1949,101,"Jesse Klaver (GL)",0.371662852784134,0.0494855463008329,0
"<anonymized_userid>",9,1958,102,"Jesse Klaver (GL)",0.373379099923722,0.0499755022048016,0
"<anonymized_userid>",9,1967,103,"Jesse Klaver (GL)",0.37509534706331,0.0504654581087702,0
"<anonymized_userid>",8,1975,104,"Jesse Klaver (GL)",0.376620900076278,0.0509554140127389,0
"<anonymized_userid>",8,1983,105,"Jesse Klaver (GL)",0.378146453089245,0.0514453699167075,0
"<anonymized_userid>",8,1991,106,"Jesse Klaver (GL)",0.379672006102212,0.0519353258206761,0
"<anonymized_userid>",8,1999,107,"Jesse Klaver (GL)",0.381197559115179,0.0524252817246448,0
"<anonymized_userid>",8,2007,108,"Jesse Klaver (GL)",0.382723112128146,0.0529152376286134,0
"<anonymized_userid>",8,2015,109,"Jesse Klaver (GL)",0.384248665141114,0.0534051935325821,0
"<anonymized_userid>",8,2023,110,"Jesse Klaver (GL)",0.385774218154081,0.0538951494365507,0
"<anonymized_userid>",8,2031,111,"Jesse Klaver (GL)",0.387299771167048,0.0543851053405194,0
"<anonymized_userid>",8,2039,112,"Jesse Klaver (GL)",0.388825324180015,0.054875061244488,0
"<anonymized_userid>",8,2047,113,"Jesse Klaver (GL)",0.390350877192982,0.0553650171484566,0
"<anonymized_userid>",8,2055,114,"Jesse Klaver (GL)",0.39187643020595,0.0558549730524253,0
"<anonymized_userid>",8,2063,115,"Jesse Klaver (GL)",0.393401983218917,0.0563449289563939,0
"<anonymized_userid>",8,2071,116,"Jesse Klaver (GL)",0.394927536231884,0.0568348848603626,0
"<anonymized_userid>",8,2079,117,"Jesse Klaver (GL)",0.396453089244851,0.0573248407643312,0
"<anonymized_userid>",8,2087,118,"Jesse Klaver (GL)",0.397978642257818,0.0578147966682999,0
"<anonymized_userid>",8,2095,119,"Jesse Klaver (GL)",0.399504195270786,0.0583047525722685,0
"<anonymized_userid>",8,2103,120,"Jesse Klaver (GL)",0.401029748283753,0.0587947084762371,0
"<anonymized_userid>",8,2111,121,"Jesse Klaver (GL)",0.40255530129672,0.0592846643802058,0
"<anonymized_userid>",8,2119,122,"Jesse Klaver (GL)",0.404080854309687,0.0597746202841744,0
"<anonymized_userid>",8,2127,123,"Jesse Klaver (GL)",0.405606407322654,0.0602645761881431,0
"<anonymized_userid>",8,2135,124,"Jesse Klaver (GL)",0.407131960335622,0.0607545320921117,0
"<anonymized_userid>",8,2143,125,"Jesse Klaver (GL)",0.408657513348589,0.0612444879960804,0
"<anonymized_userid>",7,2150,126,"Jesse Klaver (GL)",0.409992372234935,0.061734443900049,0
"<anonymized_userid>",7,2157,127,"Jesse Klaver (GL)",0.411327231121281,0.0622243998040176,0
"<anonymized_userid>",7,2164,128,"Jesse Klaver (GL)",0.412662090007628,0.0627143557079863,0
"<anonymized_userid>",7,2171,129,"Jesse Klaver (GL)",0.413996948893974,0.0632043116119549,0
"<anonymized_userid>",7,2178,130,"Jesse Klaver (GL)",0.41533180778032,0.0636942675159236,0
"<anonymized_userid>",7,2185,131,"Jesse Klaver (GL)",0.416666666666667,0.0641842234198922,0
"<anonymized_userid>",7,2192,132,"Jesse Klaver (GL)",0.418001525553013,0.0646741793238609,0
"<anonymized_userid>",7,2199,133,"Jesse Klaver (GL)",0.419336384439359,0.0651641352278295,0
"<anonymized_userid>",7,2206,134,"Jesse Klaver (GL)",0.420671243325706,0.0656540911317981,0
"<anonymized_userid>",7,2213,135,"Jesse Klaver (GL)",0.422006102212052,0.0661440470357668,0
"<anonymized_userid>",7,2220,136,"Jesse Klaver (GL)",0.423340961098398,0.0666340029397354,0
"<anonymized_userid>",7,2227,137,"Jesse Klaver (GL)",0.424675819984744,0.0671239588437041,0
"<anonymized_userid>",7,2234,138,"Jesse Klaver (GL)",0.426010678871091,0.0676139147476727,0
"<anonymized_userid>",7,2241,139,"Jesse Klaver (GL)",0.427345537757437,0.0681038706516413,0
"<anonymized_userid>",7,2248,140,"Jesse Klaver (GL)",0.428680396643783,0.06859382655561,0
"<anonymized_userid>",7,2255,141,"Jesse Klaver (GL)",0.43001525553013,0.0690837824595786,0
"<anonymized_userid>",7,2262,142,"Jesse Klaver (GL)",0.431350114416476,0.0695737383635473,0
"<anonymized_userid>",7,2269,143,"Jesse Klaver (GL)",0.432684973302822,0.0700636942675159,0
"<anonymized_userid>",7,2276,144,"Jesse Klaver (GL)",0.434019832189169,0.0705536501714846,0
"<anonymized_userid>",6,2282,145,"Jesse Klaver (GL)",0.435163996948894,0.0710436060754532,0
"<anonymized_userid>",6,2288,146,"Jesse Klaver (GL)",0.436308161708619,0.0715335619794219,0
"<anonymized_userid>",6,2294,147,"Jesse Klaver (GL)",0.437452326468345,0.0720235178833905,0
"<anonymized_userid>",6,2300,148,"Jesse Klaver (GL)",0.43859649122807,0.0725134737873591,0
"<anonymized_userid>",6,2306,149,"Jesse Klaver (GL)",0.439740655987796,0.0730034296913278,0
"<anonymized_userid>",6,2312,150,"Jesse Klaver (GL)",0.440884820747521,0.0734933855952964,0
"<anonymized_userid>",6,2318,151,"Jesse Klaver (GL)",0.442028985507246,0.0739833414992651,0
"<anonymized_userid>",6,2324,152,"Jesse Klaver (GL)",0.443173150266972,0.0744732974032337,0
"<anonymized_userid>",6,2330,153,"Jesse Klaver (GL)",0.444317315026697,0.0749632533072024,0
"<anonymized_userid>",6,2336,154,"Jesse Klaver (GL)",0.445461479786423,0.075453209211171,0
"<anonymized_userid>",6,2342,155,"Jesse Klaver (GL)",0.446605644546148,0.0759431651151396,0
"<anonymized_userid>",6,2348,156,"Jesse Klaver (GL)",0.447749809305873,0.0764331210191083,0
"<anonymized_userid>",6,2354,157,"Jesse Klaver (GL)",0.448893974065599,0.0769230769230769,0
"<anonymized_userid>",6,2360,158,"Jesse Klaver (GL)",0.450038138825324,0.0774130328270456,0
"<anonymized_userid>",6,2366,159,"Jesse Klaver (GL)",0.45118230358505,0.0779029887310142,0
"<anonymized_userid>",6,2372,160,"Jesse Klaver (GL)",0.452326468344775,0.0783929446349829,0
"<anonymized_userid>",6,2378,161,"Jesse Klaver (GL)",0.4534706331045,0.0788829005389515,0
"<anonymized_userid>",6,2384,162,"Jesse Klaver (GL)",0.454614797864226,0.0793728564429201,0
"<anonymized_userid>",6,2390,163,"Jesse Klaver (GL)",0.455758962623951,0.0798628123468888,0
"<anonymized_userid>",6,2396,164,"Jesse Klaver (GL)",0.456903127383677,0.0803527682508574,0
"<anonymized_userid>",6,2402,165,"Jesse Klaver (GL)",0.458047292143402,0.0808427241548261,0
"<anonymized_userid>",6,2408,166,"Jesse Klaver (GL)",0.459191456903127,0.0813326800587947,0
"<anonymized_userid>",6,2414,167,"Jesse Klaver (GL)",0.460335621662853,0.0818226359627633,0
"<anonymized_userid>",6,2420,168,"Jesse Klaver (GL)",0.461479786422578,0.082312591866732,0
"<anonymized_userid>",6,2426,169,"Jesse Klaver (GL)",0.462623951182304,0.0828025477707006,0
"<anonymized_userid>",6,2432,170,"Jesse Klaver (GL)",0.463768115942029,0.0832925036746693,0
"<anonymized_userid>",6,2438,171,"Jesse Klaver (GL)",0.464912280701754,0.0837824595786379,0
"<anonymized_userid>",6,2444,172,"Jesse Klaver (GL)",0.46605644546148,0.0842724154826066,0
"<anonymized_userid>",6,2450,173,"Jesse Klaver (GL)",0.467200610221205,0.0847623713865752,0
"<anonymized_userid>",6,2456,174,"Jesse Klaver (GL)",0.468344774980931,0.0852523272905439,0
"<anonymized_userid>",6,2462,175,"Jesse Klaver (GL)",0.469488939740656,0.0857422831945125,0
"<anonymized_userid>",6,2468,176,"Jesse Klaver (GL)",0.470633104500381,0.0862322390984811,0
"<anonymized_userid>",6,2474,177,"Jesse Klaver (GL)",0.471777269260107,0.0867221950024498,0
"<anonymized_userid>",5,2479,178,"Jesse Klaver (GL)",0.472730739893211,0.0872121509064184,0
"<anonymized_userid>",5,2484,179,"Jesse Klaver (GL)",0.473684210526316,0.0877021068103871,0
"<anonymized_userid>",5,2489,180,"Jesse Klaver (GL)",0.47463768115942,0.0881920627143557,0
"<anonymized_userid>",5,2494,181,"Jesse Klaver (GL)",0.475591151792525,0.0886820186183244,0
"<anonymized_userid>",5,2499,182,"Jesse Klaver (GL)",0.476544622425629,0.089171974522293,0
"<anonymized_userid>",5,2504,183,"Jesse Klaver (GL)",0.477498093058734,0.0896619304262616,0
"<anonymized_userid>",5,2509,184,"Jesse Klaver (GL)",0.478451563691838,0.0901518863302303,0
"<anonymized_userid>",5,2514,185,"Jesse Klaver (GL)",0.479405034324943,0.0906418422341989,0
"<anonymized_userid>",5,2519,186,"Jesse Klaver (GL)",0.480358504958047,0.0911317981381676,0
"<anonymized_userid>",5,2524,187,"Jesse Klaver (GL)",0.481311975591152,0.0916217540421362,0
"<anonymized_userid>",5,2529,188,"Jesse Klaver (GL)",0.482265446224256,0.0921117099461048,0
"<anonymized_userid>",5,2534,189,"Jesse Klaver (GL)",0.483218916857361,0.0926016658500735,0
"<anonymized_userid>",5,2539,190,"Jesse Klaver (GL)",0.484172387490465,0.0930916217540421,0
"<anonymized_userid>",5,2544,191,"Jesse Klaver (GL)",0.48512585812357,0.0935815776580108,0
"<anonymized_userid>",5,2549,192,"Jesse Klaver (GL)",0.486079328756674,0.0940715335619794,0
"<anonymized_userid>",5,2554,193,"Jesse Klaver (GL)",0.487032799389779,0.0945614894659481,0
"<anonymized_userid>",5,2559,194,"Jesse Klaver (GL)",0.487986270022883,0.0950514453699167,0
"<anonymized_userid>",5,2564,195,"Jesse Klaver (GL)",0.488939740655988,0.0955414012738854,0
"<anonymized_userid>",5,2569,196,"Jesse Klaver (GL)",0.489893211289092,0.096031357177854,0
"<anonymized_userid>",5,2574,197,"Jesse Klaver (GL)",0.490846681922197,0.0965213130818226,0
"<anonymized_userid>",5,2579,198,"Jesse Klaver (GL)",0.491800152555301,0.0970112689857913,0
"<anonymized_userid>",5,2584,199,"Jesse Klaver (GL)",0.492753623188406,0.0975012248897599,0
"<anonymized_userid>",5,2589,200,"Jesse Klaver (GL)",0.49370709382151,0.0979911807937286,0
"<anonymized_userid>",5,2594,201,"Jesse Klaver (GL)",0.494660564454615,0.0984811366976972,0
"<anonymized_userid>",5,2599,202,"Jesse Klaver (GL)",0.495614035087719,0.0989710926016659,0
"<anonymized_userid>",5,2604,203,"Jesse Klaver (GL)",0.496567505720824,0.0994610485056345,0
"<anonymized_userid>",5,2609,204,"Jesse Klaver (GL)",0.497520976353928,0.0999510044096031,0
"<anonymized_userid>",5,2614,205,"Jesse Klaver (GL)",0.498474446987033,0.100440960313572,0
"<anonymized_userid>",5,2619,206,"Jesse Klaver (GL)",0.499427917620137,0.10093091621754,0
"<anonymized_userid>",5,2624,207,"Jesse Klaver (GL)",0.500381388253242,0.101420872121509,0
"<anonymized_userid>",5,2629,208,"Jesse Klaver (GL)",0.501334858886346,0.101910828025478,0
"<anonymized_userid>",5,2634,209,"Jesse Klaver (GL)",0.502288329519451,0.102400783929446,0
"<anonymized_userid>",5,2639,210,"Jesse Klaver (GL)",0.503241800152555,0.102890739833415,0
"<anonymized_userid>",5,2644,211,"Jesse Klaver (GL)",0.50419527078566,0.103380695737384,0
"<anonymized_userid>",5,2649,212,"Jesse Klaver (GL)",0.505148741418764,0.103870651641352,0
"<anonymized_userid>",5,2654,213,"Jesse Klaver (GL)",0.506102212051869,0.104360607545321,0
"<anonymized_userid>",5,2659,214,"Jesse Klaver (GL)",0.507055682684973,0.10485056344929,0
"<anonymized_userid>",5,2664,215,"Jesse Klaver (GL)",0.508009153318078,0.105340519353258,0
"<anonymized_userid>",5,2669,216,"Jesse Klaver (GL)",0.508962623951182,0.105830475257227,0
"<anonymized_userid>",5,2674,217,"Jesse Klaver (GL)",0.509916094584287,0.106320431161195,0
"<anonymized_userid>",5,2679,218,"Jesse Klaver (GL)",0.510869565217391,0.106810387065164,0
"<anonymized_userid>",5,2684,219,"Jesse Klaver (GL)",0.511823035850496,0.107300342969133,0
"<anonymized_userid>",5,2689,220,"Jesse Klaver (GL)",0.5127765064836,0.107790298873101,0
"<anonymized_userid>",5,2694,221,"Jesse Klaver (GL)",0.513729977116705,0.10828025477707,0
"<anonymized_userid>",4,2698,222,"Jesse Klaver (GL)",0.514492753623188,0.108770210681039,0
"<anonymized_userid>",4,2702,223,"Jesse Klaver (GL)",0.515255530129672,0.109260166585007,0
"<anonymized_userid>",4,2706,224,"Jesse Klaver (GL)",0.516018306636156,0.109750122488976,0
"<anonymized_userid>",4,2710,225,"Jesse Klaver (GL)",0.516781083142639,0.110240078392945,0
"<anonymized_userid>",4,2714,226,"Jesse Klaver (GL)",0.517543859649123,0.110730034296913,0
"<anonymized_userid>",4,2718,227,"Jesse Klaver (GL)",0.518306636155606,0.111219990200882,0
"<anonymized_userid>",4,2722,228,"Jesse Klaver (GL)",0.51906941266209,0.111709946104851,0
"<anonymized_userid>",4,2726,229,"Jesse Klaver (GL)",0.519832189168574,0.112199902008819,0
"<anonymized_userid>",4,2730,230,"Jesse Klaver (GL)",0.520594965675057,0.112689857912788,0
"<anonymized_userid>",4,2734,231,"Jesse Klaver (GL)",0.521357742181541,0.113179813816756,0
"<anonymized_userid>",4,2738,232,"Jesse Klaver (GL)",0.522120518688024,0.113669769720725,0
"<anonymized_userid>",4,2742,233,"Jesse Klaver (GL)",0.522883295194508,0.114159725624694,0
"<anonymized_userid>",4,2746,234,"Jesse Klaver (GL)",0.523646071700992,0.114649681528662,0
"<anonymized_userid>",4,2750,235,"Jesse Klaver (GL)",0.524408848207475,0.115139637432631,0
"<anonymized_userid>",4,2754,236,"Jesse Klaver (GL)",0.525171624713959,0.1156295933366,0
"<anonymized_userid>",4,2758,237,"Jesse Klaver (GL)",0.525934401220442,0.116119549240568,0
"<anonymized_userid>",4,2762,238,"Jesse Klaver (GL)",0.526697177726926,0.116609505144537,0
"<anonymized_userid>",4,2766,239,"Jesse Klaver (GL)",0.52745995423341,0.117099461048506,0
"<anonymized_userid>",4,2770,240,"Jesse Klaver (GL)",0.528222730739893,0.117589416952474,0
"<anonymized_userid>",4,2774,241,"Jesse Klaver (GL)",0.528985507246377,0.118079372856443,0
"<anonymized_userid>",4,2778,242,"Jesse Klaver (GL)",0.52974828375286,0.118569328760412,0
"<anonymized_userid>",4,2782,243,"Jesse Klaver (GL)",0.530511060259344,0.11905928466438,0
"<anonymized_userid>",4,2786,244,"Jesse Klaver (GL)",0.531273836765828,0.119549240568349,0
"<anonymized_userid>",4,2790,245,"Jesse Klaver (GL)",0.532036613272311,0.120039196472317,0
"<anonymized_userid>",4,2794,246,"Jesse Klaver (GL)",0.532799389778795,0.120529152376286,0
"<anonymized_userid>",4,2798,247,"Jesse Klaver (GL)",0.533562166285278,0.121019108280255,0
"<anonymized_userid>",4,2802,248,"Jesse Klaver (GL)",0.534324942791762,0.121509064184223,0
"<anonymized_userid>",4,2806,249,"Jesse Klaver (GL)",0.535087719298246,0.121999020088192,0
"<anonymized_userid>",4,2810,250,"Jesse Klaver (GL)",0.535850495804729,0.122488975992161,0
"<anonymized_userid>",4,2814,251,"Jesse Klaver (GL)",0.536613272311213,0.122978931896129,0
"<anonymized_userid>",4,2818,252,"Jesse Klaver (GL)",0.537376048817696,0.123468887800098,0
"<anonymized_userid>",4,2822,253,"Jesse Klaver (GL)",0.53813882532418,0.123958843704067,0
"<anonymized_userid>",4,2826,254,"Jesse Klaver (GL)",0.538901601830664,0.124448799608035,0
"<anonymized_userid>",4,2830,255,"Jesse Klaver (GL)",0.539664378337147,0.124938755512004,0
"<anonymized_userid>",4,2834,256,"Jesse Klaver (GL)",0.540427154843631,0.125428711415973,0
"<anonymized_userid>",4,2838,257,"Jesse Klaver (GL)",0.541189931350114,0.125918667319941,0
"<anonymized_userid>",4,2842,258,"Jesse Klaver (GL)",0.541952707856598,0.12640862322391,0
"<anonymized_userid>",4,2846,259,"Jesse Klaver (GL)",0.542715484363082,0.126898579127878,0
"<anonymized_userid>",4,2850,260,"Jesse Klaver (GL)",0.543478260869565,0.127388535031847,0
"<anonymized_userid>",4,2854,261,"Jesse Klaver (GL)",0.544241037376049,0.127878490935816,0
"<anonymized_userid>",4,2858,262,"Jesse Klaver (GL)",0.545003813882532,0.128368446839784,0
"<anonymized_userid>",4,2862,263,"Jesse Klaver (GL)",0.545766590389016,0.128858402743753,0
"<anonymized_userid>",4,2866,264,"Jesse Klaver (GL)",0.5465293668955,0.129348358647722,0
"<anonymized_userid>",4,2870,265,"Jesse Klaver (GL)",0.547292143401983,0.12983831455169,0
"<anonymized_userid>",4,2874,266,"Jesse Klaver (GL)",0.548054919908467,0.130328270455659,0
"<anonymized_userid>",4,2878,267,"Jesse Klaver (GL)",0.54881769641495,0.130818226359628,0
"<anonymized_userid>",4,2882,268,"Jesse Klaver (GL)",0.549580472921434,0.131308182263596,0
"<anonymized_userid>",4,2886,269,"Jesse Klaver (GL)",0.550343249427918,0.131798138167565,0
"<anonymized_userid>",4,2890,270,"Jesse Klaver (GL)",0.551106025934401,0.132288094071534,0
"<anonymized_userid>",4,2894,271,"Jesse Klaver (GL)",0.551868802440885,0.132778049975502,0
"<anonymized_userid>",4,2898,272,"Jesse Klaver (GL)",0.552631578947368,0.133268005879471,0
"<anonymized_userid>",4,2902,273,"Jesse Klaver (GL)",0.553394355453852,0.133757961783439,0
"<anonymized_userid>",4,2906,274,"Jesse Klaver (GL)",0.554157131960336,0.134247917687408,0
"<anonymized_userid>",4,2910,275,"Jesse Klaver (GL)",0.554919908466819,0.134737873591377,0
"<anonymized_userid>",4,2914,276,"Jesse Klaver (GL)",0.555682684973303,0.135227829495345,0
"<anonymized_userid>",4,2918,277,"Jesse Klaver (GL)",0.556445461479786,0.135717785399314,0
"<anonymized_userid>",4,2922,278,"Jesse Klaver (GL)",0.55720823798627,0.136207741303283,0
"<anonymized_userid>",4,2926,279,"Jesse Klaver (GL)",0.557971014492754,0.136697697207251,0
"<anonymized_userid>",4,2930,280,"Jesse Klaver (GL)",0.558733790999237,0.13718765311122,0
"<anonymized_userid>",4,2934,281,"Jesse Klaver (GL)",0.559496567505721,0.137677609015189,0
"<anonymized_userid>",4,2938,282,"Jesse Klaver (GL)",0.560259344012204,0.138167564919157,0
"<anonymized_userid>",4,2942,283,"Jesse Klaver (GL)",0.561022120518688,0.138657520823126,0
"<anonymized_userid>",4,2946,284,"Jesse Klaver (GL)",0.561784897025172,0.139147476727095,0
"<anonymized_userid>",4,2950,285,"Jesse Klaver (GL)",0.562547673531655,0.139637432631063,0
"<anonymized_userid>",4,2954,286,"Jesse Klaver (GL)",0.563310450038139,0.140127388535032,0
"<anonymized_userid>",4,2958,287,"Jesse Klaver (GL)",0.564073226544622,0.140617344439,0
"<anonymized_userid>",4,2962,288,"Jesse Klaver (GL)",0.564836003051106,0.141107300342969,0
"<anonymized_userid>",4,2966,289,"Jesse Klaver (GL)",0.56559877955759,0.141597256246938,0
"<anonymized_userid>",4,2970,290,"Jesse Klaver (GL)",0.566361556064073,0.142087212150906,0
"<anonymized_userid>",4,2974,291,"Jesse Klaver (GL)",0.567124332570557,0.142577168054875,0
"<anonymized_userid>",4,2978,292,"Jesse Klaver (GL)",0.56788710907704,0.143067123958844,0
"<anonymized_userid>",3,2981,293,"Jesse Klaver (GL)",0.568459191456903,0.143557079862812,0
"<anonymized_userid>",3,2984,294,"Jesse Klaver (GL)",0.569031273836766,0.144047035766781,0
"<anonymized_userid>",3,2987,295,"Jesse Klaver (GL)",0.569603356216628,0.14453699167075,0
"<anonymized_userid>",3,2990,296,"Jesse Klaver (GL)",0.570175438596491,0.145026947574718,0
"<anonymized_userid>",3,2993,297,"Jesse Klaver (GL)",0.570747520976354,0.145516903478687,0
"<anonymized_userid>",3,2996,298,"Jesse Klaver (GL)",0.571319603356217,0.146006859382656,0
"<anonymized_userid>",3,2999,299,"Jesse Klaver (GL)",0.571891685736079,0.146496815286624,0
"<anonymized_userid>",3,3002,300,"Jesse Klaver (GL)",0.572463768115942,0.146986771190593,0
"<anonymized_userid>",3,3005,301,"Jesse Klaver (GL)",0.573035850495805,0.147476727094561,0
"<anonymized_userid>",3,3008,302,"Jesse Klaver (GL)",0.573607932875667,0.14796668299853,0
"<anonymized_userid>",3,3011,303,"Jesse Klaver (GL)",0.57418001525553,0.148456638902499,0
"<anonymized_userid>",3,3014,304,"Jesse Klaver (GL)",0.574752097635393,0.148946594806467,0
"<anonymized_userid>",3,3017,305,"Jesse Klaver (GL)",0.575324180015256,0.149436550710436,0
"<anonymized_userid>",3,3020,306,"Jesse Klaver (GL)",0.575896262395118,0.149926506614405,0
"<anonymized_userid>",3,3023,307,"Jesse Klaver (GL)",0.576468344774981,0.150416462518373,0
"<anonymized_userid>",3,3026,308,"Jesse Klaver (GL)",0.577040427154844,0.150906418422342,0
"<anonymized_userid>",3,3029,309,"Jesse Klaver (GL)",0.577612509534706,0.151396374326311,0
"<anonymized_userid>",3,3032,310,"Jesse Klaver (GL)",0.578184591914569,0.151886330230279,0
"<anonymized_userid>",3,3035,311,"Jesse Klaver (GL)",0.578756674294432,0.152376286134248,0
"<anonymized_userid>",3,3038,312,"Jesse Klaver (GL)",0.579328756674294,0.152866242038217,0
"<anonymized_userid>",3,3041,313,"Jesse Klaver (GL)",0.579900839054157,0.153356197942185,0
"<anonymized_userid>",3,3044,314,"Jesse Klaver (GL)",0.58047292143402,0.153846153846154,0
"<anonymized_userid>",3,3047,315,"Jesse Klaver (GL)",0.581045003813883,0.154336109750122,0
"<anonymized_userid>",3,3050,316,"Jesse Klaver (GL)",0.581617086193745,0.154826065654091,0
"<anonymized_userid>",3,3053,317,"Jesse Klaver (GL)",0.582189168573608,0.15531602155806,0
"<anonymized_userid>",3,3056,318,"Jesse Klaver (GL)",0.582761250953471,0.155805977462028,0
"<anonymized_userid>",3,3059,319,"Jesse Klaver (GL)",0.583333333333333,0.156295933365997,0
"<anonymized_userid>",3,3062,320,"Jesse Klaver (GL)",0.583905415713196,0.156785889269966,0
"<anonymized_userid>",3,3065,321,"Jesse Klaver (GL)",0.584477498093059,0.157275845173934,0
"<anonymized_userid>",3,3068,322,"Jesse Klaver (GL)",0.585049580472921,0.157765801077903,0
"<anonymized_userid>",3,3071,323,"Jesse Klaver (GL)",0.585621662852784,0.158255756981872,0
"<anonymized_userid>",3,3074,324,"Jesse Klaver (GL)",0.586193745232647,0.15874571288584,0
"<anonymized_userid>",3,3077,325,"Jesse Klaver (GL)",0.58676582761251,0.159235668789809,0
"<anonymized_userid>",3,3080,326,"Jesse Klaver (GL)",0.587337909992372,0.159725624693778,0
"<anonymized_userid>",3,3083,327,"Jesse Klaver (GL)",0.587909992372235,0.160215580597746,0
"<anonymized_userid>",3,3086,328,"Jesse Klaver (GL)",0.588482074752098,0.160705536501715,0
"<anonymized_userid>",3,3089,329,"Jesse Klaver (GL)",0.58905415713196,0.161195492405683,0
"<anonymized_userid>",3,3092,330,"Jesse Klaver (GL)",0.589626239511823,0.161685448309652,0
"<anonymized_userid>",3,3095,331,"Jesse Klaver (GL)",0.590198321891686,0.162175404213621,0
"<anonymized_userid>",3,3098,332,"Jesse Klaver (GL)",0.590770404271548,0.162665360117589,0
"<anonymized_userid>",3,3101,333,"Jesse Klaver (GL)",0.591342486651411,0.163155316021558,0
"<anonymized_userid>",3,3104,334,"Jesse Klaver (GL)",0.591914569031274,0.163645271925527,0
"<anonymized_userid>",3,3107,335,"Jesse Klaver (GL)",0.592486651411137,0.164135227829495,0
"<anonymized_userid>",3,3110,336,"Jesse Klaver (GL)",0.593058733790999,0.164625183733464,0
"<anonymized_userid>",3,3113,337,"Jesse Klaver (GL)",0.593630816170862,0.165115139637433,0
"<anonymized_userid>",3,3116,338,"Jesse Klaver (GL)",0.594202898550725,0.165605095541401,0
"<anonymized_userid>",3,3119,339,"Jesse Klaver (GL)",0.594774980930587,0.16609505144537,0
"<anonymized_userid>",3,3122,340,"Jesse Klaver (GL)",0.59534706331045,0.166585007349339,0
"<anonymized_userid>",3,3125,341,"Jesse Klaver (GL)",0.595919145690313,0.167074963253307,0
"<anonymized_userid>",3,3128,342,"Jesse Klaver (GL)",0.596491228070175,0.167564919157276,0
"<anonymized_userid>",3,3131,343,"Jesse Klaver (GL)",0.597063310450038,0.168054875061244,0
"<anonymized_userid>",3,3134,344,"Jesse Klaver (GL)",0.597635392829901,0.168544830965213,0
"<anonymized_userid>",3,3137,345,"Jesse Klaver (GL)",0.598207475209764,0.169034786869182,0
"<anonymized_userid>",3,3140,346,"Jesse Klaver (GL)",0.598779557589626,0.16952474277315,0
"<anonymized_userid>",3,3143,347,"Jesse Klaver (GL)",0.599351639969489,0.170014698677119,0
"<anonymized_userid>",3,3146,348,"Jesse Klaver (GL)",0.599923722349352,0.170504654581088,0
"<anonymized_userid>",3,3149,349,"Jesse Klaver (GL)",0.600495804729214,0.170994610485056,0
"<anonymized_userid>",3,3152,350,"Jesse Klaver (GL)",0.601067887109077,0.171484566389025,0
"<anonymized_userid>",3,3155,351,"Jesse Klaver (GL)",0.60163996948894,0.171974522292994,0
"<anonymized_userid>",3,3158,352,"Jesse Klaver (GL)",0.602212051868802,0.172464478196962,0
"<anonymized_userid>",3,3161,353,"Jesse Klaver (GL)",0.602784134248665,0.172954434100931,0
"<anonymized_userid>",3,3164,354,"Jesse Klaver (GL)",0.603356216628528,0.1734443900049,0
"<anonymized_userid>",3,3167,355,"Jesse Klaver (GL)",0.603928299008391,0.173934345908868,0
"<anonymized_userid>",3,3170,356,"Jesse Klaver (GL)",0.604500381388253,0.174424301812837,0
"<anonymized_userid>",3,3173,357,"Jesse Klaver (GL)",0.605072463768116,0.174914257716805,0
"<anonymized_userid>",3,3176,358,"Jesse Klaver (GL)",0.605644546147979,0.175404213620774,0
"<anonymized_userid>",3,3179,359,"Jesse Klaver (GL)",0.606216628527841,0.175894169524743,0
"<anonymized_userid>",3,3182,360,"Jesse Klaver (GL)",0.606788710907704,0.176384125428711,0
"<anonymized_userid>",3,3185,361,"Jesse Klaver (GL)",0.607360793287567,0.17687408133268,0
"<anonymized_userid>",3,3188,362,"Jesse Klaver (GL)",0.607932875667429,0.177364037236649,0
"<anonymized_userid>",3,3191,363,"Jesse Klaver (GL)",0.608504958047292,0.177853993140617,0
"<anonymized_userid>",3,3194,364,"Jesse Klaver (GL)",0.609077040427155,0.178343949044586,0
"<anonymized_userid>",3,3197,365,"Jesse Klaver (GL)",0.609649122807018,0.178833904948555,0
"<anonymized_userid>",3,3200,366,"Jesse Klaver (GL)",0.61022120518688,0.179323860852523,0
"<anonymized_userid>",3,3203,367,"Jesse Klaver (GL)",0.610793287566743,0.179813816756492,0
"<anonymized_userid>",3,3206,368,"Jesse Klaver (GL)",0.611365369946606,0.180303772660461,0
"<anonymized_userid>",3,3209,369,"Jesse Klaver (GL)",0.611937452326468,0.180793728564429,0
"<anonymized_userid>",3,3212,370,"Jesse Klaver (GL)",0.612509534706331,0.181283684468398,0
"<anonymized_userid>",3,3215,371,"Jesse Klaver (GL)",0.613081617086194,0.181773640372366,0
"<anonymized_userid>",3,3218,372,"Jesse Klaver (GL)",0.613653699466056,0.182263596276335,0
"<anonymized_userid>",3,3221,373,"Jesse Klaver (GL)",0.614225781845919,0.182753552180304,0
"<anonymized_userid>",3,3224,374,"Jesse Klaver (GL)",0.614797864225782,0.183243508084272,0
"<anonymized_userid>",3,3227,375,"Jesse Klaver (GL)",0.615369946605645,0.183733463988241,0
"<anonymized_userid>",3,3230,376,"Jesse Klaver (GL)",0.615942028985507,0.18422341989221,0
"<anonymized_userid>",3,3233,377,"Jesse Klaver (GL)",0.61651411136537,0.184713375796178,0
"<anonymized_userid>",3,3236,378,"Jesse Klaver (GL)",0.617086193745233,0.185203331700147,0
"<anonymized_userid>",3,3239,379,"Jesse Klaver (GL)",0.617658276125095,0.185693287604116,0
"<anonymized_userid>",3,3242,380,"Jesse Klaver (GL)",0.618230358504958,0.186183243508084,0
"<anonymized_userid>",3,3245,381,"Jesse Klaver (GL)",0.618802440884821,0.186673199412053,0
"<anonymized_userid>",3,3248,382,"Jesse Klaver (GL)",0.619374523264683,0.187163155316022,0
"<anonymized_userid>",3,3251,383,"Jesse Klaver (GL)",0.619946605644546,0.18765311121999,0
"<anonymized_userid>",3,3254,384,"Jesse Klaver (GL)",0.620518688024409,0.188143067123959,0
"<anonymized_userid>",3,3257,385,"Jesse Klaver (GL)",0.621090770404272,0.188633023027927,0
"<anonymized_userid>",3,3260,386,"Jesse Klaver (GL)",0.621662852784134,0.189122978931896,0
"<anonymized_userid>",3,3263,387,"Jesse Klaver (GL)",0.622234935163997,0.189612934835865,0
"<anonymized_userid>",3,3266,388,"Jesse Klaver (GL)",0.62280701754386,0.190102890739833,0
"<anonymized_userid>",3,3269,389,"Jesse Klaver (GL)",0.623379099923722,0.190592846643802,0
"<anonymized_userid>",3,3272,390,"Jesse Klaver (GL)",0.623951182303585,0.191082802547771,0
"<anonymized_userid>",3,3275,391,"Jesse Klaver (GL)",0.624523264683448,0.191572758451739,0
"<anonymized_userid>",3,3278,392,"Jesse Klaver (GL)",0.62509534706331,0.192062714355708,0
"<anonymized_userid>",3,3281,393,"Jesse Klaver (GL)",0.625667429443173,0.192552670259677,0
"<anonymized_userid>",3,3284,394,"Jesse Klaver (GL)",0.626239511823036,0.193042626163645,0
"<anonymized_userid>",3,3287,395,"Jesse Klaver (GL)",0.626811594202899,0.193532582067614,0
"<anonymized_userid>",3,3290,396,"Jesse Klaver (GL)",0.627383676582761,0.194022537971583,0
"<anonymized_userid>",3,3293,397,"Jesse Klaver (GL)",0.627955758962624,0.194512493875551,0
"<anonymized_userid>",3,3296,398,"Jesse Klaver (GL)",0.628527841342487,0.19500244977952,0
"<anonymized_userid>",3,3299,399,"Jesse Klaver (GL)",0.629099923722349,0.195492405683488,0
"<anonymized_userid>",3,3302,400,"Jesse Klaver (GL)",0.629672006102212,0.195982361587457,0
"<anonymized_userid>",3,3305,401,"Jesse Klaver (GL)",0.630244088482075,0.196472317491426,0
"<anonymized_userid>",3,3308,402,"Jesse Klaver (GL)",0.630816170861937,0.196962273395394,0
"<anonymized_userid>",3,3311,403,"Jesse Klaver (GL)",0.6313882532418,0.197452229299363,0
"<anonymized_userid>",3,3314,404,"Jesse Klaver (GL)",0.631960335621663,0.197942185203332,0
"<anonymized_userid>",3,3317,405,"Jesse Klaver (GL)",0.632532418001526,0.1984321411073,0
"<anonymized_userid>",3,3320,406,"Jesse Klaver (GL)",0.633104500381388,0.198922097011269,0
"<anonymized_userid>",3,3323,407,"Jesse Klaver (GL)",0.633676582761251,0.199412052915238,0
"<anonymized_userid>",3,3326,408,"Jesse Klaver (GL)",0.634248665141114,0.199902008819206,0
"<anonymized_userid>",2,3328,409,"Jesse Klaver (GL)",0.634630053394355,0.200391964723175,0
"<anonymized_userid>",2,3330,410,"Jesse Klaver (GL)",0.635011441647597,0.200881920627144,0
"<anonymized_userid>",2,3332,411,"Jesse Klaver (GL)",0.635392829900839,0.201371876531112,0
"<anonymized_userid>",2,3334,412,"Jesse Klaver (GL)",0.635774218154081,0.201861832435081,0
"<anonymized_userid>",2,3336,413,"Jesse Klaver (GL)",0.636155606407323,0.202351788339049,0
"<anonymized_userid>",2,3338,414,"Jesse Klaver (GL)",0.636536994660564,0.202841744243018,0
"<anonymized_userid>",2,3340,415,"Jesse Klaver (GL)",0.636918382913806,0.203331700146987,0
"<anonymized_userid>",2,3342,416,"Jesse Klaver (GL)",0.637299771167048,0.203821656050955,0
"<anonymized_userid>",2,3344,417,"Jesse Klaver (GL)",0.63768115942029,0.204311611954924,0
"<anonymized_userid>",2,3346,418,"Jesse Klaver (GL)",0.638062547673532,0.204801567858893,0
"<anonymized_userid>",2,3348,419,"Jesse Klaver (GL)",0.638443935926774,0.205291523762861,0
"<anonymized_userid>",2,3350,420,"Jesse Klaver (GL)",0.638825324180015,0.20578147966683,0
"<anonymized_userid>",2,3352,421,"Jesse Klaver (GL)",0.639206712433257,0.206271435570799,0
"<anonymized_userid>",2,3354,422,"Jesse Klaver (GL)",0.639588100686499,0.206761391474767,0
"<anonymized_userid>",2,3356,423,"Jesse Klaver (GL)",0.639969488939741,0.207251347378736,0
"<anonymized_userid>",2,3358,424,"Jesse Klaver (GL)",0.640350877192982,0.207741303282705,0
"<anonymized_userid>",2,3360,425,"Jesse Klaver (GL)",0.640732265446224,0.208231259186673,0
"<anonymized_userid>",2,3362,426,"Jesse Klaver (GL)",0.641113653699466,0.208721215090642,0
"<anonymized_userid>",2,3364,427,"Jesse Klaver (GL)",0.641495041952708,0.20921117099461,0
"<anonymized_userid>",2,3366,428,"Jesse Klaver (GL)",0.64187643020595,0.209701126898579,0
"<anonymized_userid>",2,3368,429,"Jesse Klaver (GL)",0.642257818459191,0.210191082802548,0
"<anonymized_userid>",2,3370,430,"Jesse Klaver (GL)",0.642639206712433,0.210681038706516,0
"<anonymized_userid>",2,3372,431,"Jesse Klaver (GL)",0.643020594965675,0.211170994610485,0
"<anonymized_userid>",2,3374,432,"Jesse Klaver (GL)",0.643401983218917,0.211660950514454,0
"<anonymized_userid>",2,3376,433,"Jesse Klaver (GL)",0.643783371472159,0.212150906418422,0
"<anonymized_userid>",2,3378,434,"Jesse Klaver (GL)",0.6441647597254,0.212640862322391,0
"<anonymized_userid>",2,3380,435,"Jesse Klaver (GL)",0.644546147978642,0.21313081822636,0
"<anonymized_userid>",2,3382,436,"Jesse Klaver (GL)",0.644927536231884,0.213620774130328,0
"<anonymized_userid>",2,3384,437,"Jesse Klaver (GL)",0.645308924485126,0.214110730034297,0
"<anonymized_userid>",2,3386,438,"Jesse Klaver (GL)",0.645690312738368,0.214600685938266,0
"<anonymized_userid>",2,3388,439,"Jesse Klaver (GL)",0.646071700991609,0.215090641842234,0
"<anonymized_userid>",2,3390,440,"Jesse Klaver (GL)",0.646453089244851,0.215580597746203,0
"<anonymized_userid>",2,3392,441,"Jesse Klaver (GL)",0.646834477498093,0.216070553650171,0
"<anonymized_userid>",2,3394,442,"Jesse Klaver (GL)",0.647215865751335,0.21656050955414,0
"<anonymized_userid>",2,3396,443,"Jesse Klaver (GL)",0.647597254004577,0.217050465458109,0
"<anonymized_userid>",2,3398,444,"Jesse Klaver (GL)",0.647978642257818,0.217540421362077,0
"<anonymized_userid>",2,3400,445,"Jesse Klaver (GL)",0.64836003051106,0.218030377266046,0
"<anonymized_userid>",2,3402,446,"Jesse Klaver (GL)",0.648741418764302,0.218520333170015,0
"<anonymized_userid>",2,3404,447,"Jesse Klaver (GL)",0.649122807017544,0.219010289073983,0
"<anonymized_userid>",2,3406,448,"Jesse Klaver (GL)",0.649504195270786,0.219500244977952,0
"<anonymized_userid>",2,3408,449,"Jesse Klaver (GL)",0.649885583524027,0.219990200881921,0
"<anonymized_userid>",2,3410,450,"Jesse Klaver (GL)",0.650266971777269,0.220480156785889,0
"<anonymized_userid>",2,3412,451,"Jesse Klaver (GL)",0.650648360030511,0.220970112689858,0
"<anonymized_userid>",2,3414,452,"Jesse Klaver (GL)",0.651029748283753,0.221460068593827,0
"<anonymized_userid>",2,3416,453,"Jesse Klaver (GL)",0.651411136536995,0.221950024497795,0
"<anonymized_userid>",2,3418,454,"Jesse Klaver (GL)",0.651792524790236,0.222439980401764,0
"<anonymized_userid>",2,3420,455,"Jesse Klaver (GL)",0.652173913043478,0.222929936305732,0
"<anonymized_userid>",2,3422,456,"Jesse Klaver (GL)",0.65255530129672,0.223419892209701,0
"<anonymized_userid>",2,3424,457,"Jesse Klaver (GL)",0.652936689549962,0.22390984811367,0
"<anonymized_userid>",2,3426,458,"Jesse Klaver (GL)",0.653318077803204,0.224399804017638,0
"<anonymized_userid>",2,3428,459,"Jesse Klaver (GL)",0.653699466056445,0.224889759921607,0
"<anonymized_userid>",2,3430,460,"Jesse Klaver (GL)",0.654080854309687,0.225379715825576,0
"<anonymized_userid>",2,3432,461,"Jesse Klaver (GL)",0.654462242562929,0.225869671729544,0
"<anonymized_userid>",2,3434,462,"Jesse Klaver (GL)",0.654843630816171,0.226359627633513,0
"<anonymized_userid>",2,3436,463,"Jesse Klaver (GL)",0.655225019069413,0.226849583537482,0
"<anonymized_userid>",2,3438,464,"Jesse Klaver (GL)",0.655606407322655,0.22733953944145,0
"<anonymized_userid>",2,3440,465,"Jesse Klaver (GL)",0.655987795575896,0.227829495345419,0
"<anonymized_userid>",2,3442,466,"Jesse Klaver (GL)",0.656369183829138,0.228319451249388,0
"<anonymized_userid>",2,3444,467,"Jesse Klaver (GL)",0.65675057208238,0.228809407153356,0
"<anonymized_userid>",2,3446,468,"Jesse Klaver (GL)",0.657131960335622,0.229299363057325,0
"<anonymized_userid>",2,3448,469,"Jesse Klaver (GL)",0.657513348588863,0.229789318961293,0
"<anonymized_userid>",2,3450,470,"Jesse Klaver (GL)",0.657894736842105,0.230279274865262,0
"<anonymized_userid>",2,3452,471,"Jesse Klaver (GL)",0.658276125095347,0.230769230769231,0
"<anonymized_userid>",2,3454,472,"Jesse Klaver (GL)",0.658657513348589,0.231259186673199,0
"<anonymized_userid>",2,3456,473,"Jesse Klaver (GL)",0.659038901601831,0.231749142577168,0
"<anonymized_userid>",2,3458,474,"Jesse Klaver (GL)",0.659420289855073,0.232239098481137,0
"<anonymized_userid>",2,3460,475,"Jesse Klaver (GL)",0.659801678108314,0.232729054385105,0
"<anonymized_userid>",2,3462,476,"Jesse Klaver (GL)",0.660183066361556,0.233219010289074,0
"<anonymized_userid>",2,3464,477,"Jesse Klaver (GL)",0.660564454614798,0.233708966193043,0
"<anonymized_userid>",2,3466,478,"Jesse Klaver (GL)",0.66094584286804,0.234198922097011,0
"<anonymized_userid>",2,3468,479,"Jesse Klaver (GL)",0.661327231121281,0.23468887800098,0
"<anonymized_userid>",2,3470,480,"Jesse Klaver (GL)",0.661708619374523,0.235178833904949,0
"<anonymized_userid>",2,3472,481,"Jesse Klaver (GL)",0.662090007627765,0.235668789808917,0
"<anonymized_userid>",2,3474,482,"Jesse Klaver (GL)",0.662471395881007,0.236158745712886,0
"<anonymized_userid>",2,3476,483,"Jesse Klaver (GL)",0.662852784134249,0.236648701616854,0
"<anonymized_userid>",2,3478,484,"Jesse Klaver (GL)",0.66323417238749,0.237138657520823,0
"<anonymized_userid>",2,3480,485,"Jesse Klaver (GL)",0.663615560640732,0.237628613424792,0
"<anonymized_userid>",2,3482,486,"Jesse Klaver (GL)",0.663996948893974,0.23811856932876,0
"<anonymized_userid>",2,3484,487,"Jesse Klaver (GL)",0.664378337147216,0.238608525232729,0
"<anonymized_userid>",2,3486,488,"Jesse Klaver (GL)",0.664759725400458,0.239098481136698,0
"<anonymized_userid>",2,3488,489,"Jesse Klaver (GL)",0.665141113653699,0.239588437040666,0
"<anonymized_userid>",2,3490,490,"Jesse Klaver (GL)",0.665522501906941,0.240078392944635,0
"<anonymized_userid>",2,3492,491,"Jesse Klaver (GL)",0.665903890160183,0.240568348848604,0
"<anonymized_userid>",2,3494,492,"Jesse Klaver (GL)",0.666285278413425,0.241058304752572,0
"<anonymized_userid>",2,3496,493,"Jesse Klaver (GL)",0.666666666666667,0.241548260656541,0
"<anonymized_userid>",2,3498,494,"Jesse Klaver (GL)",0.667048054919908,0.24203821656051,0
"<anonymized_userid>",2,3500,495,"Jesse Klaver (GL)",0.66742944317315,0.242528172464478,0
"<anonymized_userid>",2,3502,496,"Jesse Klaver (GL)",0.667810831426392,0.243018128368447,0
"<anonymized_userid>",2,3504,497,"Jesse Klaver (GL)",0.668192219679634,0.243508084272415,0
"<anonymized_userid>",2,3506,498,"Jesse Klaver (GL)",0.668573607932876,0.243998040176384,0
"<anonymized_userid>",2,3508,499,"Jesse Klaver (GL)",0.668954996186117,0.244487996080353,0
"<anonymized_userid>",2,3510,500,"Jesse Klaver (GL)",0.669336384439359,0.244977951984321,0
"<anonymized_userid>",2,3512,501,"Jesse Klaver (GL)",0.669717772692601,0.24546790788829,0
"<anonymized_userid>",2,3514,502,"Jesse Klaver (GL)",0.670099160945843,0.245957863792259,0
"<anonymized_userid>",2,3516,503,"Jesse Klaver (GL)",0.670480549199085,0.246447819696227,0
"<anonymized_userid>",2,3518,504,"Jesse Klaver (GL)",0.670861937452326,0.246937775600196,0
"<anonymized_userid>",2,3520,505,"Jesse Klaver (GL)",0.671243325705568,0.247427731504165,0
"<anonymized_userid>",2,3522,506,"Jesse Klaver (GL)",0.67162471395881,0.247917687408133,0
"<anonymized_userid>",2,3524,507,"Jesse Klaver (GL)",0.672006102212052,0.248407643312102,0
"<anonymized_userid>",2,3526,508,"Jesse Klaver (GL)",0.672387490465294,0.248897599216071,0
"<anonymized_userid>",2,3528,509,"Jesse Klaver (GL)",0.672768878718536,0.249387555120039,0
"<anonymized_userid>",2,3530,510,"Jesse Klaver (GL)",0.673150266971777,0.249877511024008,0
"<anonymized_userid>",2,3532,511,"Jesse Klaver (GL)",0.673531655225019,0.250367466927976,0
"<anonymized_userid>",2,3534,512,"Jesse Klaver (GL)",0.673913043478261,0.250857422831945,0
"<anonymized_userid>",2,3536,513,"Jesse Klaver (GL)",0.674294431731503,0.251347378735914,0
"<anonymized_userid>",2,3538,514,"Jesse Klaver (GL)",0.674675819984744,0.251837334639882,0
"<anonymized_userid>",2,3540,515,"Jesse Klaver (GL)",0.675057208237986,0.252327290543851,0
"<anonymized_userid>",2,3542,516,"Jesse Klaver (GL)",0.675438596491228,0.25281724644782,0
"<anonymized_userid>",2,3544,517,"Jesse Klaver (GL)",0.67581998474447,0.253307202351788,0
"<anonymized_userid>",2,3546,518,"Jesse Klaver (GL)",0.676201372997712,0.253797158255757,0
"<anonymized_userid>",2,3548,519,"Jesse Klaver (GL)",0.676582761250954,0.254287114159726,0
"<anonymized_userid>",2,3550,520,"Jesse Klaver (GL)",0.676964149504195,0.254777070063694,0
"<anonymized_userid>",2,3552,521,"Jesse Klaver (GL)",0.677345537757437,0.255267025967663,0
"<anonymized_userid>",2,3554,522,"Jesse Klaver (GL)",0.677726926010679,0.255756981871632,0
"<anonymized_userid>",2,3556,523,"Jesse Klaver (GL)",0.678108314263921,0.2562469377756,0
"<anonymized_userid>",2,3558,524,"Jesse Klaver (GL)",0.678489702517162,0.256736893679569,0
"<anonymized_userid>",2,3560,525,"Jesse Klaver (GL)",0.678871090770404,0.257226849583537,0
"<anonymized_userid>",2,3562,526,"Jesse Klaver (GL)",0.679252479023646,0.257716805487506,0
"<anonymized_userid>",2,3564,527,"Jesse Klaver (GL)",0.679633867276888,0.258206761391475,0
"<anonymized_userid>",2,3566,528,"Jesse Klaver (GL)",0.68001525553013,0.258696717295443,0
"<anonymized_userid>",2,3568,529,"Jesse Klaver (GL)",0.680396643783372,0.259186673199412,0
"<anonymized_userid>",2,3570,530,"Jesse Klaver (GL)",0.680778032036613,0.259676629103381,0
"<anonymized_userid>",2,3572,531,"Jesse Klaver (GL)",0.681159420289855,0.260166585007349,0
"<anonymized_userid>",2,3574,532,"Jesse Klaver (GL)",0.681540808543097,0.260656540911318,0
"<anonymized_userid>",2,3576,533,"Jesse Klaver (GL)",0.681922196796339,0.261146496815287,0
"<anonymized_userid>",2,3578,534,"Jesse Klaver (GL)",0.68230358504958,0.261636452719255,0
"<anonymized_userid>",2,3580,535,"Jesse Klaver (GL)",0.682684973302822,0.262126408623224,0
"<anonymized_userid>",2,3582,536,"Jesse Klaver (GL)",0.683066361556064,0.262616364527193,0
"<anonymized_userid>",2,3584,537,"Jesse Klaver (GL)",0.683447749809306,0.263106320431161,0
"<anonymized_userid>",2,3586,538,"Jesse Klaver (GL)",0.683829138062548,0.26359627633513,0
"<anonymized_userid>",2,3588,539,"Jesse Klaver (GL)",0.684210526315789,0.264086232239098,0
"<anonymized_userid>",2,3590,540,"Jesse Klaver (GL)",0.684591914569031,0.264576188143067,0
"<anonymized_userid>",2,3592,541,"Jesse Klaver (GL)",0.684973302822273,0.265066144047036,0
"<anonymized_userid>",2,3594,542,"Jesse Klaver (GL)",0.685354691075515,0.265556099951004,0
"<anonymized_userid>",2,3596,543,"Jesse Klaver (GL)",0.685736079328757,0.266046055854973,0
"<anonymized_userid>",2,3598,544,"Jesse Klaver (GL)",0.686117467581998,0.266536011758942,0
"<anonymized_userid>",2,3600,545,"Jesse Klaver (GL)",0.68649885583524,0.26702596766291,0
"<anonymized_userid>",2,3602,546,"Jesse Klaver (GL)",0.686880244088482,0.267515923566879,0
"<anonymized_userid>",2,3604,547,"Jesse Klaver (GL)",0.687261632341724,0.268005879470848,0
"<anonymized_userid>",2,3606,548,"Jesse Klaver (GL)",0.687643020594966,0.268495835374816,0
"<anonymized_userid>",2,3608,549,"Jesse Klaver (GL)",0.688024408848207,0.268985791278785,0
"<anonymized_userid>",2,3610,550,"Jesse Klaver (GL)",0.688405797101449,0.269475747182754,0
"<anonymized_userid>",2,3612,551,"Jesse Klaver (GL)",0.688787185354691,0.269965703086722,0
"<anonymized_userid>",2,3614,552,"Jesse Klaver (GL)",0.689168573607933,0.270455658990691,0
"<anonymized_userid>",2,3616,553,"Jesse Klaver (GL)",0.689549961861175,0.270945614894659,0
"<anonymized_userid>",2,3618,554,"Jesse Klaver (GL)",0.689931350114417,0.271435570798628,0
"<anonymized_userid>",2,3620,555,"Jesse Klaver (GL)",0.690312738367658,0.271925526702597,0
"<anonymized_userid>",2,3622,556,"Jesse Klaver (GL)",0.6906941266209,0.272415482606565,0
"<anonymized_userid>",2,3624,557,"Jesse Klaver (GL)",0.691075514874142,0.272905438510534,0
"<anonymized_userid>",2,3626,558,"Jesse Klaver (GL)",0.691456903127384,0.273395394414503,0
"<anonymized_userid>",2,3628,559,"Jesse Klaver (GL)",0.691838291380625,0.273885350318471,0
"<anonymized_userid>",2,3630,560,"Jesse Klaver (GL)",0.692219679633867,0.27437530622244,0
"<anonymized_userid>",2,3632,561,"Jesse Klaver (GL)",0.692601067887109,0.274865262126409,0
"<anonymized_userid>",2,3634,562,"Jesse Klaver (GL)",0.692982456140351,0.275355218030377,0
"<anonymized_userid>",2,3636,563,"Jesse Klaver (GL)",0.693363844393593,0.275845173934346,0
"<anonymized_userid>",2,3638,564,"Jesse Klaver (GL)",0.693745232646835,0.276335129838315,0
"<anonymized_userid>",2,3640,565,"Jesse Klaver (GL)",0.694126620900076,0.276825085742283,0
"<anonymized_userid>",2,3642,566,"Jesse Klaver (GL)",0.694508009153318,0.277315041646252,0
"<anonymized_userid>",2,3644,567,"Jesse Klaver (GL)",0.69488939740656,0.27780499755022,0
"<anonymized_userid>",2,3646,568,"Jesse Klaver (GL)",0.695270785659802,0.278294953454189,0
"<anonymized_userid>",2,3648,569,"Jesse Klaver (GL)",0.695652173913043,0.278784909358158,0
"<anonymized_userid>",2,3650,570,"Jesse Klaver (GL)",0.696033562166285,0.279274865262126,0
"<anonymized_userid>",2,3652,571,"Jesse Klaver (GL)",0.696414950419527,0.279764821166095,0
"<anonymized_userid>",2,3654,572,"Jesse Klaver (GL)",0.696796338672769,0.280254777070064,0
"<anonymized_userid>",2,3656,573,"Jesse Klaver (GL)",0.697177726926011,0.280744732974032,0
"<anonymized_userid>",2,3658,574,"Jesse Klaver (GL)",0.697559115179253,0.281234688878001,0
"<anonymized_userid>",2,3660,575,"Jesse Klaver (GL)",0.697940503432494,0.28172464478197,0
"<anonymized_userid>",2,3662,576,"Jesse Klaver (GL)",0.698321891685736,0.282214600685938,0
"<anonymized_userid>",2,3664,577,"Jesse Klaver (GL)",0.698703279938978,0.282704556589907,0
"<anonymized_userid>",2,3666,578,"Jesse Klaver (GL)",0.69908466819222,0.283194512493876,0
"<anonymized_userid>",2,3668,579,"Jesse Klaver (GL)",0.699466056445461,0.283684468397844,0
"<anonymized_userid>",2,3670,580,"Jesse Klaver (GL)",0.699847444698703,0.284174424301813,0
"<anonymized_userid>",2,3672,581,"Jesse Klaver (GL)",0.700228832951945,0.284664380205781,0
"<anonymized_userid>",2,3674,582,"Jesse Klaver (GL)",0.700610221205187,0.28515433610975,0
"<anonymized_userid>",2,3676,583,"Jesse Klaver (GL)",0.700991609458429,0.285644292013719,0
"<anonymized_userid>",2,3678,584,"Jesse Klaver (GL)",0.70137299771167,0.286134247917687,0
"<anonymized_userid>",2,3680,585,"Jesse Klaver (GL)",0.701754385964912,0.286624203821656,0
"<anonymized_userid>",2,3682,586,"Jesse Klaver (GL)",0.702135774218154,0.287114159725625,0
"<anonymized_userid>",2,3684,587,"Jesse Klaver (GL)",0.702517162471396,0.287604115629593,0
"<anonymized_userid>",2,3686,588,"Jesse Klaver (GL)",0.702898550724638,0.288094071533562,0
"<anonymized_userid>",2,3688,589,"Jesse Klaver (GL)",0.703279938977879,0.288584027437531,0
"<anonymized_userid>",2,3690,590,"Jesse Klaver (GL)",0.703661327231121,0.289073983341499,0
"<anonymized_userid>",2,3692,591,"Jesse Klaver (GL)",0.704042715484363,0.289563939245468,0
"<anonymized_userid>",2,3694,592,"Jesse Klaver (GL)",0.704424103737605,0.290053895149437,0
"<anonymized_userid>",2,3696,593,"Jesse Klaver (GL)",0.704805491990847,0.290543851053405,0
"<anonymized_userid>",2,3698,594,"Jesse Klaver (GL)",0.705186880244088,0.291033806957374,0
"<anonymized_userid>",2,3700,595,"Jesse Klaver (GL)",0.70556826849733,0.291523762861342,0
"<anonymized_userid>",2,3702,596,"Jesse Klaver (GL)",0.705949656750572,0.292013718765311,0
"<anonymized_userid>",2,3704,597,"Jesse Klaver (GL)",0.706331045003814,0.29250367466928,0
"<anonymized_userid>",2,3706,598,"Jesse Klaver (GL)",0.706712433257056,0.292993630573248,0
"<anonymized_userid>",2,3708,599,"Jesse Klaver (GL)",0.707093821510298,0.293483586477217,0
"<anonymized_userid>",2,3710,600,"Jesse Klaver (GL)",0.707475209763539,0.293973542381186,0
"<anonymized_userid>",2,3712,601,"Jesse Klaver (GL)",0.707856598016781,0.294463498285154,0
"<anonymized_userid>",2,3714,602,"Jesse Klaver (GL)",0.708237986270023,0.294953454189123,0
"<anonymized_userid>",2,3716,603,"Jesse Klaver (GL)",0.708619374523265,0.295443410093092,0
"<anonymized_userid>",2,3718,604,"Jesse Klaver (GL)",0.709000762776506,0.29593336599706,0
"<anonymized_userid>",2,3720,605,"Jesse Klaver (GL)",0.709382151029748,0.296423321901029,0
"<anonymized_userid>",2,3722,606,"Jesse Klaver (GL)",0.70976353928299,0.296913277804998,0
"<anonymized_userid>",2,3724,607,"Jesse Klaver (GL)",0.710144927536232,0.297403233708966,0
"<anonymized_userid>",2,3726,608,"Jesse Klaver (GL)",0.710526315789474,0.297893189612935,0
"<anonymized_userid>",2,3728,609,"Jesse Klaver (GL)",0.710907704042716,0.298383145516903,0
"<anonymized_userid>",2,3730,610,"Jesse Klaver (GL)",0.711289092295957,0.298873101420872,0
"<anonymized_userid>",2,3732,611,"Jesse Klaver (GL)",0.711670480549199,0.299363057324841,0
"<anonymized_userid>",2,3734,612,"Jesse Klaver (GL)",0.712051868802441,0.299853013228809,0
"<anonymized_userid>",2,3736,613,"Jesse Klaver (GL)",0.712433257055683,0.300342969132778,0
"<anonymized_userid>",2,3738,614,"Jesse Klaver (GL)",0.712814645308924,0.300832925036747,0
"<anonymized_userid>",2,3740,615,"Jesse Klaver (GL)",0.713196033562166,0.301322880940715,0
"<anonymized_userid>",2,3742,616,"Jesse Klaver (GL)",0.713577421815408,0.301812836844684,0
"<anonymized_userid>",2,3744,617,"Jesse Klaver (GL)",0.71395881006865,0.302302792748653,0
"<anonymized_userid>",2,3746,618,"Jesse Klaver (GL)",0.714340198321892,0.302792748652621,0
"<anonymized_userid>",2,3748,619,"Jesse Klaver (GL)",0.714721586575134,0.30328270455659,0
"<anonymized_userid>",2,3750,620,"Jesse Klaver (GL)",0.715102974828375,0.303772660460559,0
"<anonymized_userid>",2,3752,621,"Jesse Klaver (GL)",0.715484363081617,0.304262616364527,0
"<anonymized_userid>",2,3754,622,"Jesse Klaver (GL)",0.715865751334859,0.304752572268496,0
"<anonymized_userid>",2,3756,623,"Jesse Klaver (GL)",0.716247139588101,0.305242528172465,0
"<anonymized_userid>",2,3758,624,"Jesse Klaver (GL)",0.716628527841342,0.305732484076433,0
"<anonymized_userid>",2,3760,625,"Jesse Klaver (GL)",0.717009916094584,0.306222439980402,0
"<anonymized_userid>",2,3762,626,"Jesse Klaver (GL)",0.717391304347826,0.30671239588437,0
"<anonymized_userid>",2,3764,627,"Jesse Klaver (GL)",0.717772692601068,0.307202351788339,0
"<anonymized_userid>",2,3766,628,"Jesse Klaver (GL)",0.71815408085431,0.307692307692308,0
"<anonymized_userid>",2,3768,629,"Jesse Klaver (GL)",0.718535469107552,0.308182263596276,0
"<anonymized_userid>",2,3770,630,"Jesse Klaver (GL)",0.718916857360793,0.308672219500245,0
"<anonymized_userid>",2,3772,631,"Jesse Klaver (GL)",0.719298245614035,0.309162175404214,0
"<anonymized_userid>",2,3774,632,"Jesse Klaver (GL)",0.719679633867277,0.309652131308182,0
"<anonymized_userid>",2,3776,633,"Jesse Klaver (GL)",0.720061022120519,0.310142087212151,0
"<anonymized_userid>",2,3778,634,"Jesse Klaver (GL)",0.72044241037376,0.31063204311612,0
"<anonymized_userid>",2,3780,635,"Jesse Klaver (GL)",0.720823798627002,0.311121999020088,0
"<anonymized_userid>",2,3782,636,"Jesse Klaver (GL)",0.721205186880244,0.311611954924057,0
"<anonymized_userid>",2,3784,637,"Jesse Klaver (GL)",0.721586575133486,0.312101910828025,0
"<anonymized_userid>",2,3786,638,"Jesse Klaver (GL)",0.721967963386728,0.312591866731994,0
"<anonymized_userid>",2,3788,639,"Jesse Klaver (GL)",0.722349351639969,0.313081822635963,0
"<anonymized_userid>",2,3790,640,"Jesse Klaver (GL)",0.722730739893211,0.313571778539931,0
"<anonymized_userid>",2,3792,641,"Jesse Klaver (GL)",0.723112128146453,0.3140617344439,0
"<anonymized_userid>",2,3794,642,"Jesse Klaver (GL)",0.723493516399695,0.314551690347869,0
"<anonymized_userid>",2,3796,643,"Jesse Klaver (GL)",0.723874904652937,0.315041646251837,0
"<anonymized_userid>",2,3798,644,"Jesse Klaver (GL)",0.724256292906179,0.315531602155806,0
"<anonymized_userid>",2,3800,645,"Jesse Klaver (GL)",0.72463768115942,0.316021558059775,0
"<anonymized_userid>",2,3802,646,"Jesse Klaver (GL)",0.725019069412662,0.316511513963743,0
"<anonymized_userid>",2,3804,647,"Jesse Klaver (GL)",0.725400457665904,0.317001469867712,0
"<anonymized_userid>",2,3806,648,"Jesse Klaver (GL)",0.725781845919146,0.317491425771681,0
"<anonymized_userid>",2,3808,649,"Jesse Klaver (GL)",0.726163234172387,0.317981381675649,0
"<anonymized_userid>",2,3810,650,"Jesse Klaver (GL)",0.726544622425629,0.318471337579618,0
"<anonymized_userid>",2,3812,651,"Jesse Klaver (GL)",0.726926010678871,0.318961293483586,0
"<anonymized_userid>",2,3814,652,"Jesse Klaver (GL)",0.727307398932113,0.319451249387555,0
"<anonymized_userid>",2,3816,653,"Jesse Klaver (GL)",0.727688787185355,0.319941205291524,0
"<anonymized_userid>",2,3818,654,"Jesse Klaver (GL)",0.728070175438597,0.320431161195492,0
"<anonymized_userid>",2,3820,655,"Jesse Klaver (GL)",0.728451563691838,0.320921117099461,0
"<anonymized_userid>",2,3822,656,"Jesse Klaver (GL)",0.72883295194508,0.32141107300343,0
"<anonymized_userid>",2,3824,657,"Jesse Klaver (GL)",0.729214340198322,0.321901028907398,0
"<anonymized_userid>",2,3826,658,"Jesse Klaver (GL)",0.729595728451564,0.322390984811367,0
"<anonymized_userid>",2,3828,659,"Jesse Klaver (GL)",0.729977116704805,0.322880940715336,0
"<anonymized_userid>",2,3830,660,"Jesse Klaver (GL)",0.730358504958047,0.323370896619304,0
"<anonymized_userid>",2,3832,661,"Jesse Klaver (GL)",0.730739893211289,0.323860852523273,0
"<anonymized_userid>",2,3834,662,"Jesse Klaver (GL)",0.731121281464531,0.324350808427242,0
"<anonymized_userid>",2,3836,663,"Jesse Klaver (GL)",0.731502669717773,0.32484076433121,0
"<anonymized_userid>",2,3838,664,"Jesse Klaver (GL)",0.731884057971015,0.325330720235179,0
"<anonymized_userid>",2,3840,665,"Jesse Klaver (GL)",0.732265446224256,0.325820676139148,0
"<anonymized_userid>",2,3842,666,"Jesse Klaver (GL)",0.732646834477498,0.326310632043116,0
"<anonymized_userid>",2,3844,667,"Jesse Klaver (GL)",0.73302822273074,0.326800587947085,0
"<anonymized_userid>",2,3846,668,"Jesse Klaver (GL)",0.733409610983982,0.327290543851053,0
"<anonymized_userid>",2,3848,669,"Jesse Klaver (GL)",0.733790999237223,0.327780499755022,0
"<anonymized_userid>",2,3850,670,"Jesse Klaver (GL)",0.734172387490465,0.328270455658991,0
"<anonymized_userid>",2,3852,671,"Jesse Klaver (GL)",0.734553775743707,0.328760411562959,0
"<anonymized_userid>",2,3854,672,"Jesse Klaver (GL)",0.734935163996949,0.329250367466928,0
"<anonymized_userid>",2,3856,673,"Jesse Klaver (GL)",0.735316552250191,0.329740323370897,0
"<anonymized_userid>",2,3858,674,"Jesse Klaver (GL)",0.735697940503433,0.330230279274865,0
"<anonymized_userid>",2,3860,675,"Jesse Klaver (GL)",0.736079328756674,0.330720235178834,0
"<anonymized_userid>",2,3862,676,"Jesse Klaver (GL)",0.736460717009916,0.331210191082803,0
"<anonymized_userid>",2,3864,677,"Jesse Klaver (GL)",0.736842105263158,0.331700146986771,0
"<anonymized_userid>",2,3866,678,"Jesse Klaver (GL)",0.7372234935164,0.33219010289074,0
"<anonymized_userid>",2,3868,679,"Jesse Klaver (GL)",0.737604881769641,0.332680058794708,0
"<anonymized_userid>",2,3870,680,"Jesse Klaver (GL)",0.737986270022883,0.333170014698677,0
"<anonymized_userid>",2,3872,681,"Jesse Klaver (GL)",0.738367658276125,0.333659970602646,0
"<anonymized_userid>",2,3874,682,"Jesse Klaver (GL)",0.738749046529367,0.334149926506614,0
"<anonymized_userid>",2,3876,683,"Jesse Klaver (GL)",0.739130434782609,0.334639882410583,0
"<anonymized_userid>",2,3878,684,"Jesse Klaver (GL)",0.739511823035851,0.335129838314552,0
"<anonymized_userid>",2,3880,685,"Jesse Klaver (GL)",0.739893211289092,0.33561979421852,0
"<anonymized_userid>",2,3882,686,"Jesse Klaver (GL)",0.740274599542334,0.336109750122489,0
"<anonymized_userid>",2,3884,687,"Jesse Klaver (GL)",0.740655987795576,0.336599706026458,0
"<anonymized_userid>",2,3886,688,"Jesse Klaver (GL)",0.741037376048818,0.337089661930426,0
"<anonymized_userid>",2,3888,689,"Jesse Klaver (GL)",0.74141876430206,0.337579617834395,0
"<anonymized_userid>",2,3890,690,"Jesse Klaver (GL)",0.741800152555301,0.338069573738364,0
"<anonymized_userid>",2,3892,691,"Jesse Klaver (GL)",0.742181540808543,0.338559529642332,0
"<anonymized_userid>",2,3894,692,"Jesse Klaver (GL)",0.742562929061785,0.339049485546301,0
"<anonymized_userid>",2,3896,693,"Jesse Klaver (GL)",0.742944317315027,0.339539441450269,0
"<anonymized_userid>",1,3897,694,"Jesse Klaver (GL)",0.743135011441648,0.340029397354238,0
"<anonymized_userid>",1,3898,695,"Jesse Klaver (GL)",0.743325705568268,0.340519353258207,0
"<anonymized_userid>",1,3899,696,"Jesse Klaver (GL)",0.743516399694889,0.341009309162175,0
"<anonymized_userid>",1,3900,697,"Jesse Klaver (GL)",0.74370709382151,0.341499265066144,0
"<anonymized_userid>",1,3901,698,"Jesse Klaver (GL)",0.743897787948131,0.341989220970113,0
"<anonymized_userid>",1,3902,699,"Jesse Klaver (GL)",0.744088482074752,0.342479176874081,0
"<anonymized_userid>",1,3903,700,"Jesse Klaver (GL)",0.744279176201373,0.34296913277805,0
"<anonymized_userid>",1,3904,701,"Jesse Klaver (GL)",0.744469870327994,0.343459088682019,0
"<anonymized_userid>",1,3905,702,"Jesse Klaver (GL)",0.744660564454615,0.343949044585987,0
"<anonymized_userid>",1,3906,703,"Jesse Klaver (GL)",0.744851258581236,0.344439000489956,0
"<anonymized_userid>",1,3907,704,"Jesse Klaver (GL)",0.745041952707857,0.344928956393925,0
"<anonymized_userid>",1,3908,705,"Jesse Klaver (GL)",0.745232646834478,0.345418912297893,0
"<anonymized_userid>",1,3909,706,"Jesse Klaver (GL)",0.745423340961098,0.345908868201862,0
"<anonymized_userid>",1,3910,707,"Jesse Klaver (GL)",0.745614035087719,0.34639882410583,0
"<anonymized_userid>",1,3911,708,"Jesse Klaver (GL)",0.74580472921434,0.346888780009799,0
"<anonymized_userid>",1,3912,709,"Jesse Klaver (GL)",0.745995423340961,0.347378735913768,0
"<anonymized_userid>",1,3913,710,"Jesse Klaver (GL)",0.746186117467582,0.347868691817736,0
"<anonymized_userid>",1,3914,711,"Jesse Klaver (GL)",0.746376811594203,0.348358647721705,0
"<anonymized_userid>",1,3915,712,"Jesse Klaver (GL)",0.746567505720824,0.348848603625674,0
"<anonymized_userid>",1,3916,713,"Jesse Klaver (GL)",0.746758199847445,0.349338559529642,0
"<anonymized_userid>",1,3917,714,"Jesse Klaver (GL)",0.746948893974066,0.349828515433611,0
"<anonymized_userid>",1,3918,715,"Jesse Klaver (GL)",0.747139588100686,0.35031847133758,0
"<anonymized_userid>",1,3919,716,"Jesse Klaver (GL)",0.747330282227307,0.350808427241548,0
"<anonymized_userid>",1,3920,717,"Jesse Klaver (GL)",0.747520976353928,0.351298383145517,0
"<anonymized_userid>",1,3921,718,"Jesse Klaver (GL)",0.747711670480549,0.351788339049486,0
"<anonymized_userid>",1,3922,719,"Jesse Klaver (GL)",0.74790236460717,0.352278294953454,0
"<anonymized_userid>",1,3923,720,"Jesse Klaver (GL)",0.748093058733791,0.352768250857423,0
"<anonymized_userid>",1,3924,721,"Jesse Klaver (GL)",0.748283752860412,0.353258206761391,0
"<anonymized_userid>",1,3925,722,"Jesse Klaver (GL)",0.748474446987033,0.35374816266536,0
"<anonymized_userid>",1,3926,723,"Jesse Klaver (GL)",0.748665141113654,0.354238118569329,0
"<anonymized_userid>",1,3927,724,"Jesse Klaver (GL)",0.748855835240275,0.354728074473297,0
"<anonymized_userid>",1,3928,725,"Jesse Klaver (GL)",0.749046529366896,0.355218030377266,0
"<anonymized_userid>",1,3929,726,"Jesse Klaver (GL)",0.749237223493516,0.355707986281235,0
"<anonymized_userid>",1,3930,727,"Jesse Klaver (GL)",0.749427917620137,0.356197942185203,0
"<anonymized_userid>",1,3931,728,"Jesse Klaver (GL)",0.749618611746758,0.356687898089172,0
"<anonymized_userid>",1,3932,729,"Jesse Klaver (GL)",0.749809305873379,0.357177853993141,0
"<anonymized_userid>",1,3933,730,"Jesse Klaver (GL)",0.75,0.357667809897109,0
"<anonymized_userid>",1,3934,731,"Jesse Klaver (GL)",0.750190694126621,0.358157765801078,0
"<anonymized_userid>",1,3935,732,"Jesse Klaver (GL)",0.750381388253242,0.358647721705047,0
"<anonymized_userid>",1,3936,733,"Jesse Klaver (GL)",0.750572082379863,0.359137677609015,0
"<anonymized_userid>",1,3937,734,"Jesse Klaver (GL)",0.750762776506484,0.359627633512984,0
"<anonymized_userid>",1,3938,735,"Jesse Klaver (GL)",0.750953470633104,0.360117589416952,0
"<anonymized_userid>",1,3939,736,"Jesse Klaver (GL)",0.751144164759725,0.360607545320921,0
"<anonymized_userid>",1,3940,737,"Jesse Klaver (GL)",0.751334858886346,0.36109750122489,0
"<anonymized_userid>",1,3941,738,"Jesse Klaver (GL)",0.751525553012967,0.361587457128858,0
"<anonymized_userid>",1,3942,739,"Jesse Klaver (GL)",0.751716247139588,0.362077413032827,0
"<anonymized_userid>",1,3943,740,"Jesse Klaver (GL)",0.751906941266209,0.362567368936796,0
"<anonymized_userid>",1,3944,741,"Jesse Klaver (GL)",0.75209763539283,0.363057324840764,0
"<anonymized_userid>",1,3945,742,"Jesse Klaver (GL)",0.752288329519451,0.363547280744733,0
"<anonymized_userid>",1,3946,743,"Jesse Klaver (GL)",0.752479023646072,0.364037236648702,0
"<anonymized_userid>",1,3947,744,"Jesse Klaver (GL)",0.752669717772693,0.36452719255267,0
"<anonymized_userid>",1,3948,745,"Jesse Klaver (GL)",0.752860411899314,0.365017148456639,0
"<anonymized_userid>",1,3949,746,"Jesse Klaver (GL)",0.753051106025934,0.365507104360608,0
"<anonymized_userid>",1,3950,747,"Jesse Klaver (GL)",0.753241800152555,0.365997060264576,0
"<anonymized_userid>",1,3951,748,"Jesse Klaver (GL)",0.753432494279176,0.366487016168545,0
"<anonymized_userid>",1,3952,749,"Jesse Klaver (GL)",0.753623188405797,0.366976972072513,0
"<anonymized_userid>",1,3953,750,"Jesse Klaver (GL)",0.753813882532418,0.367466927976482,0
"<anonymized_userid>",1,3954,751,"Jesse Klaver (GL)",0.754004576659039,0.367956883880451,0
"<anonymized_userid>",1,3955,752,"Jesse Klaver (GL)",0.75419527078566,0.368446839784419,0
"<anonymized_userid>",1,3956,753,"Jesse Klaver (GL)",0.754385964912281,0.368936795688388,0
"<anonymized_userid>",1,3957,754,"Jesse Klaver (GL)",0.754576659038902,0.369426751592357,0
"<anonymized_userid>",1,3958,755,"Jesse Klaver (GL)",0.754767353165522,0.369916707496325,0
"<anonymized_userid>",1,3959,756,"Jesse Klaver (GL)",0.754958047292143,0.370406663400294,0
"<anonymized_userid>",1,3960,757,"Jesse Klaver (GL)",0.755148741418764,0.370896619304263,0
"<anonymized_userid>",1,3961,758,"Jesse Klaver (GL)",0.755339435545385,0.371386575208231,0
"<anonymized_userid>",1,3962,759,"Jesse Klaver (GL)",0.755530129672006,0.3718765311122,0
"<anonymized_userid>",1,3963,760,"Jesse Klaver (GL)",0.755720823798627,0.372366487016169,0
"<anonymized_userid>",1,3964,761,"Jesse Klaver (GL)",0.755911517925248,0.372856442920137,0
"<anonymized_userid>",1,3965,762,"Jesse Klaver (GL)",0.756102212051869,0.373346398824106,0
"<anonymized_userid>",1,3966,763,"Jesse Klaver (GL)",0.75629290617849,0.373836354728074,0
"<anonymized_userid>",1,3967,764,"Jesse Klaver (GL)",0.756483600305111,0.374326310632043,0
"<anonymized_userid>",1,3968,765,"Jesse Klaver (GL)",0.756674294431732,0.374816266536012,0
"<anonymized_userid>",1,3969,766,"Jesse Klaver (GL)",0.756864988558352,0.37530622243998,0
"<anonymized_userid>",1,3970,767,"Jesse Klaver (GL)",0.757055682684973,0.375796178343949,0
"<anonymized_userid>",1,3971,768,"Jesse Klaver (GL)",0.757246376811594,0.376286134247918,0
"<anonymized_userid>",1,3972,769,"Jesse Klaver (GL)",0.757437070938215,0.376776090151886,0
"<anonymized_userid>",1,3973,770,"Jesse Klaver (GL)",0.757627765064836,0.377266046055855,0
"<anonymized_userid>",1,3974,771,"Jesse Klaver (GL)",0.757818459191457,0.377756001959824,0
"<anonymized_userid>",1,3975,772,"Jesse Klaver (GL)",0.758009153318078,0.378245957863792,0
"<anonymized_userid>",1,3976,773,"Jesse Klaver (GL)",0.758199847444699,0.378735913767761,0
"<anonymized_userid>",1,3977,774,"Jesse Klaver (GL)",0.75839054157132,0.37922586967173,0
"<anonymized_userid>",1,3978,775,"Jesse Klaver (GL)",0.75858123569794,0.379715825575698,0
"<anonymized_userid>",1,3979,776,"Jesse Klaver (GL)",0.758771929824561,0.380205781479667,0
"<anonymized_userid>",1,3980,777,"Jesse Klaver (GL)",0.758962623951182,0.380695737383635,0
"<anonymized_userid>",1,3981,778,"Jesse Klaver (GL)",0.759153318077803,0.381185693287604,0
"<anonymized_userid>",1,3982,779,"Jesse Klaver (GL)",0.759344012204424,0.381675649191573,0
"<anonymized_userid>",1,3983,780,"Jesse Klaver (GL)",0.759534706331045,0.382165605095541,0
"<anonymized_userid>",1,3984,781,"Jesse Klaver (GL)",0.759725400457666,0.38265556099951,0
"<anonymized_userid>",1,3985,782,"Jesse Klaver (GL)",0.759916094584287,0.383145516903479,0
"<anonymized_userid>",1,3986,783,"Jesse Klaver (GL)",0.760106788710908,0.383635472807447,0
"<anonymized_userid>",1,3987,784,"Jesse Klaver (GL)",0.760297482837529,0.384125428711416,0
"<anonymized_userid>",1,3988,785,"Jesse Klaver (GL)",0.760488176964149,0.384615384615385,0
"<anonymized_userid>",1,3989,786,"Jesse Klaver (GL)",0.76067887109077,0.385105340519353,0
"<anonymized_userid>",1,3990,787,"Jesse Klaver (GL)",0.760869565217391,0.385595296423322,0
"<anonymized_userid>",1,3991,788,"Jesse Klaver (GL)",0.761060259344012,0.386085252327291,0
"<anonymized_userid>",1,3992,789,"Jesse Klaver (GL)",0.761250953470633,0.386575208231259,0
"<anonymized_userid>",1,3993,790,"Jesse Klaver (GL)",0.761441647597254,0.387065164135228,0
"<anonymized_userid>",1,3994,791,"Jesse Klaver (GL)",0.761632341723875,0.387555120039196,0
"<anonymized_userid>",1,3995,792,"Jesse Klaver (GL)",0.761823035850496,0.388045075943165,0
"<anonymized_userid>",1,3996,793,"Jesse Klaver (GL)",0.762013729977117,0.388535031847134,0
"<anonymized_userid>",1,3997,794,"Jesse Klaver (GL)",0.762204424103738,0.389024987751102,0
"<anonymized_userid>",1,3998,795,"Jesse Klaver (GL)",0.762395118230359,0.389514943655071,0
"<anonymized_userid>",1,3999,796,"Jesse Klaver (GL)",0.762585812356979,0.39000489955904,0
"<anonymized_userid>",1,4000,797,"Jesse Klaver (GL)",0.7627765064836,0.390494855463008,0
"<anonymized_userid>",1,4001,798,"Jesse Klaver (GL)",0.762967200610221,0.390984811366977,0
"<anonymized_userid>",1,4002,799,"Jesse Klaver (GL)",0.763157894736842,0.391474767270946,0
"<anonymized_userid>",1,4003,800,"Jesse Klaver (GL)",0.763348588863463,0.391964723174914,0
"<anonymized_userid>",1,4004,801,"Jesse Klaver (GL)",0.763539282990084,0.392454679078883,0
"<anonymized_userid>",1,4005,802,"Jesse Klaver (GL)",0.763729977116705,0.392944634982852,0
"<anonymized_userid>",1,4006,803,"Jesse Klaver (GL)",0.763920671243326,0.39343459088682,0
"<anonymized_userid>",1,4007,804,"Jesse Klaver (GL)",0.764111365369947,0.393924546790789,0
"<anonymized_userid>",1,4008,805,"Jesse Klaver (GL)",0.764302059496567,0.394414502694757,0
"<anonymized_userid>",1,4009,806,"Jesse Klaver (GL)",0.764492753623188,0.394904458598726,0
"<anonymized_userid>",1,4010,807,"Jesse Klaver (GL)",0.764683447749809,0.395394414502695,0
"<anonymized_userid>",1,4011,808,"Jesse Klaver (GL)",0.76487414187643,0.395884370406663,0
"<anonymized_userid>",1,4012,809,"Jesse Klaver (GL)",0.765064836003051,0.396374326310632,0
"<anonymized_userid>",1,4013,810,"Jesse Klaver (GL)",0.765255530129672,0.396864282214601,0
"<anonymized_userid>",1,4014,811,"Jesse Klaver (GL)",0.765446224256293,0.397354238118569,0
"<anonymized_userid>",1,4015,812,"Jesse Klaver (GL)",0.765636918382914,0.397844194022538,0
"<anonymized_userid>",1,4016,813,"Jesse Klaver (GL)",0.765827612509535,0.398334149926507,0
"<anonymized_userid>",1,4017,814,"Jesse Klaver (GL)",0.766018306636156,0.398824105830475,0
"<anonymized_userid>",1,4018,815,"Jesse Klaver (GL)",0.766209000762777,0.399314061734444,0
"<anonymized_userid>",1,4019,816,"Jesse Klaver (GL)",0.766399694889397,0.399804017638413,0
"<anonymized_userid>",1,4020,817,"Jesse Klaver (GL)",0.766590389016018,0.400293973542381,0
"<anonymized_userid>",1,4021,818,"Jesse Klaver (GL)",0.766781083142639,0.40078392944635,0
"<anonymized_userid>",1,4022,819,"Jesse Klaver (GL)",0.76697177726926,0.401273885350318,0
"<anonymized_userid>",1,4023,820,"Jesse Klaver (GL)",0.767162471395881,0.401763841254287,0
"<anonymized_userid>",1,4024,821,"Jesse Klaver (GL)",0.767353165522502,0.402253797158256,0
"<anonymized_userid>",1,4025,822,"Jesse Klaver (GL)",0.767543859649123,0.402743753062224,0
"<anonymized_userid>",1,4026,823,"Jesse Klaver (GL)",0.767734553775744,0.403233708966193,0
"<anonymized_userid>",1,4027,824,"Jesse Klaver (GL)",0.767925247902365,0.403723664870162,0
"<anonymized_userid>",1,4028,825,"Jesse Klaver (GL)",0.768115942028985,0.40421362077413,0
"<anonymized_userid>",1,4029,826,"Jesse Klaver (GL)",0.768306636155606,0.404703576678099,0
"<anonymized_userid>",1,4030,827,"Jesse Klaver (GL)",0.768497330282227,0.405193532582068,0
"<anonymized_userid>",1,4031,828,"Jesse Klaver (GL)",0.768688024408848,0.405683488486036,0
"<anonymized_userid>",1,4032,829,"Jesse Klaver (GL)",0.768878718535469,0.406173444390005,0
"<anonymized_userid>",1,4033,830,"Jesse Klaver (GL)",0.76906941266209,0.406663400293974,0
"<anonymized_userid>",1,4034,831,"Jesse Klaver (GL)",0.769260106788711,0.407153356197942,0
"<anonymized_userid>",1,4035,832,"Jesse Klaver (GL)",0.769450800915332,0.407643312101911,0
"<anonymized_userid>",1,4036,833,"Jesse Klaver (GL)",0.769641495041953,0.408133268005879,0
"<anonymized_userid>",1,4037,834,"Jesse Klaver (GL)",0.769832189168574,0.408623223909848,0
"<anonymized_userid>",1,4038,835,"Jesse Klaver (GL)",0.770022883295195,0.409113179813817,0
"<anonymized_userid>",1,4039,836,"Jesse Klaver (GL)",0.770213577421815,0.409603135717785,0
"<anonymized_userid>",1,4040,837,"Jesse Klaver (GL)",0.770404271548436,0.410093091621754,0
"<anonymized_userid>",1,4041,838,"Jesse Klaver (GL)",0.770594965675057,0.410583047525723,0
"<anonymized_userid>",1,4042,839,"Jesse Klaver (GL)",0.770785659801678,0.411073003429691,0
"<anonymized_userid>",1,4043,840,"Jesse Klaver (GL)",0.770976353928299,0.41156295933366,0
"<anonymized_userid>",1,4044,841,"Jesse Klaver (GL)",0.77116704805492,0.412052915237629,0
"<anonymized_userid>",1,4045,842,"Jesse Klaver (GL)",0.771357742181541,0.412542871141597,0
"<anonymized_userid>",1,4046,843,"Jesse Klaver (GL)",0.771548436308162,0.413032827045566,0
"<anonymized_userid>",1,4047,844,"Jesse Klaver (GL)",0.771739130434783,0.413522782949535,0
"<anonymized_userid>",1,4048,845,"Jesse Klaver (GL)",0.771929824561403,0.414012738853503,0
"<anonymized_userid>",1,4049,846,"Jesse Klaver (GL)",0.772120518688024,0.414502694757472,0
"<anonymized_userid>",1,4050,847,"Jesse Klaver (GL)",0.772311212814645,0.41499265066144,0
"<anonymized_userid>",1,4051,848,"Jesse Klaver (GL)",0.772501906941266,0.415482606565409,0
"<anonymized_userid>",1,4052,849,"Jesse Klaver (GL)",0.772692601067887,0.415972562469378,0
"<anonymized_userid>",1,4053,850,"Jesse Klaver (GL)",0.772883295194508,0.416462518373346,0
"<anonymized_userid>",1,4054,851,"Jesse Klaver (GL)",0.773073989321129,0.416952474277315,0
"<anonymized_userid>",1,4055,852,"Jesse Klaver (GL)",0.77326468344775,0.417442430181284,0
"<anonymized_userid>",1,4056,853,"Jesse Klaver (GL)",0.773455377574371,0.417932386085252,0
"<anonymized_userid>",1,4057,854,"Jesse Klaver (GL)",0.773646071700992,0.418422341989221,0
"<anonymized_userid>",1,4058,855,"Jesse Klaver (GL)",0.773836765827613,0.41891229789319,0
"<anonymized_userid>",1,4059,856,"Jesse Klaver (GL)",0.774027459954233,0.419402253797158,0
"<anonymized_userid>",1,4060,857,"Jesse Klaver (GL)",0.774218154080854,0.419892209701127,0
"<anonymized_userid>",1,4061,858,"Jesse Klaver (GL)",0.774408848207475,0.420382165605096,0
"<anonymized_userid>",1,4062,859,"Jesse Klaver (GL)",0.774599542334096,0.420872121509064,0
"<anonymized_userid>",1,4063,860,"Jesse Klaver (GL)",0.774790236460717,0.421362077413033,0
"<anonymized_userid>",1,4064,861,"Jesse Klaver (GL)",0.774980930587338,0.421852033317001,0
"<anonymized_userid>",1,4065,862,"Jesse Klaver (GL)",0.775171624713959,0.42234198922097,0
"<anonymized_userid>",1,4066,863,"Jesse Klaver (GL)",0.77536231884058,0.422831945124939,0
"<anonymized_userid>",1,4067,864,"Jesse Klaver (GL)",0.775553012967201,0.423321901028907,0
"<anonymized_userid>",1,4068,865,"Jesse Klaver (GL)",0.775743707093821,0.423811856932876,0
"<anonymized_userid>",1,4069,866,"Jesse Klaver (GL)",0.775934401220442,0.424301812836845,0
"<anonymized_userid>",1,4070,867,"Jesse Klaver (GL)",0.776125095347063,0.424791768740813,0
"<anonymized_userid>",1,4071,868,"Jesse Klaver (GL)",0.776315789473684,0.425281724644782,0
"<anonymized_userid>",1,4072,869,"Jesse Klaver (GL)",0.776506483600305,0.425771680548751,0
"<anonymized_userid>",1,4073,870,"Jesse Klaver (GL)",0.776697177726926,0.426261636452719,0
"<anonymized_userid>",1,4074,871,"Jesse Klaver (GL)",0.776887871853547,0.426751592356688,0
"<anonymized_userid>",1,4075,872,"Jesse Klaver (GL)",0.777078565980168,0.427241548260657,0
"<anonymized_userid>",1,4076,873,"Jesse Klaver (GL)",0.777269260106789,0.427731504164625,0
"<anonymized_userid>",1,4077,874,"Jesse Klaver (GL)",0.77745995423341,0.428221460068594,0
"<anonymized_userid>",1,4078,875,"Jesse Klaver (GL)",0.777650648360031,0.428711415972562,0
"<anonymized_userid>",1,4079,876,"Jesse Klaver (GL)",0.777841342486651,0.429201371876531,0
"<anonymized_userid>",1,4080,877,"Jesse Klaver (GL)",0.778032036613272,0.4296913277805,0
"<anonymized_userid>",1,4081,878,"Jesse Klaver (GL)",0.778222730739893,0.430181283684468,0
"<anonymized_userid>",1,4082,879,"Jesse Klaver (GL)",0.778413424866514,0.430671239588437,0
"<anonymized_userid>",1,4083,880,"Jesse Klaver (GL)",0.778604118993135,0.431161195492406,0
"<anonymized_userid>",1,4084,881,"Jesse Klaver (GL)",0.778794813119756,0.431651151396374,0
"<anonymized_userid>",1,4085,882,"Jesse Klaver (GL)",0.778985507246377,0.432141107300343,0
"<anonymized_userid>",1,4086,883,"Jesse Klaver (GL)",0.779176201372998,0.432631063204312,0
"<anonymized_userid>",1,4087,884,"Jesse Klaver (GL)",0.779366895499619,0.43312101910828,0
"<anonymized_userid>",1,4088,885,"Jesse Klaver (GL)",0.77955758962624,0.433610975012249,0
"<anonymized_userid>",1,4089,886,"Jesse Klaver (GL)",0.77974828375286,0.434100930916218,0
"<anonymized_userid>",1,4090,887,"Jesse Klaver (GL)",0.779938977879481,0.434590886820186,0
"<anonymized_userid>",1,4091,888,"Jesse Klaver (GL)",0.780129672006102,0.435080842724155,0
"<anonymized_userid>",1,4092,889,"Jesse Klaver (GL)",0.780320366132723,0.435570798628123,0
"<anonymized_userid>",1,4093,890,"Jesse Klaver (GL)",0.780511060259344,0.436060754532092,0
"<anonymized_userid>",1,4094,891,"Jesse Klaver (GL)",0.780701754385965,0.436550710436061,0
"<anonymized_userid>",1,4095,892,"Jesse Klaver (GL)",0.780892448512586,0.437040666340029,0
"<anonymized_userid>",1,4096,893,"Jesse Klaver (GL)",0.781083142639207,0.437530622243998,0
"<anonymized_userid>",1,4097,894,"Jesse Klaver (GL)",0.781273836765828,0.438020578147967,0
"<anonymized_userid>",1,4098,895,"Jesse Klaver (GL)",0.781464530892448,0.438510534051935,0
"<anonymized_userid>",1,4099,896,"Jesse Klaver (GL)",0.781655225019069,0.439000489955904,0
"<anonymized_userid>",1,4100,897,"Jesse Klaver (GL)",0.78184591914569,0.439490445859873,0
"<anonymized_userid>",1,4101,898,"Jesse Klaver (GL)",0.782036613272311,0.439980401763841,0
"<anonymized_userid>",1,4102,899,"Jesse Klaver (GL)",0.782227307398932,0.44047035766781,0
"<anonymized_userid>",1,4103,900,"Jesse Klaver (GL)",0.782418001525553,0.440960313571779,0
"<anonymized_userid>",1,4104,901,"Jesse Klaver (GL)",0.782608695652174,0.441450269475747,0
"<anonymized_userid>",1,4105,902,"Jesse Klaver (GL)",0.782799389778795,0.441940225379716,0
"<anonymized_userid>",1,4106,903,"Jesse Klaver (GL)",0.782990083905416,0.442430181283684,0
"<anonymized_userid>",1,4107,904,"Jesse Klaver (GL)",0.783180778032037,0.442920137187653,0
"<anonymized_userid>",1,4108,905,"Jesse Klaver (GL)",0.783371472158658,0.443410093091622,0
"<anonymized_userid>",1,4109,906,"Jesse Klaver (GL)",0.783562166285278,0.44390004899559,0
"<anonymized_userid>",1,4110,907,"Jesse Klaver (GL)",0.783752860411899,0.444390004899559,0
"<anonymized_userid>",1,4111,908,"Jesse Klaver (GL)",0.78394355453852,0.444879960803528,0
"<anonymized_userid>",1,4112,909,"Jesse Klaver (GL)",0.784134248665141,0.445369916707496,0
"<anonymized_userid>",1,4113,910,"Jesse Klaver (GL)",0.784324942791762,0.445859872611465,0
"<anonymized_userid>",1,4114,911,"Jesse Klaver (GL)",0.784515636918383,0.446349828515434,0
"<anonymized_userid>",1,4115,912,"Jesse Klaver (GL)",0.784706331045004,0.446839784419402,0
"<anonymized_userid>",1,4116,913,"Jesse Klaver (GL)",0.784897025171625,0.447329740323371,0
"<anonymized_userid>",1,4117,914,"Jesse Klaver (GL)",0.785087719298246,0.44781969622734,0
"<anonymized_userid>",1,4118,915,"Jesse Klaver (GL)",0.785278413424866,0.448309652131308,0
"<anonymized_userid>",1,4119,916,"Jesse Klaver (GL)",0.785469107551487,0.448799608035277,0
"<anonymized_userid>",1,4120,917,"Jesse Klaver (GL)",0.785659801678108,0.449289563939245,0
"<anonymized_userid>",1,4121,918,"Jesse Klaver (GL)",0.785850495804729,0.449779519843214,0
"<anonymized_userid>",1,4122,919,"Jesse Klaver (GL)",0.78604118993135,0.450269475747183,0
"<anonymized_userid>",1,4123,920,"Jesse Klaver (GL)",0.786231884057971,0.450759431651151,0
"<anonymized_userid>",1,4124,921,"Jesse Klaver (GL)",0.786422578184592,0.45124938755512,0
"<anonymized_userid>",1,4125,922,"Jesse Klaver (GL)",0.786613272311213,0.451739343459089,0
"<anonymized_userid>",1,4126,923,"Jesse Klaver (GL)",0.786803966437834,0.452229299363057,0
"<anonymized_userid>",1,4127,924,"Jesse Klaver (GL)",0.786994660564455,0.452719255267026,0
"<anonymized_userid>",1,4128,925,"Jesse Klaver (GL)",0.787185354691076,0.453209211170995,0
"<anonymized_userid>",1,4129,926,"Jesse Klaver (GL)",0.787376048817696,0.453699167074963,0
"<anonymized_userid>",1,4130,927,"Jesse Klaver (GL)",0.787566742944317,0.454189122978932,0
"<anonymized_userid>",1,4131,928,"Jesse Klaver (GL)",0.787757437070938,0.454679078882901,0
"<anonymized_userid>",1,4132,929,"Jesse Klaver (GL)",0.787948131197559,0.455169034786869,0
"<anonymized_userid>",1,4133,930,"Jesse Klaver (GL)",0.78813882532418,0.455658990690838,0
"<anonymized_userid>",1,4134,931,"Jesse Klaver (GL)",0.788329519450801,0.456148946594806,0
"<anonymized_userid>",1,4135,932,"Jesse Klaver (GL)",0.788520213577422,0.456638902498775,0
"<anonymized_userid>",1,4136,933,"Jesse Klaver (GL)",0.788710907704043,0.457128858402744,0
"<anonymized_userid>",1,4137,934,"Jesse Klaver (GL)",0.788901601830664,0.457618814306712,0
"<anonymized_userid>",1,4138,935,"Jesse Klaver (GL)",0.789092295957284,0.458108770210681,0
"<anonymized_userid>",1,4139,936,"Jesse Klaver (GL)",0.789282990083905,0.45859872611465,0
"<anonymized_userid>",1,4140,937,"Jesse Klaver (GL)",0.789473684210526,0.459088682018618,0
"<anonymized_userid>",1,4141,938,"Jesse Klaver (GL)",0.789664378337147,0.459578637922587,0
"<anonymized_userid>",1,4142,939,"Jesse Klaver (GL)",0.789855072463768,0.460068593826556,0
"<anonymized_userid>",1,4143,940,"Jesse Klaver (GL)",0.790045766590389,0.460558549730524,0
"<anonymized_userid>",1,4144,941,"Jesse Klaver (GL)",0.79023646071701,0.461048505634493,0
"<anonymized_userid>",1,4145,942,"Jesse Klaver (GL)",0.790427154843631,0.461538461538462,0
"<anonymized_userid>",1,4146,943,"Jesse Klaver (GL)",0.790617848970252,0.46202841744243,0
"<anonymized_userid>",1,4147,944,"Jesse Klaver (GL)",0.790808543096873,0.462518373346399,0
"<anonymized_userid>",1,4148,945,"Jesse Klaver (GL)",0.790999237223494,0.463008329250367,0
"<anonymized_userid>",1,4149,946,"Jesse Klaver (GL)",0.791189931350114,0.463498285154336,0
"<anonymized_userid>",1,4150,947,"Jesse Klaver (GL)",0.791380625476735,0.463988241058305,0
"<anonymized_userid>",1,4151,948,"Jesse Klaver (GL)",0.791571319603356,0.464478196962273,0
"<anonymized_userid>",1,4152,949,"Jesse Klaver (GL)",0.791762013729977,0.464968152866242,0
"<anonymized_userid>",1,4153,950,"Jesse Klaver (GL)",0.791952707856598,0.465458108770211,0
"<anonymized_userid>",1,4154,951,"Jesse Klaver (GL)",0.792143401983219,0.465948064674179,0
"<anonymized_userid>",1,4155,952,"Jesse Klaver (GL)",0.79233409610984,0.466438020578148,0
"<anonymized_userid>",1,4156,953,"Jesse Klaver (GL)",0.792524790236461,0.466927976482117,0
"<anonymized_userid>",1,4157,954,"Jesse Klaver (GL)",0.792715484363082,0.467417932386085,0
"<anonymized_userid>",1,4158,955,"Jesse Klaver (GL)",0.792906178489702,0.467907888290054,0
"<anonymized_userid>",1,4159,956,"Jesse Klaver (GL)",0.793096872616323,0.468397844194023,0
"<anonymized_userid>",1,4160,957,"Jesse Klaver (GL)",0.793287566742944,0.468887800097991,0
"<anonymized_userid>",1,4161,958,"Jesse Klaver (GL)",0.793478260869565,0.46937775600196,0
"<anonymized_userid>",1,4162,959,"Jesse Klaver (GL)",0.793668954996186,0.469867711905928,0
"<anonymized_userid>",1,4163,960,"Jesse Klaver (GL)",0.793859649122807,0.470357667809897,0
"<anonymized_userid>",1,4164,961,"Jesse Klaver (GL)",0.794050343249428,0.470847623713866,0
"<anonymized_userid>",1,4165,962,"Jesse Klaver (GL)",0.794241037376049,0.471337579617834,0
"<anonymized_userid>",1,4166,963,"Jesse Klaver (GL)",0.79443173150267,0.471827535521803,0
"<anonymized_userid>",1,4167,964,"Jesse Klaver (GL)",0.794622425629291,0.472317491425772,0
"<anonymized_userid>",1,4168,965,"Jesse Klaver (GL)",0.794813119755912,0.47280744732974,0
"<anonymized_userid>",1,4169,966,"Jesse Klaver (GL)",0.795003813882532,0.473297403233709,0
"<anonymized_userid>",1,4170,967,"Jesse Klaver (GL)",0.795194508009153,0.473787359137678,0
"<anonymized_userid>",1,4171,968,"Jesse Klaver (GL)",0.795385202135774,0.474277315041646,0
"<anonymized_userid>",1,4172,969,"Jesse Klaver (GL)",0.795575896262395,0.474767270945615,0
"<anonymized_userid>",1,4173,970,"Jesse Klaver (GL)",0.795766590389016,0.475257226849584,0
"<anonymized_userid>",1,4174,971,"Jesse Klaver (GL)",0.795957284515637,0.475747182753552,0
"<anonymized_userid>",1,4175,972,"Jesse Klaver (GL)",0.796147978642258,0.476237138657521,0
"<anonymized_userid>",1,4176,973,"Jesse Klaver (GL)",0.796338672768879,0.476727094561489,0
"<anonymized_userid>",1,4177,974,"Jesse Klaver (GL)",0.7965293668955,0.477217050465458,0
"<anonymized_userid>",1,4178,975,"Jesse Klaver (GL)",0.796720061022121,0.477707006369427,0
"<anonymized_userid>",1,4179,976,"Jesse Klaver (GL)",0.796910755148741,0.478196962273395,0
"<anonymized_userid>",1,4180,977,"Jesse Klaver (GL)",0.797101449275362,0.478686918177364,0
"<anonymized_userid>",1,4181,978,"Jesse Klaver (GL)",0.797292143401983,0.479176874081333,0
"<anonymized_userid>",1,4182,979,"Jesse Klaver (GL)",0.797482837528604,0.479666829985301,0
"<anonymized_userid>",1,4183,980,"Jesse Klaver (GL)",0.797673531655225,0.48015678588927,0
"<anonymized_userid>",1,4184,981,"Jesse Klaver (GL)",0.797864225781846,0.480646741793239,0
"<anonymized_userid>",1,4185,982,"Jesse Klaver (GL)",0.798054919908467,0.481136697697207,0
"<anonymized_userid>",1,4186,983,"Jesse Klaver (GL)",0.798245614035088,0.481626653601176,0
"<anonymized_userid>",1,4187,984,"Jesse Klaver (GL)",0.798436308161709,0.482116609505145,0
"<anonymized_userid>",1,4188,985,"Jesse Klaver (GL)",0.79862700228833,0.482606565409113,0
"<anonymized_userid>",1,4189,986,"Jesse Klaver (GL)",0.79881769641495,0.483096521313082,0
"<anonymized_userid>",1,4190,987,"Jesse Klaver (GL)",0.799008390541571,0.48358647721705,0
"<anonymized_userid>",1,4191,988,"Jesse Klaver (GL)",0.799199084668192,0.484076433121019,0
"<anonymized_userid>",1,4192,989,"Jesse Klaver (GL)",0.799389778794813,0.484566389024988,0
"<anonymized_userid>",1,4193,990,"Jesse Klaver (GL)",0.799580472921434,0.485056344928956,0
"<anonymized_userid>",1,4194,991,"Jesse Klaver (GL)",0.799771167048055,0.485546300832925,0
"<anonymized_userid>",1,4195,992,"Jesse Klaver (GL)",0.799961861174676,0.486036256736894,0
"<anonymized_userid>",1,4196,993,"Jesse Klaver (GL)",0.800152555301297,0.486526212640862,0
"<anonymized_userid>",1,4197,994,"Jesse Klaver (GL)",0.800343249427918,0.487016168544831,0
"<anonymized_userid>",1,4198,995,"Jesse Klaver (GL)",0.800533943554539,0.4875061244488,0
"<anonymized_userid>",1,4199,996,"Jesse Klaver (GL)",0.800724637681159,0.487996080352768,0
"<anonymized_userid>",1,4200,997,"Jesse Klaver (GL)",0.80091533180778,0.488486036256737,0
"<anonymized_userid>",1,4201,998,"Jesse Klaver (GL)",0.801106025934401,0.488975992160706,0
"<anonymized_userid>",1,4202,999,"Jesse Klaver (GL)",0.801296720061022,0.489465948064674,0
"<anonymized_userid>",1,4203,1000,"Jesse Klaver (GL)",0.801487414187643,0.489955903968643,0
"<anonymized_userid>",1,4204,1001,"Jesse Klaver (GL)",0.801678108314264,0.490445859872611,0
"<anonymized_userid>",1,4205,1002,"Jesse Klaver (GL)",0.801868802440885,0.49093581577658,0
"<anonymized_userid>",1,4206,1003,"Jesse Klaver (GL)",0.802059496567506,0.491425771680549,0
"<anonymized_userid>",1,4207,1004,"Jesse Klaver (GL)",0.802250190694127,0.491915727584517,0
"<anonymized_userid>",1,4208,1005,"Jesse Klaver (GL)",0.802440884820747,0.492405683488486,0
"<anonymized_userid>",1,4209,1006,"Jesse Klaver (GL)",0.802631578947368,0.492895639392455,0
"<anonymized_userid>",1,4210,1007,"Jesse Klaver (GL)",0.802822273073989,0.493385595296423,0
"<anonymized_userid>",1,4211,1008,"Jesse Klaver (GL)",0.80301296720061,0.493875551200392,0
"<anonymized_userid>",1,4212,1009,"Jesse Klaver (GL)",0.803203661327231,0.494365507104361,0
"<anonymized_userid>",1,4213,1010,"Jesse Klaver (GL)",0.803394355453852,0.494855463008329,0
"<anonymized_userid>",1,4214,1011,"Jesse Klaver (GL)",0.803585049580473,0.495345418912298,0
"<anonymized_userid>",1,4215,1012,"Jesse Klaver (GL)",0.803775743707094,0.495835374816267,0
"<anonymized_userid>",1,4216,1013,"Jesse Klaver (GL)",0.803966437833715,0.496325330720235,0
"<anonymized_userid>",1,4217,1014,"Jesse Klaver (GL)",0.804157131960336,0.496815286624204,0
"<anonymized_userid>",1,4218,1015,"Jesse Klaver (GL)",0.804347826086957,0.497305242528172,0
"<anonymized_userid>",1,4219,1016,"Jesse Klaver (GL)",0.804538520213577,0.497795198432141,0
"<anonymized_userid>",1,4220,1017,"Jesse Klaver (GL)",0.804729214340198,0.49828515433611,0
"<anonymized_userid>",1,4221,1018,"Jesse Klaver (GL)",0.804919908466819,0.498775110240078,0
"<anonymized_userid>",1,4222,1019,"Jesse Klaver (GL)",0.80511060259344,0.499265066144047,0
"<anonymized_userid>",1,4223,1020,"Jesse Klaver (GL)",0.805301296720061,0.499755022048016,0
"<anonymized_userid>",1,4224,1021,"Jesse Klaver (GL)",0.805491990846682,0.500244977951984,0
"<anonymized_userid>",1,4225,1022,"Jesse Klaver (GL)",0.805682684973303,0.500734933855953,0
"<anonymized_userid>",1,4226,1023,"Jesse Klaver (GL)",0.805873379099924,0.501224889759922,0
"<anonymized_userid>",1,4227,1024,"Jesse Klaver (GL)",0.806064073226545,0.50171484566389,0
"<anonymized_userid>",1,4228,1025,"Jesse Klaver (GL)",0.806254767353165,0.502204801567859,0
"<anonymized_userid>",1,4229,1026,"Jesse Klaver (GL)",0.806445461479786,0.502694757471828,0
"<anonymized_userid>",1,4230,1027,"Jesse Klaver (GL)",0.806636155606407,0.503184713375796,0
"<anonymized_userid>",1,4231,1028,"Jesse Klaver (GL)",0.806826849733028,0.503674669279765,0
"<anonymized_userid>",1,4232,1029,"Jesse Klaver (GL)",0.807017543859649,0.504164625183734,0
"<anonymized_userid>",1,4233,1030,"Jesse Klaver (GL)",0.80720823798627,0.504654581087702,0
"<anonymized_userid>",1,4234,1031,"Jesse Klaver (GL)",0.807398932112891,0.505144536991671,0
"<anonymized_userid>",1,4235,1032,"Jesse Klaver (GL)",0.807589626239512,0.505634492895639,0
"<anonymized_userid>",1,4236,1033,"Jesse Klaver (GL)",0.807780320366133,0.506124448799608,0
"<anonymized_userid>",1,4237,1034,"Jesse Klaver (GL)",0.807971014492754,0.506614404703577,0
"<anonymized_userid>",1,4238,1035,"Jesse Klaver (GL)",0.808161708619375,0.507104360607545,0
"<anonymized_userid>",1,4239,1036,"Jesse Klaver (GL)",0.808352402745995,0.507594316511514,0
"<anonymized_userid>",1,4240,1037,"Jesse Klaver (GL)",0.808543096872616,0.508084272415483,0
"<anonymized_userid>",1,4241,1038,"Jesse Klaver (GL)",0.808733790999237,0.508574228319451,0
"<anonymized_userid>",1,4242,1039,"Jesse Klaver (GL)",0.808924485125858,0.50906418422342,0
"<anonymized_userid>",1,4243,1040,"Jesse Klaver (GL)",0.809115179252479,0.509554140127389,0
"<anonymized_userid>",1,4244,1041,"Jesse Klaver (GL)",0.8093058733791,0.510044096031357,0
"<anonymized_userid>",1,4245,1042,"Jesse Klaver (GL)",0.809496567505721,0.510534051935326,0
"<anonymized_userid>",1,4246,1043,"Jesse Klaver (GL)",0.809687261632342,0.511024007839294,0
"<anonymized_userid>",1,4247,1044,"Jesse Klaver (GL)",0.809877955758963,0.511513963743263,0
"<anonymized_userid>",1,4248,1045,"Jesse Klaver (GL)",0.810068649885583,0.512003919647232,0
"<anonymized_userid>",1,4249,1046,"Jesse Klaver (GL)",0.810259344012204,0.5124938755512,0
"<anonymized_userid>",1,4250,1047,"Jesse Klaver (GL)",0.810450038138825,0.512983831455169,0
"<anonymized_userid>",1,4251,1048,"Jesse Klaver (GL)",0.810640732265446,0.513473787359138,0
"<anonymized_userid>",1,4252,1049,"Jesse Klaver (GL)",0.810831426392067,0.513963743263106,0
"<anonymized_userid>",1,4253,1050,"Jesse Klaver (GL)",0.811022120518688,0.514453699167075,0
"<anonymized_userid>",1,4254,1051,"Jesse Klaver (GL)",0.811212814645309,0.514943655071044,0
"<anonymized_userid>",1,4255,1052,"Jesse Klaver (GL)",0.81140350877193,0.515433610975012,0
"<anonymized_userid>",1,4256,1053,"Jesse Klaver (GL)",0.811594202898551,0.515923566878981,0
"<anonymized_userid>",1,4257,1054,"Jesse Klaver (GL)",0.811784897025172,0.516413522782949,0
"<anonymized_userid>",1,4258,1055,"Jesse Klaver (GL)",0.811975591151793,0.516903478686918,0
"<anonymized_userid>",1,4259,1056,"Jesse Klaver (GL)",0.812166285278413,0.517393434590887,0
"<anonymized_userid>",1,4260,1057,"Jesse Klaver (GL)",0.812356979405034,0.517883390494855,0
"<anonymized_userid>",1,4261,1058,"Jesse Klaver (GL)",0.812547673531655,0.518373346398824,0
"<anonymized_userid>",1,4262,1059,"Jesse Klaver (GL)",0.812738367658276,0.518863302302793,0
"<anonymized_userid>",1,4263,1060,"Jesse Klaver (GL)",0.812929061784897,0.519353258206761,0
"<anonymized_userid>",1,4264,1061,"Jesse Klaver (GL)",0.813119755911518,0.51984321411073,0
"<anonymized_userid>",1,4265,1062,"Jesse Klaver (GL)",0.813310450038139,0.520333170014699,0
"<anonymized_userid>",1,4266,1063,"Jesse Klaver (GL)",0.81350114416476,0.520823125918667,0
"<anonymized_userid>",1,4267,1064,"Jesse Klaver (GL)",0.813691838291381,0.521313081822636,0
"<anonymized_userid>",1,4268,1065,"Jesse Klaver (GL)",0.813882532418002,0.521803037726605,0
"<anonymized_userid>",1,4269,1066,"Jesse Klaver (GL)",0.814073226544622,0.522292993630573,0
"<anonymized_userid>",1,4270,1067,"Jesse Klaver (GL)",0.814263920671243,0.522782949534542,0
"<anonymized_userid>",1,4271,1068,"Jesse Klaver (GL)",0.814454614797864,0.523272905438511,0
"<anonymized_userid>",1,4272,1069,"Jesse Klaver (GL)",0.814645308924485,0.523762861342479,0
"<anonymized_userid>",1,4273,1070,"Jesse Klaver (GL)",0.814836003051106,0.524252817246448,0
"<anonymized_userid>",1,4274,1071,"Jesse Klaver (GL)",0.815026697177727,0.524742773150417,0
"<anonymized_userid>",1,4275,1072,"Jesse Klaver (GL)",0.815217391304348,0.525232729054385,0
"<anonymized_userid>",1,4276,1073,"Jesse Klaver (GL)",0.815408085430969,0.525722684958354,0
"<anonymized_userid>",1,4277,1074,"Jesse Klaver (GL)",0.81559877955759,0.526212640862322,0
"<anonymized_userid>",1,4278,1075,"Jesse Klaver (GL)",0.815789473684211,0.526702596766291,0
"<anonymized_userid>",1,4279,1076,"Jesse Klaver (GL)",0.815980167810831,0.52719255267026,0
"<anonymized_userid>",1,4280,1077,"Jesse Klaver (GL)",0.816170861937452,0.527682508574228,0
"<anonymized_userid>",1,4281,1078,"Jesse Klaver (GL)",0.816361556064073,0.528172464478197,0
"<anonymized_userid>",1,4282,1079,"Jesse Klaver (GL)",0.816552250190694,0.528662420382166,0
"<anonymized_userid>",1,4283,1080,"Jesse Klaver (GL)",0.816742944317315,0.529152376286134,0
"<anonymized_userid>",1,4284,1081,"Jesse Klaver (GL)",0.816933638443936,0.529642332190103,0
"<anonymized_userid>",1,4285,1082,"Jesse Klaver (GL)",0.817124332570557,0.530132288094072,0
"<anonymized_userid>",1,4286,1083,"Jesse Klaver (GL)",0.817315026697178,0.53062224399804,0
"<anonymized_userid>",1,4287,1084,"Jesse Klaver (GL)",0.817505720823799,0.531112199902009,0
"<anonymized_userid>",1,4288,1085,"Jesse Klaver (GL)",0.81769641495042,0.531602155805977,0
"<anonymized_userid>",1,4289,1086,"Jesse Klaver (GL)",0.81788710907704,0.532092111709946,0
"<anonymized_userid>",1,4290,1087,"Jesse Klaver (GL)",0.818077803203661,0.532582067613915,0
"<anonymized_userid>",1,4291,1088,"Jesse Klaver (GL)",0.818268497330282,0.533072023517883,0
"<anonymized_userid>",1,4292,1089,"Jesse Klaver (GL)",0.818459191456903,0.533561979421852,0
"<anonymized_userid>",1,4293,1090,"Jesse Klaver (GL)",0.818649885583524,0.534051935325821,0
"<anonymized_userid>",1,4294,1091,"Jesse Klaver (GL)",0.818840579710145,0.534541891229789,0
"<anonymized_userid>",1,4295,1092,"Jesse Klaver (GL)",0.819031273836766,0.535031847133758,0
"<anonymized_userid>",1,4296,1093,"Jesse Klaver (GL)",0.819221967963387,0.535521803037727,0
"<anonymized_userid>",1,4297,1094,"Jesse Klaver (GL)",0.819412662090008,0.536011758941695,0
"<anonymized_userid>",1,4298,1095,"Jesse Klaver (GL)",0.819603356216628,0.536501714845664,0
"<anonymized_userid>",1,4299,1096,"Jesse Klaver (GL)",0.819794050343249,0.536991670749632,0
"<anonymized_userid>",1,4300,1097,"Jesse Klaver (GL)",0.81998474446987,0.537481626653601,0
"<anonymized_userid>",1,4301,1098,"Jesse Klaver (GL)",0.820175438596491,0.53797158255757,0
"<anonymized_userid>",1,4302,1099,"Jesse Klaver (GL)",0.820366132723112,0.538461538461538,0
"<anonymized_userid>",1,4303,1100,"Jesse Klaver (GL)",0.820556826849733,0.538951494365507,0
"<anonymized_userid>",1,4304,1101,"Jesse Klaver (GL)",0.820747520976354,0.539441450269476,0
"<anonymized_userid>",1,4305,1102,"Jesse Klaver (GL)",0.820938215102975,0.539931406173444,0
"<anonymized_userid>",1,4306,1103,"Jesse Klaver (GL)",0.821128909229596,0.540421362077413,0
"<anonymized_userid>",1,4307,1104,"Jesse Klaver (GL)",0.821319603356217,0.540911317981382,0
"<anonymized_userid>",1,4308,1105,"Jesse Klaver (GL)",0.821510297482838,0.54140127388535,0
"<anonymized_userid>",1,4309,1106,"Jesse Klaver (GL)",0.821700991609458,0.541891229789319,0
"<anonymized_userid>",1,4310,1107,"Jesse Klaver (GL)",0.821891685736079,0.542381185693288,0
"<anonymized_userid>",1,4311,1108,"Jesse Klaver (GL)",0.8220823798627,0.542871141597256,0
"<anonymized_userid>",1,4312,1109,"Jesse Klaver (GL)",0.822273073989321,0.543361097501225,0
"<anonymized_userid>",1,4313,1110,"Jesse Klaver (GL)",0.822463768115942,0.543851053405194,0
"<anonymized_userid>",1,4314,1111,"Jesse Klaver (GL)",0.822654462242563,0.544341009309162,0
"<anonymized_userid>",1,4315,1112,"Jesse Klaver (GL)",0.822845156369184,0.544830965213131,0
"<anonymized_userid>",1,4316,1113,"Jesse Klaver (GL)",0.823035850495805,0.5453209211171,0
"<anonymized_userid>",1,4317,1114,"Jesse Klaver (GL)",0.823226544622426,0.545810877021068,0
"<anonymized_userid>",1,4318,1115,"Jesse Klaver (GL)",0.823417238749046,0.546300832925037,0
"<anonymized_userid>",1,4319,1116,"Jesse Klaver (GL)",0.823607932875667,0.546790788829005,0
"<anonymized_userid>",1,4320,1117,"Jesse Klaver (GL)",0.823798627002288,0.547280744732974,0
"<anonymized_userid>",1,4321,1118,"Jesse Klaver (GL)",0.823989321128909,0.547770700636943,0
"<anonymized_userid>",1,4322,1119,"Jesse Klaver (GL)",0.82418001525553,0.548260656540911,0
"<anonymized_userid>",1,4323,1120,"Jesse Klaver (GL)",0.824370709382151,0.54875061244488,0
"<anonymized_userid>",1,4324,1121,"Jesse Klaver (GL)",0.824561403508772,0.549240568348849,0
"<anonymized_userid>",1,4325,1122,"Jesse Klaver (GL)",0.824752097635393,0.549730524252817,0
"<anonymized_userid>",1,4326,1123,"Jesse Klaver (GL)",0.824942791762014,0.550220480156786,0
"<anonymized_userid>",1,4327,1124,"Jesse Klaver (GL)",0.825133485888635,0.550710436060755,0
"<anonymized_userid>",1,4328,1125,"Jesse Klaver (GL)",0.825324180015256,0.551200391964723,0
"<anonymized_userid>",1,4329,1126,"Jesse Klaver (GL)",0.825514874141876,0.551690347868692,0
"<anonymized_userid>",1,4330,1127,"Jesse Klaver (GL)",0.825705568268497,0.55218030377266,0
"<anonymized_userid>",1,4331,1128,"Jesse Klaver (GL)",0.825896262395118,0.552670259676629,0
"<anonymized_userid>",1,4332,1129,"Jesse Klaver (GL)",0.826086956521739,0.553160215580598,0
"<anonymized_userid>",1,4333,1130,"Jesse Klaver (GL)",0.82627765064836,0.553650171484566,0
"<anonymized_userid>",1,4334,1131,"Jesse Klaver (GL)",0.826468344774981,0.554140127388535,0
"<anonymized_userid>",1,4335,1132,"Jesse Klaver (GL)",0.826659038901602,0.554630083292504,0
"<anonymized_userid>",1,4336,1133,"Jesse Klaver (GL)",0.826849733028223,0.555120039196472,0
"<anonymized_userid>",1,4337,1134,"Jesse Klaver (GL)",0.827040427154844,0.555609995100441,0
"<anonymized_userid>",1,4338,1135,"Jesse Klaver (GL)",0.827231121281464,0.55609995100441,0
"<anonymized_userid>",1,4339,1136,"Jesse Klaver (GL)",0.827421815408085,0.556589906908378,0
"<anonymized_userid>",1,4340,1137,"Jesse Klaver (GL)",0.827612509534706,0.557079862812347,0
"<anonymized_userid>",1,4341,1138,"Jesse Klaver (GL)",0.827803203661327,0.557569818716316,0
"<anonymized_userid>",1,4342,1139,"Jesse Klaver (GL)",0.827993897787948,0.558059774620284,0
"<anonymized_userid>",1,4343,1140,"Jesse Klaver (GL)",0.828184591914569,0.558549730524253,0
"<anonymized_userid>",1,4344,1141,"Jesse Klaver (GL)",0.82837528604119,0.559039686428221,0
"<anonymized_userid>",1,4345,1142,"Jesse Klaver (GL)",0.828565980167811,0.55952964233219,0
"<anonymized_userid>",1,4346,1143,"Jesse Klaver (GL)",0.828756674294432,0.560019598236159,0
"<anonymized_userid>",1,4347,1144,"Jesse Klaver (GL)",0.828947368421053,0.560509554140127,0
"<anonymized_userid>",1,4348,1145,"Jesse Klaver (GL)",0.829138062547674,0.560999510044096,0
"<anonymized_userid>",1,4349,1146,"Jesse Klaver (GL)",0.829328756674294,0.561489465948065,0
"<anonymized_userid>",1,4350,1147,"Jesse Klaver (GL)",0.829519450800915,0.561979421852033,0
"<anonymized_userid>",1,4351,1148,"Jesse Klaver (GL)",0.829710144927536,0.562469377756002,0
"<anonymized_userid>",1,4352,1149,"Jesse Klaver (GL)",0.829900839054157,0.562959333659971,0
"<anonymized_userid>",1,4353,1150,"Jesse Klaver (GL)",0.830091533180778,0.563449289563939,0
"<anonymized_userid>",1,4354,1151,"Jesse Klaver (GL)",0.830282227307399,0.563939245467908,0
"<anonymized_userid>",1,4355,1152,"Jesse Klaver (GL)",0.83047292143402,0.564429201371877,0
"<anonymized_userid>",1,4356,1153,"Jesse Klaver (GL)",0.830663615560641,0.564919157275845,0
"<anonymized_userid>",1,4357,1154,"Jesse Klaver (GL)",0.830854309687262,0.565409113179814,0
"<anonymized_userid>",1,4358,1155,"Jesse Klaver (GL)",0.831045003813883,0.565899069083783,0
"<anonymized_userid>",1,4359,1156,"Jesse Klaver (GL)",0.831235697940503,0.566389024987751,0
"<anonymized_userid>",1,4360,1157,"Jesse Klaver (GL)",0.831426392067124,0.56687898089172,0
"<anonymized_userid>",1,4361,1158,"Jesse Klaver (GL)",0.831617086193745,0.567368936795688,0
"<anonymized_userid>",1,4362,1159,"Jesse Klaver (GL)",0.831807780320366,0.567858892699657,0
"<anonymized_userid>",1,4363,1160,"Jesse Klaver (GL)",0.831998474446987,0.568348848603626,0
"<anonymized_userid>",1,4364,1161,"Jesse Klaver (GL)",0.832189168573608,0.568838804507594,0
"<anonymized_userid>",1,4365,1162,"Jesse Klaver (GL)",0.832379862700229,0.569328760411563,0
"<anonymized_userid>",1,4366,1163,"Jesse Klaver (GL)",0.83257055682685,0.569818716315532,0
"<anonymized_userid>",1,4367,1164,"Jesse Klaver (GL)",0.832761250953471,0.5703086722195,0
"<anonymized_userid>",1,4368,1165,"Jesse Klaver (GL)",0.832951945080092,0.570798628123469,0
"<anonymized_userid>",1,4369,1166,"Jesse Klaver (GL)",0.833142639206712,0.571288584027438,0
"<anonymized_userid>",1,4370,1167,"Jesse Klaver (GL)",0.833333333333333,0.571778539931406,0
"<anonymized_userid>",1,4371,1168,"Jesse Klaver (GL)",0.833524027459954,0.572268495835375,0
"<anonymized_userid>",1,4372,1169,"Jesse Klaver (GL)",0.833714721586575,0.572758451739343,0
"<anonymized_userid>",1,4373,1170,"Jesse Klaver (GL)",0.833905415713196,0.573248407643312,0
"<anonymized_userid>",1,4374,1171,"Jesse Klaver (GL)",0.834096109839817,0.573738363547281,0
"<anonymized_userid>",1,4375,1172,"Jesse Klaver (GL)",0.834286803966438,0.574228319451249,0
"<anonymized_userid>",1,4376,1173,"Jesse Klaver (GL)",0.834477498093059,0.574718275355218,0
"<anonymized_userid>",1,4377,1174,"Jesse Klaver (GL)",0.83466819221968,0.575208231259187,0
"<anonymized_userid>",1,4378,1175,"Jesse Klaver (GL)",0.834858886346301,0.575698187163155,0
"<anonymized_userid>",1,4379,1176,"Jesse Klaver (GL)",0.835049580472921,0.576188143067124,0
"<anonymized_userid>",1,4380,1177,"Jesse Klaver (GL)",0.835240274599542,0.576678098971093,0
"<anonymized_userid>",1,4381,1178,"Jesse Klaver (GL)",0.835430968726163,0.577168054875061,0
"<anonymized_userid>",1,4382,1179,"Jesse Klaver (GL)",0.835621662852784,0.57765801077903,0
"<anonymized_userid>",1,4383,1180,"Jesse Klaver (GL)",0.835812356979405,0.578147966682999,0
"<anonymized_userid>",1,4384,1181,"Jesse Klaver (GL)",0.836003051106026,0.578637922586967,0
"<anonymized_userid>",1,4385,1182,"Jesse Klaver (GL)",0.836193745232647,0.579127878490936,0
"<anonymized_userid>",1,4386,1183,"Jesse Klaver (GL)",0.836384439359268,0.579617834394904,0
"<anonymized_userid>",1,4387,1184,"Jesse Klaver (GL)",0.836575133485889,0.580107790298873,0
"<anonymized_userid>",1,4388,1185,"Jesse Klaver (GL)",0.83676582761251,0.580597746202842,0
"<anonymized_userid>",1,4389,1186,"Jesse Klaver (GL)",0.83695652173913,0.58108770210681,0
"<anonymized_userid>",1,4390,1187,"Jesse Klaver (GL)",0.837147215865751,0.581577658010779,0
"<anonymized_userid>",1,4391,1188,"Jesse Klaver (GL)",0.837337909992372,0.582067613914748,0
"<anonymized_userid>",1,4392,1189,"Jesse Klaver (GL)",0.837528604118993,0.582557569818716,0
"<anonymized_userid>",1,4393,1190,"Jesse Klaver (GL)",0.837719298245614,0.583047525722685,0
"<anonymized_userid>",1,4394,1191,"Jesse Klaver (GL)",0.837909992372235,0.583537481626654,0
"<anonymized_userid>",1,4395,1192,"Jesse Klaver (GL)",0.838100686498856,0.584027437530622,0
"<anonymized_userid>",1,4396,1193,"Jesse Klaver (GL)",0.838291380625477,0.584517393434591,0
"<anonymized_userid>",1,4397,1194,"Jesse Klaver (GL)",0.838482074752098,0.58500734933856,0
"<anonymized_userid>",1,4398,1195,"Jesse Klaver (GL)",0.838672768878719,0.585497305242528,0
"<anonymized_userid>",1,4399,1196,"Jesse Klaver (GL)",0.838863463005339,0.585987261146497,0
"<anonymized_userid>",1,4400,1197,"Jesse Klaver (GL)",0.83905415713196,0.586477217050465,0
"<anonymized_userid>",1,4401,1198,"Jesse Klaver (GL)",0.839244851258581,0.586967172954434,0
"<anonymized_userid>",1,4402,1199,"Jesse Klaver (GL)",0.839435545385202,0.587457128858403,0
"<anonymized_userid>",1,4403,1200,"Jesse Klaver (GL)",0.839626239511823,0.587947084762371,0
"<anonymized_userid>",1,4404,1201,"Jesse Klaver (GL)",0.839816933638444,0.58843704066634,0
"<anonymized_userid>",1,4405,1202,"Jesse Klaver (GL)",0.840007627765065,0.588926996570309,0
"<anonymized_userid>",1,4406,1203,"Jesse Klaver (GL)",0.840198321891686,0.589416952474277,0
"<anonymized_userid>",1,4407,1204,"Jesse Klaver (GL)",0.840389016018307,0.589906908378246,0
"<anonymized_userid>",1,4408,1205,"Jesse Klaver (GL)",0.840579710144927,0.590396864282215,0
"<anonymized_userid>",1,4409,1206,"Jesse Klaver (GL)",0.840770404271548,0.590886820186183,0
"<anonymized_userid>",1,4410,1207,"Jesse Klaver (GL)",0.840961098398169,0.591376776090152,0
"<anonymized_userid>",1,4411,1208,"Jesse Klaver (GL)",0.84115179252479,0.591866731994121,0
"<anonymized_userid>",1,4412,1209,"Jesse Klaver (GL)",0.841342486651411,0.592356687898089,0
"<anonymized_userid>",1,4413,1210,"Jesse Klaver (GL)",0.841533180778032,0.592846643802058,0
"<anonymized_userid>",1,4414,1211,"Jesse Klaver (GL)",0.841723874904653,0.593336599706026,0
"<anonymized_userid>",1,4415,1212,"Jesse Klaver (GL)",0.841914569031274,0.593826555609995,0
"<anonymized_userid>",1,4416,1213,"Jesse Klaver (GL)",0.842105263157895,0.594316511513964,0
"<anonymized_userid>",1,4417,1214,"Jesse Klaver (GL)",0.842295957284516,0.594806467417932,0
"<anonymized_userid>",1,4418,1215,"Jesse Klaver (GL)",0.842486651411137,0.595296423321901,0
"<anonymized_userid>",1,4419,1216,"Jesse Klaver (GL)",0.842677345537757,0.59578637922587,0
"<anonymized_userid>",1,4420,1217,"Jesse Klaver (GL)",0.842868039664378,0.596276335129838,0
"<anonymized_userid>",1,4421,1218,"Jesse Klaver (GL)",0.843058733790999,0.596766291033807,0
"<anonymized_userid>",1,4422,1219,"Jesse Klaver (GL)",0.84324942791762,0.597256246937776,0
"<anonymized_userid>",1,4423,1220,"Jesse Klaver (GL)",0.843440122044241,0.597746202841744,0
"<anonymized_userid>",1,4424,1221,"Jesse Klaver (GL)",0.843630816170862,0.598236158745713,0
"<anonymized_userid>",1,4425,1222,"Jesse Klaver (GL)",0.843821510297483,0.598726114649682,0
"<anonymized_userid>",1,4426,1223,"Jesse Klaver (GL)",0.844012204424104,0.59921607055365,0
"<anonymized_userid>",1,4427,1224,"Jesse Klaver (GL)",0.844202898550725,0.599706026457619,0
"<anonymized_userid>",1,4428,1225,"Jesse Klaver (GL)",0.844393592677345,0.600195982361587,0
"<anonymized_userid>",1,4429,1226,"Jesse Klaver (GL)",0.844584286803966,0.600685938265556,0
"<anonymized_userid>",1,4430,1227,"Jesse Klaver (GL)",0.844774980930587,0.601175894169525,0
"<anonymized_userid>",1,4431,1228,"Jesse Klaver (GL)",0.844965675057208,0.601665850073493,0
"<anonymized_userid>",1,4432,1229,"Jesse Klaver (GL)",0.845156369183829,0.602155805977462,0
"<anonymized_userid>",1,4433,1230,"Jesse Klaver (GL)",0.84534706331045,0.602645761881431,0
"<anonymized_userid>",1,4434,1231,"Jesse Klaver (GL)",0.845537757437071,0.603135717785399,0
"<anonymized_userid>",1,4435,1232,"Jesse Klaver (GL)",0.845728451563692,0.603625673689368,0
"<anonymized_userid>",1,4436,1233,"Jesse Klaver (GL)",0.845919145690313,0.604115629593337,0
"<anonymized_userid>",1,4437,1234,"Jesse Klaver (GL)",0.846109839816934,0.604605585497305,0
"<anonymized_userid>",1,4438,1235,"Jesse Klaver (GL)",0.846300533943555,0.605095541401274,0
"<anonymized_userid>",1,4439,1236,"Jesse Klaver (GL)",0.846491228070175,0.605585497305243,0
"<anonymized_userid>",1,4440,1237,"Jesse Klaver (GL)",0.846681922196796,0.606075453209211,0
"<anonymized_userid>",1,4441,1238,"Jesse Klaver (GL)",0.846872616323417,0.60656540911318,0
"<anonymized_userid>",1,4442,1239,"Jesse Klaver (GL)",0.847063310450038,0.607055365017148,0
"<anonymized_userid>",1,4443,1240,"Jesse Klaver (GL)",0.847254004576659,0.607545320921117,0
"<anonymized_userid>",1,4444,1241,"Jesse Klaver (GL)",0.84744469870328,0.608035276825086,0
"<anonymized_userid>",1,4445,1242,"Jesse Klaver (GL)",0.847635392829901,0.608525232729054,0
"<anonymized_userid>",1,4446,1243,"Jesse Klaver (GL)",0.847826086956522,0.609015188633023,0
"<anonymized_userid>",1,4447,1244,"Jesse Klaver (GL)",0.848016781083143,0.609505144536992,0
"<anonymized_userid>",1,4448,1245,"Jesse Klaver (GL)",0.848207475209764,0.60999510044096,0
"<anonymized_userid>",1,4449,1246,"Jesse Klaver (GL)",0.848398169336384,0.610485056344929,0
"<anonymized_userid>",1,4450,1247,"Jesse Klaver (GL)",0.848588863463005,0.610975012248898,0
"<anonymized_userid>",1,4451,1248,"Jesse Klaver (GL)",0.848779557589626,0.611464968152866,0
"<anonymized_userid>",1,4452,1249,"Jesse Klaver (GL)",0.848970251716247,0.611954924056835,0
"<anonymized_userid>",1,4453,1250,"Jesse Klaver (GL)",0.849160945842868,0.612444879960804,0
"<anonymized_userid>",1,4454,1251,"Jesse Klaver (GL)",0.849351639969489,0.612934835864772,0
"<anonymized_userid>",1,4455,1252,"Jesse Klaver (GL)",0.84954233409611,0.613424791768741,0
"<anonymized_userid>",1,4456,1253,"Jesse Klaver (GL)",0.849733028222731,0.613914747672709,0
"<anonymized_userid>",1,4457,1254,"Jesse Klaver (GL)",0.849923722349352,0.614404703576678,0
"<anonymized_userid>",1,4458,1255,"Jesse Klaver (GL)",0.850114416475973,0.614894659480647,0
"<anonymized_userid>",1,4459,1256,"Jesse Klaver (GL)",0.850305110602593,0.615384615384615,0
"<anonymized_userid>",1,4460,1257,"Jesse Klaver (GL)",0.850495804729214,0.615874571288584,0
"<anonymized_userid>",1,4461,1258,"Jesse Klaver (GL)",0.850686498855835,0.616364527192553,0
"<anonymized_userid>",1,4462,1259,"Jesse Klaver (GL)",0.850877192982456,0.616854483096521,0
"<anonymized_userid>",1,4463,1260,"Jesse Klaver (GL)",0.851067887109077,0.61734443900049,0
"<anonymized_userid>",1,4464,1261,"Jesse Klaver (GL)",0.851258581235698,0.617834394904459,0
"<anonymized_userid>",1,4465,1262,"Jesse Klaver (GL)",0.851449275362319,0.618324350808427,0
"<anonymized_userid>",1,4466,1263,"Jesse Klaver (GL)",0.85163996948894,0.618814306712396,0
"<anonymized_userid>",1,4467,1264,"Jesse Klaver (GL)",0.851830663615561,0.619304262616365,0
"<anonymized_userid>",1,4468,1265,"Jesse Klaver (GL)",0.852021357742182,0.619794218520333,0
"<anonymized_userid>",1,4469,1266,"Jesse Klaver (GL)",0.852212051868802,0.620284174424302,0
"<anonymized_userid>",1,4470,1267,"Jesse Klaver (GL)",0.852402745995423,0.62077413032827,0
"<anonymized_userid>",1,4471,1268,"Jesse Klaver (GL)",0.852593440122044,0.621264086232239,0
"<anonymized_userid>",1,4472,1269,"Jesse Klaver (GL)",0.852784134248665,0.621754042136208,0
"<anonymized_userid>",1,4473,1270,"Jesse Klaver (GL)",0.852974828375286,0.622243998040176,0
"<anonymized_userid>",1,4474,1271,"Jesse Klaver (GL)",0.853165522501907,0.622733953944145,0
"<anonymized_userid>",1,4475,1272,"Jesse Klaver (GL)",0.853356216628528,0.623223909848114,0
"<anonymized_userid>",1,4476,1273,"Jesse Klaver (GL)",0.853546910755149,0.623713865752082,0
"<anonymized_userid>",1,4477,1274,"Jesse Klaver (GL)",0.85373760488177,0.624203821656051,0
"<anonymized_userid>",1,4478,1275,"Jesse Klaver (GL)",0.853928299008391,0.62469377756002,0
"<anonymized_userid>",1,4479,1276,"Jesse Klaver (GL)",0.854118993135011,0.625183733463988,0
"<anonymized_userid>",1,4480,1277,"Jesse Klaver (GL)",0.854309687261632,0.625673689367957,0
"<anonymized_userid>",1,4481,1278,"Jesse Klaver (GL)",0.854500381388253,0.626163645271925,0
"<anonymized_userid>",1,4482,1279,"Jesse Klaver (GL)",0.854691075514874,0.626653601175894,0
"<anonymized_userid>",1,4483,1280,"Jesse Klaver (GL)",0.854881769641495,0.627143557079863,0
"<anonymized_userid>",1,4484,1281,"Jesse Klaver (GL)",0.855072463768116,0.627633512983831,0
"<anonymized_userid>",1,4485,1282,"Jesse Klaver (GL)",0.855263157894737,0.6281234688878,0
"<anonymized_userid>",1,4486,1283,"Jesse Klaver (GL)",0.855453852021358,0.628613424791769,0
"<anonymized_userid>",1,4487,1284,"Jesse Klaver (GL)",0.855644546147979,0.629103380695737,0
"<anonymized_userid>",1,4488,1285,"Jesse Klaver (GL)",0.8558352402746,0.629593336599706,0
"<anonymized_userid>",1,4489,1286,"Jesse Klaver (GL)",0.85602593440122,0.630083292503675,0
"<anonymized_userid>",1,4490,1287,"Jesse Klaver (GL)",0.856216628527841,0.630573248407643,0
"<anonymized_userid>",1,4491,1288,"Jesse Klaver (GL)",0.856407322654462,0.631063204311612,0
"<anonymized_userid>",1,4492,1289,"Jesse Klaver (GL)",0.856598016781083,0.631553160215581,0
"<anonymized_userid>",1,4493,1290,"Jesse Klaver (GL)",0.856788710907704,0.632043116119549,0
"<anonymized_userid>",1,4494,1291,"Jesse Klaver (GL)",0.856979405034325,0.632533072023518,0
"<anonymized_userid>",1,4495,1292,"Jesse Klaver (GL)",0.857170099160946,0.633023027927487,0
"<anonymized_userid>",1,4496,1293,"Jesse Klaver (GL)",0.857360793287567,0.633512983831455,0
"<anonymized_userid>",1,4497,1294,"Jesse Klaver (GL)",0.857551487414188,0.634002939735424,0
"<anonymized_userid>",1,4498,1295,"Jesse Klaver (GL)",0.857742181540809,0.634492895639392,0
"<anonymized_userid>",1,4499,1296,"Jesse Klaver (GL)",0.857932875667429,0.634982851543361,0
"<anonymized_userid>",1,4500,1297,"Jesse Klaver (GL)",0.85812356979405,0.63547280744733,0
"<anonymized_userid>",1,4501,1298,"Jesse Klaver (GL)",0.858314263920671,0.635962763351298,0
"<anonymized_userid>",1,4502,1299,"Jesse Klaver (GL)",0.858504958047292,0.636452719255267,0
"<anonymized_userid>",1,4503,1300,"Jesse Klaver (GL)",0.858695652173913,0.636942675159236,0
"<anonymized_userid>",1,4504,1301,"Jesse Klaver (GL)",0.858886346300534,0.637432631063204,0
"<anonymized_userid>",1,4505,1302,"Jesse Klaver (GL)",0.859077040427155,0.637922586967173,0
"<anonymized_userid>",1,4506,1303,"Jesse Klaver (GL)",0.859267734553776,0.638412542871142,0
"<anonymized_userid>",1,4507,1304,"Jesse Klaver (GL)",0.859458428680397,0.63890249877511,0
"<anonymized_userid>",1,4508,1305,"Jesse Klaver (GL)",0.859649122807018,0.639392454679079,0
"<anonymized_userid>",1,4509,1306,"Jesse Klaver (GL)",0.859839816933638,0.639882410583048,0
"<anonymized_userid>",1,4510,1307,"Jesse Klaver (GL)",0.860030511060259,0.640372366487016,0
"<anonymized_userid>",1,4511,1308,"Jesse Klaver (GL)",0.86022120518688,0.640862322390985,0
"<anonymized_userid>",1,4512,1309,"Jesse Klaver (GL)",0.860411899313501,0.641352278294953,0
"<anonymized_userid>",1,4513,1310,"Jesse Klaver (GL)",0.860602593440122,0.641842234198922,0
"<anonymized_userid>",1,4514,1311,"Jesse Klaver (GL)",0.860793287566743,0.642332190102891,0
"<anonymized_userid>",1,4515,1312,"Jesse Klaver (GL)",0.860983981693364,0.642822146006859,0
"<anonymized_userid>",1,4516,1313,"Jesse Klaver (GL)",0.861174675819985,0.643312101910828,0
"<anonymized_userid>",1,4517,1314,"Jesse Klaver (GL)",0.861365369946606,0.643802057814797,0
"<anonymized_userid>",1,4518,1315,"Jesse Klaver (GL)",0.861556064073226,0.644292013718765,0
"<anonymized_userid>",1,4519,1316,"Jesse Klaver (GL)",0.861746758199847,0.644781969622734,0
"<anonymized_userid>",1,4520,1317,"Jesse Klaver (GL)",0.861937452326468,0.645271925526703,0
"<anonymized_userid>",1,4521,1318,"Jesse Klaver (GL)",0.862128146453089,0.645761881430671,0
"<anonymized_userid>",1,4522,1319,"Jesse Klaver (GL)",0.86231884057971,0.64625183733464,0
"<anonymized_userid>",1,4523,1320,"Jesse Klaver (GL)",0.862509534706331,0.646741793238608,0
"<anonymized_userid>",1,4524,1321,"Jesse Klaver (GL)",0.862700228832952,0.647231749142577,0
"<anonymized_userid>",1,4525,1322,"Jesse Klaver (GL)",0.862890922959573,0.647721705046546,0
"<anonymized_userid>",1,4526,1323,"Jesse Klaver (GL)",0.863081617086194,0.648211660950514,0
"<anonymized_userid>",1,4527,1324,"Jesse Klaver (GL)",0.863272311212815,0.648701616854483,0
"<anonymized_userid>",1,4528,1325,"Jesse Klaver (GL)",0.863463005339436,0.649191572758452,0
"<anonymized_userid>",1,4529,1326,"Jesse Klaver (GL)",0.863653699466056,0.64968152866242,0
"<anonymized_userid>",1,4530,1327,"Jesse Klaver (GL)",0.863844393592677,0.650171484566389,0
"<anonymized_userid>",1,4531,1328,"Jesse Klaver (GL)",0.864035087719298,0.650661440470358,0
"<anonymized_userid>",1,4532,1329,"Jesse Klaver (GL)",0.864225781845919,0.651151396374326,0
"<anonymized_userid>",1,4533,1330,"Jesse Klaver (GL)",0.86441647597254,0.651641352278295,0
"<anonymized_userid>",1,4534,1331,"Jesse Klaver (GL)",0.864607170099161,0.652131308182264,0
"<anonymized_userid>",1,4535,1332,"Jesse Klaver (GL)",0.864797864225782,0.652621264086232,0
"<anonymized_userid>",1,4536,1333,"Jesse Klaver (GL)",0.864988558352403,0.653111219990201,0
"<anonymized_userid>",1,4537,1334,"Jesse Klaver (GL)",0.865179252479024,0.65360117589417,0
"<anonymized_userid>",1,4538,1335,"Jesse Klaver (GL)",0.865369946605645,0.654091131798138,0
"<anonymized_userid>",1,4539,1336,"Jesse Klaver (GL)",0.865560640732265,0.654581087702107,0
"<anonymized_userid>",1,4540,1337,"Jesse Klaver (GL)",0.865751334858886,0.655071043606075,0
"<anonymized_userid>",1,4541,1338,"Jesse Klaver (GL)",0.865942028985507,0.655560999510044,0
"<anonymized_userid>",1,4542,1339,"Jesse Klaver (GL)",0.866132723112128,0.656050955414013,0
"<anonymized_userid>",1,4543,1340,"Jesse Klaver (GL)",0.866323417238749,0.656540911317981,0
"<anonymized_userid>",1,4544,1341,"Jesse Klaver (GL)",0.86651411136537,0.65703086722195,0
"<anonymized_userid>",1,4545,1342,"Jesse Klaver (GL)",0.866704805491991,0.657520823125919,0
"<anonymized_userid>",1,4546,1343,"Jesse Klaver (GL)",0.866895499618612,0.658010779029887,0
"<anonymized_userid>",1,4547,1344,"Jesse Klaver (GL)",0.867086193745233,0.658500734933856,0
"<anonymized_userid>",1,4548,1345,"Jesse Klaver (GL)",0.867276887871854,0.658990690837825,0
"<anonymized_userid>",1,4549,1346,"Jesse Klaver (GL)",0.867467581998474,0.659480646741793,0
"<anonymized_userid>",1,4550,1347,"Jesse Klaver (GL)",0.867658276125095,0.659970602645762,0
"<anonymized_userid>",1,4551,1348,"Jesse Klaver (GL)",0.867848970251716,0.660460558549731,0
"<anonymized_userid>",1,4552,1349,"Jesse Klaver (GL)",0.868039664378337,0.660950514453699,0
"<anonymized_userid>",1,4553,1350,"Jesse Klaver (GL)",0.868230358504958,0.661440470357668,0
"<anonymized_userid>",1,4554,1351,"Jesse Klaver (GL)",0.868421052631579,0.661930426261636,0
"<anonymized_userid>",1,4555,1352,"Jesse Klaver (GL)",0.8686117467582,0.662420382165605,0
"<anonymized_userid>",1,4556,1353,"Jesse Klaver (GL)",0.868802440884821,0.662910338069574,0
"<anonymized_userid>",1,4557,1354,"Jesse Klaver (GL)",0.868993135011442,0.663400293973542,0
"<anonymized_userid>",1,4558,1355,"Jesse Klaver (GL)",0.869183829138063,0.663890249877511,0
"<anonymized_userid>",1,4559,1356,"Jesse Klaver (GL)",0.869374523264683,0.66438020578148,0
"<anonymized_userid>",1,4560,1357,"Jesse Klaver (GL)",0.869565217391304,0.664870161685448,0
"<anonymized_userid>",1,4561,1358,"Jesse Klaver (GL)",0.869755911517925,0.665360117589417,0
"<anonymized_userid>",1,4562,1359,"Jesse Klaver (GL)",0.869946605644546,0.665850073493386,0
"<anonymized_userid>",1,4563,1360,"Jesse Klaver (GL)",0.870137299771167,0.666340029397354,0
"<anonymized_userid>",1,4564,1361,"Jesse Klaver (GL)",0.870327993897788,0.666829985301323,0
"<anonymized_userid>",1,4565,1362,"Jesse Klaver (GL)",0.870518688024409,0.667319941205291,0
"<anonymized_userid>",1,4566,1363,"Jesse Klaver (GL)",0.87070938215103,0.66780989710926,0
"<anonymized_userid>",1,4567,1364,"Jesse Klaver (GL)",0.870900076277651,0.668299853013229,0
"<anonymized_userid>",1,4568,1365,"Jesse Klaver (GL)",0.871090770404272,0.668789808917197,0
"<anonymized_userid>",1,4569,1366,"Jesse Klaver (GL)",0.871281464530893,0.669279764821166,0
"<anonymized_userid>",1,4570,1367,"Jesse Klaver (GL)",0.871472158657513,0.669769720725135,0
"<anonymized_userid>",1,4571,1368,"Jesse Klaver (GL)",0.871662852784134,0.670259676629103,0
"<anonymized_userid>",1,4572,1369,"Jesse Klaver (GL)",0.871853546910755,0.670749632533072,0
"<anonymized_userid>",1,4573,1370,"Jesse Klaver (GL)",0.872044241037376,0.671239588437041,0
"<anonymized_userid>",1,4574,1371,"Jesse Klaver (GL)",0.872234935163997,0.671729544341009,0
"<anonymized_userid>",1,4575,1372,"Jesse Klaver (GL)",0.872425629290618,0.672219500244978,0
"<anonymized_userid>",1,4576,1373,"Jesse Klaver (GL)",0.872616323417239,0.672709456148947,0
"<anonymized_userid>",1,4577,1374,"Jesse Klaver (GL)",0.87280701754386,0.673199412052915,0
"<anonymized_userid>",1,4578,1375,"Jesse Klaver (GL)",0.872997711670481,0.673689367956884,0
"<anonymized_userid>",1,4579,1376,"Jesse Klaver (GL)",0.873188405797101,0.674179323860853,0
"<anonymized_userid>",1,4580,1377,"Jesse Klaver (GL)",0.873379099923722,0.674669279764821,0
"<anonymized_userid>",1,4581,1378,"Jesse Klaver (GL)",0.873569794050343,0.67515923566879,0
"<anonymized_userid>",1,4582,1379,"Jesse Klaver (GL)",0.873760488176964,0.675649191572758,0
"<anonymized_userid>",1,4583,1380,"Jesse Klaver (GL)",0.873951182303585,0.676139147476727,0
"<anonymized_userid>",1,4584,1381,"Jesse Klaver (GL)",0.874141876430206,0.676629103380696,0
"<anonymized_userid>",1,4585,1382,"Jesse Klaver (GL)",0.874332570556827,0.677119059284664,0
"<anonymized_userid>",1,4586,1383,"Jesse Klaver (GL)",0.874523264683448,0.677609015188633,0
"<anonymized_userid>",1,4587,1384,"Jesse Klaver (GL)",0.874713958810069,0.678098971092602,0
"<anonymized_userid>",1,4588,1385,"Jesse Klaver (GL)",0.87490465293669,0.67858892699657,0
"<anonymized_userid>",1,4589,1386,"Jesse Klaver (GL)",0.87509534706331,0.679078882900539,0
"<anonymized_userid>",1,4590,1387,"Jesse Klaver (GL)",0.875286041189931,0.679568838804508,0
"<anonymized_userid>",1,4591,1388,"Jesse Klaver (GL)",0.875476735316552,0.680058794708476,0
"<anonymized_userid>",1,4592,1389,"Jesse Klaver (GL)",0.875667429443173,0.680548750612445,0
"<anonymized_userid>",1,4593,1390,"Jesse Klaver (GL)",0.875858123569794,0.681038706516414,0
"<anonymized_userid>",1,4594,1391,"Jesse Klaver (GL)",0.876048817696415,0.681528662420382,0
"<anonymized_userid>",1,4595,1392,"Jesse Klaver (GL)",0.876239511823036,0.682018618324351,0
"<anonymized_userid>",1,4596,1393,"Jesse Klaver (GL)",0.876430205949657,0.682508574228319,0
"<anonymized_userid>",1,4597,1394,"Jesse Klaver (GL)",0.876620900076278,0.682998530132288,0
"<anonymized_userid>",1,4598,1395,"Jesse Klaver (GL)",0.876811594202899,0.683488486036257,0
"<anonymized_userid>",1,4599,1396,"Jesse Klaver (GL)",0.877002288329519,0.683978441940225,0
"<anonymized_userid>",1,4600,1397,"Jesse Klaver (GL)",0.87719298245614,0.684468397844194,0
"<anonymized_userid>",1,4601,1398,"Jesse Klaver (GL)",0.877383676582761,0.684958353748163,0
"<anonymized_userid>",1,4602,1399,"Jesse Klaver (GL)",0.877574370709382,0.685448309652131,0
"<anonymized_userid>",1,4603,1400,"Jesse Klaver (GL)",0.877765064836003,0.6859382655561,0
"<anonymized_userid>",1,4604,1401,"Jesse Klaver (GL)",0.877955758962624,0.686428221460069,0
"<anonymized_userid>",1,4605,1402,"Jesse Klaver (GL)",0.878146453089245,0.686918177364037,0
"<anonymized_userid>",1,4606,1403,"Jesse Klaver (GL)",0.878337147215866,0.687408133268006,0
"<anonymized_userid>",1,4607,1404,"Jesse Klaver (GL)",0.878527841342487,0.687898089171974,0
"<anonymized_userid>",1,4608,1405,"Jesse Klaver (GL)",0.878718535469107,0.688388045075943,0
"<anonymized_userid>",1,4609,1406,"Jesse Klaver (GL)",0.878909229595728,0.688878000979912,0
"<anonymized_userid>",1,4610,1407,"Jesse Klaver (GL)",0.879099923722349,0.68936795688388,0
"<anonymized_userid>",1,4611,1408,"Jesse Klaver (GL)",0.87929061784897,0.689857912787849,0
"<anonymized_userid>",1,4612,1409,"Jesse Klaver (GL)",0.879481311975591,0.690347868691818,0
"<anonymized_userid>",1,4613,1410,"Jesse Klaver (GL)",0.879672006102212,0.690837824595786,0
"<anonymized_userid>",1,4614,1411,"Jesse Klaver (GL)",0.879862700228833,0.691327780499755,0
"<anonymized_userid>",1,4615,1412,"Jesse Klaver (GL)",0.880053394355454,0.691817736403724,0
"<anonymized_userid>",1,4616,1413,"Jesse Klaver (GL)",0.880244088482075,0.692307692307692,0
"<anonymized_userid>",1,4617,1414,"Jesse Klaver (GL)",0.880434782608696,0.692797648211661,0
"<anonymized_userid>",1,4618,1415,"Jesse Klaver (GL)",0.880625476735317,0.69328760411563,0
"<anonymized_userid>",1,4619,1416,"Jesse Klaver (GL)",0.880816170861937,0.693777560019598,0
"<anonymized_userid>",1,4620,1417,"Jesse Klaver (GL)",0.881006864988558,0.694267515923567,0
"<anonymized_userid>",1,4621,1418,"Jesse Klaver (GL)",0.881197559115179,0.694757471827536,0
"<anonymized_userid>",1,4622,1419,"Jesse Klaver (GL)",0.8813882532418,0.695247427731504,0
"<anonymized_userid>",1,4623,1420,"Jesse Klaver (GL)",0.881578947368421,0.695737383635473,0
"<anonymized_userid>",1,4624,1421,"Jesse Klaver (GL)",0.881769641495042,0.696227339539441,0
"<anonymized_userid>",1,4625,1422,"Jesse Klaver (GL)",0.881960335621663,0.69671729544341,0
"<anonymized_userid>",1,4626,1423,"Jesse Klaver (GL)",0.882151029748284,0.697207251347379,0
"<anonymized_userid>",1,4627,1424,"Jesse Klaver (GL)",0.882341723874905,0.697697207251347,0
"<anonymized_userid>",1,4628,1425,"Jesse Klaver (GL)",0.882532418001526,0.698187163155316,0
"<anonymized_userid>",1,4629,1426,"Jesse Klaver (GL)",0.882723112128146,0.698677119059285,0
"<anonymized_userid>",1,4630,1427,"Jesse Klaver (GL)",0.882913806254767,0.699167074963253,0
"<anonymized_userid>",1,4631,1428,"Jesse Klaver (GL)",0.883104500381388,0.699657030867222,0
"<anonymized_userid>",1,4632,1429,"Jesse Klaver (GL)",0.883295194508009,0.700146986771191,0
"<anonymized_userid>",1,4633,1430,"Jesse Klaver (GL)",0.88348588863463,0.700636942675159,0
"<anonymized_userid>",1,4634,1431,"Jesse Klaver (GL)",0.883676582761251,0.701126898579128,0
"<anonymized_userid>",1,4635,1432,"Jesse Klaver (GL)",0.883867276887872,0.701616854483097,0
"<anonymized_userid>",1,4636,1433,"Jesse Klaver (GL)",0.884057971014493,0.702106810387065,0
"<anonymized_userid>",1,4637,1434,"Jesse Klaver (GL)",0.884248665141114,0.702596766291034,0
"<anonymized_userid>",1,4638,1435,"Jesse Klaver (GL)",0.884439359267735,0.703086722195002,0
"<anonymized_userid>",1,4639,1436,"Jesse Klaver (GL)",0.884630053394355,0.703576678098971,0
"<anonymized_userid>",1,4640,1437,"Jesse Klaver (GL)",0.884820747520976,0.70406663400294,0
"<anonymized_userid>",1,4641,1438,"Jesse Klaver (GL)",0.885011441647597,0.704556589906908,0
"<anonymized_userid>",1,4642,1439,"Jesse Klaver (GL)",0.885202135774218,0.705046545810877,0
"<anonymized_userid>",1,4643,1440,"Jesse Klaver (GL)",0.885392829900839,0.705536501714846,0
"<anonymized_userid>",1,4644,1441,"Jesse Klaver (GL)",0.88558352402746,0.706026457618814,0
"<anonymized_userid>",1,4645,1442,"Jesse Klaver (GL)",0.885774218154081,0.706516413522783,0
"<anonymized_userid>",1,4646,1443,"Jesse Klaver (GL)",0.885964912280702,0.707006369426752,0
"<anonymized_userid>",1,4647,1444,"Jesse Klaver (GL)",0.886155606407323,0.70749632533072,0
"<anonymized_userid>",1,4648,1445,"Jesse Klaver (GL)",0.886346300533944,0.707986281234689,0
"<anonymized_userid>",1,4649,1446,"Jesse Klaver (GL)",0.886536994660564,0.708476237138657,0
"<anonymized_userid>",1,4650,1447,"Jesse Klaver (GL)",0.886727688787185,0.708966193042626,0
"<anonymized_userid>",1,4651,1448,"Jesse Klaver (GL)",0.886918382913806,0.709456148946595,0
"<anonymized_userid>",1,4652,1449,"Jesse Klaver (GL)",0.887109077040427,0.709946104850563,0
"<anonymized_userid>",1,4653,1450,"Jesse Klaver (GL)",0.887299771167048,0.710436060754532,0
"<anonymized_userid>",1,4654,1451,"Jesse Klaver (GL)",0.887490465293669,0.710926016658501,0
"<anonymized_userid>",1,4655,1452,"Jesse Klaver (GL)",0.88768115942029,0.711415972562469,0
"<anonymized_userid>",1,4656,1453,"Jesse Klaver (GL)",0.887871853546911,0.711905928466438,0
"<anonymized_userid>",1,4657,1454,"Jesse Klaver (GL)",0.888062547673532,0.712395884370407,0
"<anonymized_userid>",1,4658,1455,"Jesse Klaver (GL)",0.888253241800153,0.712885840274375,0
"<anonymized_userid>",1,4659,1456,"Jesse Klaver (GL)",0.888443935926774,0.713375796178344,0
"<anonymized_userid>",1,4660,1457,"Jesse Klaver (GL)",0.888634630053394,0.713865752082313,0
"<anonymized_userid>",1,4661,1458,"Jesse Klaver (GL)",0.888825324180015,0.714355707986281,0
"<anonymized_userid>",1,4662,1459,"Jesse Klaver (GL)",0.889016018306636,0.71484566389025,0
"<anonymized_userid>",1,4663,1460,"Jesse Klaver (GL)",0.889206712433257,0.715335619794219,0
"<anonymized_userid>",1,4664,1461,"Jesse Klaver (GL)",0.889397406559878,0.715825575698187,0
"<anonymized_userid>",1,4665,1462,"Jesse Klaver (GL)",0.889588100686499,0.716315531602156,0
"<anonymized_userid>",1,4666,1463,"Jesse Klaver (GL)",0.88977879481312,0.716805487506124,0
"<anonymized_userid>",1,4667,1464,"Jesse Klaver (GL)",0.889969488939741,0.717295443410093,0
"<anonymized_userid>",1,4668,1465,"Jesse Klaver (GL)",0.890160183066362,0.717785399314062,0
"<anonymized_userid>",1,4669,1466,"Jesse Klaver (GL)",0.890350877192982,0.71827535521803,0
"<anonymized_userid>",1,4670,1467,"Jesse Klaver (GL)",0.890541571319603,0.718765311121999,0
"<anonymized_userid>",1,4671,1468,"Jesse Klaver (GL)",0.890732265446224,0.719255267025968,0
"<anonymized_userid>",1,4672,1469,"Jesse Klaver (GL)",0.890922959572845,0.719745222929936,0
"<anonymized_userid>",1,4673,1470,"Jesse Klaver (GL)",0.891113653699466,0.720235178833905,0
"<anonymized_userid>",1,4674,1471,"Jesse Klaver (GL)",0.891304347826087,0.720725134737874,0
"<anonymized_userid>",1,4675,1472,"Jesse Klaver (GL)",0.891495041952708,0.721215090641842,0
"<anonymized_userid>",1,4676,1473,"Jesse Klaver (GL)",0.891685736079329,0.721705046545811,0
"<anonymized_userid>",1,4677,1474,"Jesse Klaver (GL)",0.89187643020595,0.72219500244978,0
"<anonymized_userid>",1,4678,1475,"Jesse Klaver (GL)",0.892067124332571,0.722684958353748,0
"<anonymized_userid>",1,4679,1476,"Jesse Klaver (GL)",0.892257818459191,0.723174914257717,0
"<anonymized_userid>",1,4680,1477,"Jesse Klaver (GL)",0.892448512585812,0.723664870161685,0
"<anonymized_userid>",1,4681,1478,"Jesse Klaver (GL)",0.892639206712433,0.724154826065654,0
"<anonymized_userid>",1,4682,1479,"Jesse Klaver (GL)",0.892829900839054,0.724644781969623,0
"<anonymized_userid>",1,4683,1480,"Jesse Klaver (GL)",0.893020594965675,0.725134737873591,0
"<anonymized_userid>",1,4684,1481,"Jesse Klaver (GL)",0.893211289092296,0.72562469377756,0
"<anonymized_userid>",1,4685,1482,"Jesse Klaver (GL)",0.893401983218917,0.726114649681529,0
"<anonymized_userid>",1,4686,1483,"Jesse Klaver (GL)",0.893592677345538,0.726604605585497,0
"<anonymized_userid>",1,4687,1484,"Jesse Klaver (GL)",0.893783371472159,0.727094561489466,0
"<anonymized_userid>",1,4688,1485,"Jesse Klaver (GL)",0.89397406559878,0.727584517393435,0
"<anonymized_userid>",1,4689,1486,"Jesse Klaver (GL)",0.8941647597254,0.728074473297403,0
"<anonymized_userid>",1,4690,1487,"Jesse Klaver (GL)",0.894355453852021,0.728564429201372,0
"<anonymized_userid>",1,4691,1488,"Jesse Klaver (GL)",0.894546147978642,0.72905438510534,0
"<anonymized_userid>",1,4692,1489,"Jesse Klaver (GL)",0.894736842105263,0.729544341009309,0
"<anonymized_userid>",1,4693,1490,"Jesse Klaver (GL)",0.894927536231884,0.730034296913278,0
"<anonymized_userid>",1,4694,1491,"Jesse Klaver (GL)",0.895118230358505,0.730524252817246,0
"<anonymized_userid>",1,4695,1492,"Jesse Klaver (GL)",0.895308924485126,0.731014208721215,0
"<anonymized_userid>",1,4696,1493,"Jesse Klaver (GL)",0.895499618611747,0.731504164625184,0
"<anonymized_userid>",1,4697,1494,"Jesse Klaver (GL)",0.895690312738368,0.731994120529152,0
"<anonymized_userid>",1,4698,1495,"Jesse Klaver (GL)",0.895881006864989,0.732484076433121,0
"<anonymized_userid>",1,4699,1496,"Jesse Klaver (GL)",0.896071700991609,0.73297403233709,0
"<anonymized_userid>",1,4700,1497,"Jesse Klaver (GL)",0.89626239511823,0.733463988241058,0
"<anonymized_userid>",1,4701,1498,"Jesse Klaver (GL)",0.896453089244851,0.733953944145027,0
"<anonymized_userid>",1,4702,1499,"Jesse Klaver (GL)",0.896643783371472,0.734443900048996,0
"<anonymized_userid>",1,4703,1500,"Jesse Klaver (GL)",0.896834477498093,0.734933855952964,0
"<anonymized_userid>",1,4704,1501,"Jesse Klaver (GL)",0.897025171624714,0.735423811856933,0
"<anonymized_userid>",1,4705,1502,"Jesse Klaver (GL)",0.897215865751335,0.735913767760902,0
"<anonymized_userid>",1,4706,1503,"Jesse Klaver (GL)",0.897406559877956,0.73640372366487,0
"<anonymized_userid>",1,4707,1504,"Jesse Klaver (GL)",0.897597254004577,0.736893679568839,0
"<anonymized_userid>",1,4708,1505,"Jesse Klaver (GL)",0.897787948131198,0.737383635472807,0
"<anonymized_userid>",1,4709,1506,"Jesse Klaver (GL)",0.897978642257818,0.737873591376776,0
"<anonymized_userid>",1,4710,1507,"Jesse Klaver (GL)",0.898169336384439,0.738363547280745,0
"<anonymized_userid>",1,4711,1508,"Jesse Klaver (GL)",0.89836003051106,0.738853503184713,0
"<anonymized_userid>",1,4712,1509,"Jesse Klaver (GL)",0.898550724637681,0.739343459088682,0
"<anonymized_userid>",1,4713,1510,"Jesse Klaver (GL)",0.898741418764302,0.739833414992651,0
"<anonymized_userid>",1,4714,1511,"Jesse Klaver (GL)",0.898932112890923,0.740323370896619,0
"<anonymized_userid>",1,4715,1512,"Jesse Klaver (GL)",0.899122807017544,0.740813326800588,0
"<anonymized_userid>",1,4716,1513,"Jesse Klaver (GL)",0.899313501144165,0.741303282704557,0
"<anonymized_userid>",1,4717,1514,"Jesse Klaver (GL)",0.899504195270786,0.741793238608525,0
"<anonymized_userid>",1,4718,1515,"Jesse Klaver (GL)",0.899694889397407,0.742283194512494,0
"<anonymized_userid>",1,4719,1516,"Jesse Klaver (GL)",0.899885583524027,0.742773150416463,0
"<anonymized_userid>",1,4720,1517,"Jesse Klaver (GL)",0.900076277650648,0.743263106320431,0
"<anonymized_userid>",1,4721,1518,"Jesse Klaver (GL)",0.900266971777269,0.7437530622244,0
"<anonymized_userid>",1,4722,1519,"Jesse Klaver (GL)",0.90045766590389,0.744243018128368,0
"<anonymized_userid>",1,4723,1520,"Jesse Klaver (GL)",0.900648360030511,0.744732974032337,0
"<anonymized_userid>",1,4724,1521,"Jesse Klaver (GL)",0.900839054157132,0.745222929936306,0
"<anonymized_userid>",1,4725,1522,"Jesse Klaver (GL)",0.901029748283753,0.745712885840274,0
"<anonymized_userid>",1,4726,1523,"Jesse Klaver (GL)",0.901220442410374,0.746202841744243,0
"<anonymized_userid>",1,4727,1524,"Jesse Klaver (GL)",0.901411136536995,0.746692797648212,0
"<anonymized_userid>",1,4728,1525,"Jesse Klaver (GL)",0.901601830663616,0.74718275355218,0
"<anonymized_userid>",1,4729,1526,"Jesse Klaver (GL)",0.901792524790236,0.747672709456149,0
"<anonymized_userid>",1,4730,1527,"Jesse Klaver (GL)",0.901983218916857,0.748162665360118,0
"<anonymized_userid>",1,4731,1528,"Jesse Klaver (GL)",0.902173913043478,0.748652621264086,0
"<anonymized_userid>",1,4732,1529,"Jesse Klaver (GL)",0.902364607170099,0.749142577168055,0
"<anonymized_userid>",1,4733,1530,"Jesse Klaver (GL)",0.90255530129672,0.749632533072023,0
"<anonymized_userid>",1,4734,1531,"Jesse Klaver (GL)",0.902745995423341,0.750122488975992,0
"<anonymized_userid>",1,4735,1532,"Jesse Klaver (GL)",0.902936689549962,0.750612444879961,0
"<anonymized_userid>",1,4736,1533,"Jesse Klaver (GL)",0.903127383676583,0.751102400783929,0
"<anonymized_userid>",1,4737,1534,"Jesse Klaver (GL)",0.903318077803204,0.751592356687898,0
"<anonymized_userid>",1,4738,1535,"Jesse Klaver (GL)",0.903508771929825,0.752082312591867,0
"<anonymized_userid>",1,4739,1536,"Jesse Klaver (GL)",0.903699466056445,0.752572268495835,0
"<anonymized_userid>",1,4740,1537,"Jesse Klaver (GL)",0.903890160183066,0.753062224399804,0
"<anonymized_userid>",1,4741,1538,"Jesse Klaver (GL)",0.904080854309687,0.753552180303773,0
"<anonymized_userid>",1,4742,1539,"Jesse Klaver (GL)",0.904271548436308,0.754042136207741,0
"<anonymized_userid>",1,4743,1540,"Jesse Klaver (GL)",0.904462242562929,0.75453209211171,0
"<anonymized_userid>",1,4744,1541,"Jesse Klaver (GL)",0.90465293668955,0.755022048015679,0
"<anonymized_userid>",1,4745,1542,"Jesse Klaver (GL)",0.904843630816171,0.755512003919647,0
"<anonymized_userid>",1,4746,1543,"Jesse Klaver (GL)",0.905034324942792,0.756001959823616,0
"<anonymized_userid>",1,4747,1544,"Jesse Klaver (GL)",0.905225019069413,0.756491915727585,0
"<anonymized_userid>",1,4748,1545,"Jesse Klaver (GL)",0.905415713196034,0.756981871631553,0
"<anonymized_userid>",1,4749,1546,"Jesse Klaver (GL)",0.905606407322655,0.757471827535522,0
"<anonymized_userid>",1,4750,1547,"Jesse Klaver (GL)",0.905797101449275,0.75796178343949,0
"<anonymized_userid>",1,4751,1548,"Jesse Klaver (GL)",0.905987795575896,0.758451739343459,0
"<anonymized_userid>",1,4752,1549,"Jesse Klaver (GL)",0.906178489702517,0.758941695247428,0
"<anonymized_userid>",1,4753,1550,"Jesse Klaver (GL)",0.906369183829138,0.759431651151396,0
"<anonymized_userid>",1,4754,1551,"Jesse Klaver (GL)",0.906559877955759,0.759921607055365,0
"<anonymized_userid>",1,4755,1552,"Jesse Klaver (GL)",0.90675057208238,0.760411562959334,0
"<anonymized_userid>",1,4756,1553,"Jesse Klaver (GL)",0.906941266209001,0.760901518863302,0
"<anonymized_userid>",1,4757,1554,"Jesse Klaver (GL)",0.907131960335622,0.761391474767271,0
"<anonymized_userid>",1,4758,1555,"Jesse Klaver (GL)",0.907322654462243,0.76188143067124,0
"<anonymized_userid>",1,4759,1556,"Jesse Klaver (GL)",0.907513348588863,0.762371386575208,0
"<anonymized_userid>",1,4760,1557,"Jesse Klaver (GL)",0.907704042715484,0.762861342479177,0
"<anonymized_userid>",1,4761,1558,"Jesse Klaver (GL)",0.907894736842105,0.763351298383146,0
"<anonymized_userid>",1,4762,1559,"Jesse Klaver (GL)",0.908085430968726,0.763841254287114,0
"<anonymized_userid>",1,4763,1560,"Jesse Klaver (GL)",0.908276125095347,0.764331210191083,0
"<anonymized_userid>",1,4764,1561,"Jesse Klaver (GL)",0.908466819221968,0.764821166095051,0
"<anonymized_userid>",1,4765,1562,"Jesse Klaver (GL)",0.908657513348589,0.76531112199902,0
"<anonymized_userid>",1,4766,1563,"Jesse Klaver (GL)",0.90884820747521,0.765801077902989,0
"<anonymized_userid>",1,4767,1564,"Jesse Klaver (GL)",0.909038901601831,0.766291033806957,0
"<anonymized_userid>",1,4768,1565,"Jesse Klaver (GL)",0.909229595728452,0.766780989710926,0
"<anonymized_userid>",1,4769,1566,"Jesse Klaver (GL)",0.909420289855073,0.767270945614895,0
"<anonymized_userid>",1,4770,1567,"Jesse Klaver (GL)",0.909610983981693,0.767760901518863,0
"<anonymized_userid>",1,4771,1568,"Jesse Klaver (GL)",0.909801678108314,0.768250857422832,0
"<anonymized_userid>",1,4772,1569,"Jesse Klaver (GL)",0.909992372234935,0.768740813326801,0
"<anonymized_userid>",1,4773,1570,"Jesse Klaver (GL)",0.910183066361556,0.769230769230769,0
"<anonymized_userid>",1,4774,1571,"Jesse Klaver (GL)",0.910373760488177,0.769720725134738,0
"<anonymized_userid>",1,4775,1572,"Jesse Klaver (GL)",0.910564454614798,0.770210681038706,0
"<anonymized_userid>",1,4776,1573,"Jesse Klaver (GL)",0.910755148741419,0.770700636942675,0
"<anonymized_userid>",1,4777,1574,"Jesse Klaver (GL)",0.91094584286804,0.771190592846644,0
"<anonymized_userid>",1,4778,1575,"Jesse Klaver (GL)",0.911136536994661,0.771680548750612,0
"<anonymized_userid>",1,4779,1576,"Jesse Klaver (GL)",0.911327231121281,0.772170504654581,0
"<anonymized_userid>",1,4780,1577,"Jesse Klaver (GL)",0.911517925247902,0.77266046055855,0
"<anonymized_userid>",1,4781,1578,"Jesse Klaver (GL)",0.911708619374523,0.773150416462518,0
"<anonymized_userid>",1,4782,1579,"Jesse Klaver (GL)",0.911899313501144,0.773640372366487,0
"<anonymized_userid>",1,4783,1580,"Jesse Klaver (GL)",0.912090007627765,0.774130328270456,0
"<anonymized_userid>",1,4784,1581,"Jesse Klaver (GL)",0.912280701754386,0.774620284174424,0
"<anonymized_userid>",1,4785,1582,"Jesse Klaver (GL)",0.912471395881007,0.775110240078393,0
"<anonymized_userid>",1,4786,1583,"Jesse Klaver (GL)",0.912662090007628,0.775600195982362,0
"<anonymized_userid>",1,4787,1584,"Jesse Klaver (GL)",0.912852784134249,0.77609015188633,0
"<anonymized_userid>",1,4788,1585,"Jesse Klaver (GL)",0.91304347826087,0.776580107790299,0
"<anonymized_userid>",1,4789,1586,"Jesse Klaver (GL)",0.91323417238749,0.777070063694268,0
"<anonymized_userid>",1,4790,1587,"Jesse Klaver (GL)",0.913424866514111,0.777560019598236,0
"<anonymized_userid>",1,4791,1588,"Jesse Klaver (GL)",0.913615560640732,0.778049975502205,0
"<anonymized_userid>",1,4792,1589,"Jesse Klaver (GL)",0.913806254767353,0.778539931406173,0
"<anonymized_userid>",1,4793,1590,"Jesse Klaver (GL)",0.913996948893974,0.779029887310142,0
"<anonymized_userid>",1,4794,1591,"Jesse Klaver (GL)",0.914187643020595,0.779519843214111,0
"<anonymized_userid>",1,4795,1592,"Jesse Klaver (GL)",0.914378337147216,0.780009799118079,0
"<anonymized_userid>",1,4796,1593,"Jesse Klaver (GL)",0.914569031273837,0.780499755022048,0
"<anonymized_userid>",1,4797,1594,"Jesse Klaver (GL)",0.914759725400458,0.780989710926017,0
"<anonymized_userid>",1,4798,1595,"Jesse Klaver (GL)",0.914950419527079,0.781479666829985,0
"<anonymized_userid>",1,4799,1596,"Jesse Klaver (GL)",0.915141113653699,0.781969622733954,0
"<anonymized_userid>",1,4800,1597,"Jesse Klaver (GL)",0.91533180778032,0.782459578637923,0
"<anonymized_userid>",1,4801,1598,"Jesse Klaver (GL)",0.915522501906941,0.782949534541891,0
"<anonymized_userid>",1,4802,1599,"Jesse Klaver (GL)",0.915713196033562,0.78343949044586,0
"<anonymized_userid>",1,4803,1600,"Jesse Klaver (GL)",0.915903890160183,0.783929446349829,0
"<anonymized_userid>",1,4804,1601,"Jesse Klaver (GL)",0.916094584286804,0.784419402253797,0
"<anonymized_userid>",1,4805,1602,"Jesse Klaver (GL)",0.916285278413425,0.784909358157766,0
"<anonymized_userid>",1,4806,1603,"Jesse Klaver (GL)",0.916475972540046,0.785399314061734,0
"<anonymized_userid>",1,4807,1604,"Jesse Klaver (GL)",0.916666666666667,0.785889269965703,0
"<anonymized_userid>",1,4808,1605,"Jesse Klaver (GL)",0.916857360793288,0.786379225869672,0
"<anonymized_userid>",1,4809,1606,"Jesse Klaver (GL)",0.917048054919908,0.78686918177364,0
"<anonymized_userid>",1,4810,1607,"Jesse Klaver (GL)",0.917238749046529,0.787359137677609,0
"<anonymized_userid>",1,4811,1608,"Jesse Klaver (GL)",0.91742944317315,0.787849093581578,0
"<anonymized_userid>",1,4812,1609,"Jesse Klaver (GL)",0.917620137299771,0.788339049485546,0
"<anonymized_userid>",1,4813,1610,"Jesse Klaver (GL)",0.917810831426392,0.788829005389515,0
"<anonymized_userid>",1,4814,1611,"Jesse Klaver (GL)",0.918001525553013,0.789318961293484,0
"<anonymized_userid>",1,4815,1612,"Jesse Klaver (GL)",0.918192219679634,0.789808917197452,0
"<anonymized_userid>",1,4816,1613,"Jesse Klaver (GL)",0.918382913806255,0.790298873101421,0
"<anonymized_userid>",1,4817,1614,"Jesse Klaver (GL)",0.918573607932876,0.790788829005389,0
"<anonymized_userid>",1,4818,1615,"Jesse Klaver (GL)",0.918764302059497,0.791278784909358,0
"<anonymized_userid>",1,4819,1616,"Jesse Klaver (GL)",0.918954996186117,0.791768740813327,0
"<anonymized_userid>",1,4820,1617,"Jesse Klaver (GL)",0.919145690312738,0.792258696717295,0
"<anonymized_userid>",1,4821,1618,"Jesse Klaver (GL)",0.919336384439359,0.792748652621264,0
"<anonymized_userid>",1,4822,1619,"Jesse Klaver (GL)",0.91952707856598,0.793238608525233,0
"<anonymized_userid>",1,4823,1620,"Jesse Klaver (GL)",0.919717772692601,0.793728564429201,0
"<anonymized_userid>",1,4824,1621,"Jesse Klaver (GL)",0.919908466819222,0.79421852033317,0
"<anonymized_userid>",1,4825,1622,"Jesse Klaver (GL)",0.920099160945843,0.794708476237139,0
"<anonymized_userid>",1,4826,1623,"Jesse Klaver (GL)",0.920289855072464,0.795198432141107,0
"<anonymized_userid>",1,4827,1624,"Jesse Klaver (GL)",0.920480549199085,0.795688388045076,0
"<anonymized_userid>",1,4828,1625,"Jesse Klaver (GL)",0.920671243325706,0.796178343949045,0
"<anonymized_userid>",1,4829,1626,"Jesse Klaver (GL)",0.920861937452326,0.796668299853013,0
"<anonymized_userid>",1,4830,1627,"Jesse Klaver (GL)",0.921052631578947,0.797158255756982,0
"<anonymized_userid>",1,4831,1628,"Jesse Klaver (GL)",0.921243325705568,0.797648211660951,0
"<anonymized_userid>",1,4832,1629,"Jesse Klaver (GL)",0.921434019832189,0.798138167564919,0
"<anonymized_userid>",1,4833,1630,"Jesse Klaver (GL)",0.92162471395881,0.798628123468888,0
"<anonymized_userid>",1,4834,1631,"Jesse Klaver (GL)",0.921815408085431,0.799118079372856,0
"<anonymized_userid>",1,4835,1632,"Jesse Klaver (GL)",0.922006102212052,0.799608035276825,0
"<anonymized_userid>",1,4836,1633,"Jesse Klaver (GL)",0.922196796338673,0.800097991180794,0
"<anonymized_userid>",1,4837,1634,"Jesse Klaver (GL)",0.922387490465294,0.800587947084762,0
"<anonymized_userid>",1,4838,1635,"Jesse Klaver (GL)",0.922578184591915,0.801077902988731,0
"<anonymized_userid>",1,4839,1636,"Jesse Klaver (GL)",0.922768878718536,0.8015678588927,0
"<anonymized_userid>",1,4840,1637,"Jesse Klaver (GL)",0.922959572845156,0.802057814796668,0
"<anonymized_userid>",1,4841,1638,"Jesse Klaver (GL)",0.923150266971777,0.802547770700637,0
"<anonymized_userid>",1,4842,1639,"Jesse Klaver (GL)",0.923340961098398,0.803037726604606,0
"<anonymized_userid>",1,4843,1640,"Jesse Klaver (GL)",0.923531655225019,0.803527682508574,0
"<anonymized_userid>",1,4844,1641,"Jesse Klaver (GL)",0.92372234935164,0.804017638412543,0
"<anonymized_userid>",1,4845,1642,"Jesse Klaver (GL)",0.923913043478261,0.804507594316512,0
"<anonymized_userid>",1,4846,1643,"Jesse Klaver (GL)",0.924103737604882,0.80499755022048,0
"<anonymized_userid>",1,4847,1644,"Jesse Klaver (GL)",0.924294431731503,0.805487506124449,0
"<anonymized_userid>",1,4848,1645,"Jesse Klaver (GL)",0.924485125858124,0.805977462028417,0
"<anonymized_userid>",1,4849,1646,"Jesse Klaver (GL)",0.924675819984744,0.806467417932386,0
"<anonymized_userid>",1,4850,1647,"Jesse Klaver (GL)",0.924866514111365,0.806957373836355,0
"<anonymized_userid>",1,4851,1648,"Jesse Klaver (GL)",0.925057208237986,0.807447329740323,0
"<anonymized_userid>",1,4852,1649,"Jesse Klaver (GL)",0.925247902364607,0.807937285644292,0
"<anonymized_userid>",1,4853,1650,"Jesse Klaver (GL)",0.925438596491228,0.808427241548261,0
"<anonymized_userid>",1,4854,1651,"Jesse Klaver (GL)",0.925629290617849,0.808917197452229,0
"<anonymized_userid>",1,4855,1652,"Jesse Klaver (GL)",0.92581998474447,0.809407153356198,0
"<anonymized_userid>",1,4856,1653,"Jesse Klaver (GL)",0.926010678871091,0.809897109260167,0
"<anonymized_userid>",1,4857,1654,"Jesse Klaver (GL)",0.926201372997712,0.810387065164135,0
"<anonymized_userid>",1,4858,1655,"Jesse Klaver (GL)",0.926392067124333,0.810877021068104,0
"<anonymized_userid>",1,4859,1656,"Jesse Klaver (GL)",0.926582761250954,0.811366976972072,0
"<anonymized_userid>",1,4860,1657,"Jesse Klaver (GL)",0.926773455377574,0.811856932876041,0
"<anonymized_userid>",1,4861,1658,"Jesse Klaver (GL)",0.926964149504195,0.81234688878001,0
"<anonymized_userid>",1,4862,1659,"Jesse Klaver (GL)",0.927154843630816,0.812836844683978,0
"<anonymized_userid>",1,4863,1660,"Jesse Klaver (GL)",0.927345537757437,0.813326800587947,0
"<anonymized_userid>",1,4864,1661,"Jesse Klaver (GL)",0.927536231884058,0.813816756491916,0
"<anonymized_userid>",1,4865,1662,"Jesse Klaver (GL)",0.927726926010679,0.814306712395884,0
"<anonymized_userid>",1,4866,1663,"Jesse Klaver (GL)",0.9279176201373,0.814796668299853,0
"<anonymized_userid>",1,4867,1664,"Jesse Klaver (GL)",0.928108314263921,0.815286624203822,0
"<anonymized_userid>",1,4868,1665,"Jesse Klaver (GL)",0.928299008390542,0.81577658010779,0
"<anonymized_userid>",1,4869,1666,"Jesse Klaver (GL)",0.928489702517162,0.816266536011759,0
"<anonymized_userid>",1,4870,1667,"Jesse Klaver (GL)",0.928680396643783,0.816756491915728,0
"<anonymized_userid>",1,4871,1668,"Jesse Klaver (GL)",0.928871090770404,0.817246447819696,0
"<anonymized_userid>",1,4872,1669,"Jesse Klaver (GL)",0.929061784897025,0.817736403723665,0
"<anonymized_userid>",1,4873,1670,"Jesse Klaver (GL)",0.929252479023646,0.818226359627633,0
"<anonymized_userid>",1,4874,1671,"Jesse Klaver (GL)",0.929443173150267,0.818716315531602,0
"<anonymized_userid>",1,4875,1672,"Jesse Klaver (GL)",0.929633867276888,0.819206271435571,0
"<anonymized_userid>",1,4876,1673,"Jesse Klaver (GL)",0.929824561403509,0.819696227339539,0
"<anonymized_userid>",1,4877,1674,"Jesse Klaver (GL)",0.93001525553013,0.820186183243508,0
"<anonymized_userid>",1,4878,1675,"Jesse Klaver (GL)",0.930205949656751,0.820676139147477,0
"<anonymized_userid>",1,4879,1676,"Jesse Klaver (GL)",0.930396643783372,0.821166095051445,0
"<anonymized_userid>",1,4880,1677,"Jesse Klaver (GL)",0.930587337909992,0.821656050955414,0
"<anonymized_userid>",1,4881,1678,"Jesse Klaver (GL)",0.930778032036613,0.822146006859383,0
"<anonymized_userid>",1,4882,1679,"Jesse Klaver (GL)",0.930968726163234,0.822635962763351,0
"<anonymized_userid>",1,4883,1680,"Jesse Klaver (GL)",0.931159420289855,0.82312591866732,0
"<anonymized_userid>",1,4884,1681,"Jesse Klaver (GL)",0.931350114416476,0.823615874571289,0
"<anonymized_userid>",1,4885,1682,"Jesse Klaver (GL)",0.931540808543097,0.824105830475257,0
"<anonymized_userid>",1,4886,1683,"Jesse Klaver (GL)",0.931731502669718,0.824595786379226,0
"<anonymized_userid>",1,4887,1684,"Jesse Klaver (GL)",0.931922196796339,0.825085742283195,0
"<anonymized_userid>",1,4888,1685,"Jesse Klaver (GL)",0.93211289092296,0.825575698187163,0
"<anonymized_userid>",1,4889,1686,"Jesse Klaver (GL)",0.93230358504958,0.826065654091132,0
"<anonymized_userid>",1,4890,1687,"Jesse Klaver (GL)",0.932494279176201,0.8265556099951,0
"<anonymized_userid>",1,4891,1688,"Jesse Klaver (GL)",0.932684973302822,0.827045565899069,0
"<anonymized_userid>",1,4892,1689,"Jesse Klaver (GL)",0.932875667429443,0.827535521803038,0
"<anonymized_userid>",1,4893,1690,"Jesse Klaver (GL)",0.933066361556064,0.828025477707006,0
"<anonymized_userid>",1,4894,1691,"Jesse Klaver (GL)",0.933257055682685,0.828515433610975,0
"<anonymized_userid>",1,4895,1692,"Jesse Klaver (GL)",0.933447749809306,0.829005389514944,0
"<anonymized_userid>",1,4896,1693,"Jesse Klaver (GL)",0.933638443935927,0.829495345418912,0
"<anonymized_userid>",1,4897,1694,"Jesse Klaver (GL)",0.933829138062548,0.829985301322881,0
"<anonymized_userid>",1,4898,1695,"Jesse Klaver (GL)",0.934019832189169,0.83047525722685,0
"<anonymized_userid>",1,4899,1696,"Jesse Klaver (GL)",0.934210526315789,0.830965213130818,0
"<anonymized_userid>",1,4900,1697,"Jesse Klaver (GL)",0.93440122044241,0.831455169034787,0
"<anonymized_userid>",1,4901,1698,"Jesse Klaver (GL)",0.934591914569031,0.831945124938755,0
"<anonymized_userid>",1,4902,1699,"Jesse Klaver (GL)",0.934782608695652,0.832435080842724,0
"<anonymized_userid>",1,4903,1700,"Jesse Klaver (GL)",0.934973302822273,0.832925036746693,0
"<anonymized_userid>",1,4904,1701,"Jesse Klaver (GL)",0.935163996948894,0.833414992650661,0
"<anonymized_userid>",1,4905,1702,"Jesse Klaver (GL)",0.935354691075515,0.83390494855463,0
"<anonymized_userid>",1,4906,1703,"Jesse Klaver (GL)",0.935545385202136,0.834394904458599,0
"<anonymized_userid>",1,4907,1704,"Jesse Klaver (GL)",0.935736079328757,0.834884860362567,0
"<anonymized_userid>",1,4908,1705,"Jesse Klaver (GL)",0.935926773455378,0.835374816266536,0
"<anonymized_userid>",1,4909,1706,"Jesse Klaver (GL)",0.936117467581998,0.835864772170505,0
"<anonymized_userid>",1,4910,1707,"Jesse Klaver (GL)",0.936308161708619,0.836354728074473,0
"<anonymized_userid>",1,4911,1708,"Jesse Klaver (GL)",0.93649885583524,0.836844683978442,0
"<anonymized_userid>",1,4912,1709,"Jesse Klaver (GL)",0.936689549961861,0.837334639882411,0
"<anonymized_userid>",1,4913,1710,"Jesse Klaver (GL)",0.936880244088482,0.837824595786379,0
"<anonymized_userid>",1,4914,1711,"Jesse Klaver (GL)",0.937070938215103,0.838314551690348,0
"<anonymized_userid>",1,4915,1712,"Jesse Klaver (GL)",0.937261632341724,0.838804507594316,0
"<anonymized_userid>",1,4916,1713,"Jesse Klaver (GL)",0.937452326468345,0.839294463498285,0
"<anonymized_userid>",1,4917,1714,"Jesse Klaver (GL)",0.937643020594966,0.839784419402254,0
"<anonymized_userid>",1,4918,1715,"Jesse Klaver (GL)",0.937833714721587,0.840274375306222,0
"<anonymized_userid>",1,4919,1716,"Jesse Klaver (GL)",0.938024408848207,0.840764331210191,0
"<anonymized_userid>",1,4920,1717,"Jesse Klaver (GL)",0.938215102974828,0.84125428711416,0
"<anonymized_userid>",1,4921,1718,"Jesse Klaver (GL)",0.938405797101449,0.841744243018128,0
"<anonymized_userid>",1,4922,1719,"Jesse Klaver (GL)",0.93859649122807,0.842234198922097,0
"<anonymized_userid>",1,4923,1720,"Jesse Klaver (GL)",0.938787185354691,0.842724154826066,0
"<anonymized_userid>",1,4924,1721,"Jesse Klaver (GL)",0.938977879481312,0.843214110730034,0
"<anonymized_userid>",1,4925,1722,"Jesse Klaver (GL)",0.939168573607933,0.843704066634003,0
"<anonymized_userid>",1,4926,1723,"Jesse Klaver (GL)",0.939359267734554,0.844194022537972,0
"<anonymized_userid>",1,4927,1724,"Jesse Klaver (GL)",0.939549961861175,0.84468397844194,0
"<anonymized_userid>",1,4928,1725,"Jesse Klaver (GL)",0.939740655987796,0.845173934345909,0
"<anonymized_userid>",1,4929,1726,"Jesse Klaver (GL)",0.939931350114417,0.845663890249878,0
"<anonymized_userid>",1,4930,1727,"Jesse Klaver (GL)",0.940122044241037,0.846153846153846,0
"<anonymized_userid>",1,4931,1728,"Jesse Klaver (GL)",0.940312738367658,0.846643802057815,0
"<anonymized_userid>",1,4932,1729,"Jesse Klaver (GL)",0.940503432494279,0.847133757961783,0
"<anonymized_userid>",1,4933,1730,"Jesse Klaver (GL)",0.9406941266209,0.847623713865752,0
"<anonymized_userid>",1,4934,1731,"Jesse Klaver (GL)",0.940884820747521,0.848113669769721,0
"<anonymized_userid>",1,4935,1732,"Jesse Klaver (GL)",0.941075514874142,0.848603625673689,0
"<anonymized_userid>",1,4936,1733,"Jesse Klaver (GL)",0.941266209000763,0.849093581577658,0
"<anonymized_userid>",1,4937,1734,"Jesse Klaver (GL)",0.941456903127384,0.849583537481627,0
"<anonymized_userid>",1,4938,1735,"Jesse Klaver (GL)",0.941647597254005,0.850073493385595,0
"<anonymized_userid>",1,4939,1736,"Jesse Klaver (GL)",0.941838291380625,0.850563449289564,0
"<anonymized_userid>",1,4940,1737,"Jesse Klaver (GL)",0.942028985507246,0.851053405193533,0
"<anonymized_userid>",1,4941,1738,"Jesse Klaver (GL)",0.942219679633867,0.851543361097501,0
"<anonymized_userid>",1,4942,1739,"Jesse Klaver (GL)",0.942410373760488,0.85203331700147,0
"<anonymized_userid>",1,4943,1740,"Jesse Klaver (GL)",0.942601067887109,0.852523272905439,0
"<anonymized_userid>",1,4944,1741,"Jesse Klaver (GL)",0.94279176201373,0.853013228809407,0
"<anonymized_userid>",1,4945,1742,"Jesse Klaver (GL)",0.942982456140351,0.853503184713376,0
"<anonymized_userid>",1,4946,1743,"Jesse Klaver (GL)",0.943173150266972,0.853993140617344,0
"<anonymized_userid>",1,4947,1744,"Jesse Klaver (GL)",0.943363844393593,0.854483096521313,0
"<anonymized_userid>",1,4948,1745,"Jesse Klaver (GL)",0.943554538520214,0.854973052425282,0
"<anonymized_userid>",1,4949,1746,"Jesse Klaver (GL)",0.943745232646835,0.85546300832925,0
"<anonymized_userid>",1,4950,1747,"Jesse Klaver (GL)",0.943935926773455,0.855952964233219,0
"<anonymized_userid>",1,4951,1748,"Jesse Klaver (GL)",0.944126620900076,0.856442920137188,0
"<anonymized_userid>",1,4952,1749,"Jesse Klaver (GL)",0.944317315026697,0.856932876041156,0
"<anonymized_userid>",1,4953,1750,"Jesse Klaver (GL)",0.944508009153318,0.857422831945125,0
"<anonymized_userid>",1,4954,1751,"Jesse Klaver (GL)",0.944698703279939,0.857912787849094,0
"<anonymized_userid>",1,4955,1752,"Jesse Klaver (GL)",0.94488939740656,0.858402743753062,0
"<anonymized_userid>",1,4956,1753,"Jesse Klaver (GL)",0.945080091533181,0.858892699657031,0
"<anonymized_userid>",1,4957,1754,"Jesse Klaver (GL)",0.945270785659802,0.859382655560999,0
"<anonymized_userid>",1,4958,1755,"Jesse Klaver (GL)",0.945461479786423,0.859872611464968,0
"<anonymized_userid>",1,4959,1756,"Jesse Klaver (GL)",0.945652173913043,0.860362567368937,0
"<anonymized_userid>",1,4960,1757,"Jesse Klaver (GL)",0.945842868039664,0.860852523272905,0
"<anonymized_userid>",1,4961,1758,"Jesse Klaver (GL)",0.946033562166285,0.861342479176874,0
"<anonymized_userid>",1,4962,1759,"Jesse Klaver (GL)",0.946224256292906,0.861832435080843,0
"<anonymized_userid>",1,4963,1760,"Jesse Klaver (GL)",0.946414950419527,0.862322390984811,0
"<anonymized_userid>",1,4964,1761,"Jesse Klaver (GL)",0.946605644546148,0.86281234688878,0
"<anonymized_userid>",1,4965,1762,"Jesse Klaver (GL)",0.946796338672769,0.863302302792749,0
"<anonymized_userid>",1,4966,1763,"Jesse Klaver (GL)",0.94698703279939,0.863792258696717,0
"<anonymized_userid>",1,4967,1764,"Jesse Klaver (GL)",0.947177726926011,0.864282214600686,0
"<anonymized_userid>",1,4968,1765,"Jesse Klaver (GL)",0.947368421052632,0.864772170504655,0
"<anonymized_userid>",1,4969,1766,"Jesse Klaver (GL)",0.947559115179253,0.865262126408623,0
"<anonymized_userid>",1,4970,1767,"Jesse Klaver (GL)",0.947749809305873,0.865752082312592,0
"<anonymized_userid>",1,4971,1768,"Jesse Klaver (GL)",0.947940503432494,0.866242038216561,0
"<anonymized_userid>",1,4972,1769,"Jesse Klaver (GL)",0.948131197559115,0.866731994120529,0
"<anonymized_userid>",1,4973,1770,"Jesse Klaver (GL)",0.948321891685736,0.867221950024498,0
"<anonymized_userid>",1,4974,1771,"Jesse Klaver (GL)",0.948512585812357,0.867711905928466,0
"<anonymized_userid>",1,4975,1772,"Jesse Klaver (GL)",0.948703279938978,0.868201861832435,0
"<anonymized_userid>",1,4976,1773,"Jesse Klaver (GL)",0.948893974065599,0.868691817736404,0
"<anonymized_userid>",1,4977,1774,"Jesse Klaver (GL)",0.94908466819222,0.869181773640372,0
"<anonymized_userid>",1,4978,1775,"Jesse Klaver (GL)",0.949275362318841,0.869671729544341,0
"<anonymized_userid>",1,4979,1776,"Jesse Klaver (GL)",0.949466056445461,0.87016168544831,0
"<anonymized_userid>",1,4980,1777,"Jesse Klaver (GL)",0.949656750572082,0.870651641352278,0
"<anonymized_userid>",1,4981,1778,"Jesse Klaver (GL)",0.949847444698703,0.871141597256247,0
"<anonymized_userid>",1,4982,1779,"Jesse Klaver (GL)",0.950038138825324,0.871631553160216,0
"<anonymized_userid>",1,4983,1780,"Jesse Klaver (GL)",0.950228832951945,0.872121509064184,0
"<anonymized_userid>",1,4984,1781,"Jesse Klaver (GL)",0.950419527078566,0.872611464968153,0
"<anonymized_userid>",1,4985,1782,"Jesse Klaver (GL)",0.950610221205187,0.873101420872122,0
"<anonymized_userid>",1,4986,1783,"Jesse Klaver (GL)",0.950800915331808,0.87359137677609,0
"<anonymized_userid>",1,4987,1784,"Jesse Klaver (GL)",0.950991609458429,0.874081332680059,0
"<anonymized_userid>",1,4988,1785,"Jesse Klaver (GL)",0.95118230358505,0.874571288584027,0
"<anonymized_userid>",1,4989,1786,"Jesse Klaver (GL)",0.95137299771167,0.875061244487996,0
"<anonymized_userid>",1,4990,1787,"Jesse Klaver (GL)",0.951563691838291,0.875551200391965,0
"<anonymized_userid>",1,4991,1788,"Jesse Klaver (GL)",0.951754385964912,0.876041156295933,0
"<anonymized_userid>",1,4992,1789,"Jesse Klaver (GL)",0.951945080091533,0.876531112199902,0
"<anonymized_userid>",1,4993,1790,"Jesse Klaver (GL)",0.952135774218154,0.877021068103871,0
"<anonymized_userid>",1,4994,1791,"Jesse Klaver (GL)",0.952326468344775,0.877511024007839,0
"<anonymized_userid>",1,4995,1792,"Jesse Klaver (GL)",0.952517162471396,0.878000979911808,0
"<anonymized_userid>",1,4996,1793,"Jesse Klaver (GL)",0.952707856598017,0.878490935815777,0
"<anonymized_userid>",1,4997,1794,"Jesse Klaver (GL)",0.952898550724638,0.878980891719745,0
"<anonymized_userid>",1,4998,1795,"Jesse Klaver (GL)",0.953089244851259,0.879470847623714,0
"<anonymized_userid>",1,4999,1796,"Jesse Klaver (GL)",0.953279938977879,0.879960803527682,0
"<anonymized_userid>",1,5000,1797,"Jesse Klaver (GL)",0.9534706331045,0.880450759431651,0
"<anonymized_userid>",1,5001,1798,"Jesse Klaver (GL)",0.953661327231121,0.88094071533562,0
"<anonymized_userid>",1,5002,1799,"Jesse Klaver (GL)",0.953852021357742,0.881430671239588,0
"<anonymized_userid>",1,5003,1800,"Jesse Klaver (GL)",0.954042715484363,0.881920627143557,0
"<anonymized_userid>",1,5004,1801,"Jesse Klaver (GL)",0.954233409610984,0.882410583047526,0
"<anonymized_userid>",1,5005,1802,"Jesse Klaver (GL)",0.954424103737605,0.882900538951494,0
"<anonymized_userid>",1,5006,1803,"Jesse Klaver (GL)",0.954614797864226,0.883390494855463,0
"<anonymized_userid>",1,5007,1804,"Jesse Klaver (GL)",0.954805491990847,0.883880450759432,0
"<anonymized_userid>",1,5008,1805,"Jesse Klaver (GL)",0.954996186117468,0.8843704066634,0
"<anonymized_userid>",1,5009,1806,"Jesse Klaver (GL)",0.955186880244088,0.884860362567369,0
"<anonymized_userid>",1,5010,1807,"Jesse Klaver (GL)",0.955377574370709,0.885350318471338,0
"<anonymized_userid>",1,5011,1808,"Jesse Klaver (GL)",0.95556826849733,0.885840274375306,0
"<anonymized_userid>",1,5012,1809,"Jesse Klaver (GL)",0.955758962623951,0.886330230279275,0
"<anonymized_userid>",1,5013,1810,"Jesse Klaver (GL)",0.955949656750572,0.886820186183244,0
"<anonymized_userid>",1,5014,1811,"Jesse Klaver (GL)",0.956140350877193,0.887310142087212,0
"<anonymized_userid>",1,5015,1812,"Jesse Klaver (GL)",0.956331045003814,0.887800097991181,0
"<anonymized_userid>",1,5016,1813,"Jesse Klaver (GL)",0.956521739130435,0.888290053895149,0
"<anonymized_userid>",1,5017,1814,"Jesse Klaver (GL)",0.956712433257056,0.888780009799118,0
"<anonymized_userid>",1,5018,1815,"Jesse Klaver (GL)",0.956903127383677,0.889269965703087,0
"<anonymized_userid>",1,5019,1816,"Jesse Klaver (GL)",0.957093821510298,0.889759921607055,0
"<anonymized_userid>",1,5020,1817,"Jesse Klaver (GL)",0.957284515636918,0.890249877511024,0
"<anonymized_userid>",1,5021,1818,"Jesse Klaver (GL)",0.957475209763539,0.890739833414993,0
"<anonymized_userid>",1,5022,1819,"Jesse Klaver (GL)",0.95766590389016,0.891229789318961,0
"<anonymized_userid>",1,5023,1820,"Jesse Klaver (GL)",0.957856598016781,0.89171974522293,0
"<anonymized_userid>",1,5024,1821,"Jesse Klaver (GL)",0.958047292143402,0.892209701126899,0
"<anonymized_userid>",1,5025,1822,"Jesse Klaver (GL)",0.958237986270023,0.892699657030867,0
"<anonymized_userid>",1,5026,1823,"Jesse Klaver (GL)",0.958428680396644,0.893189612934836,0
"<anonymized_userid>",1,5027,1824,"Jesse Klaver (GL)",0.958619374523265,0.893679568838805,0
"<anonymized_userid>",1,5028,1825,"Jesse Klaver (GL)",0.958810068649886,0.894169524742773,0
"<anonymized_userid>",1,5029,1826,"Jesse Klaver (GL)",0.959000762776506,0.894659480646742,0
"<anonymized_userid>",1,5030,1827,"Jesse Klaver (GL)",0.959191456903127,0.89514943655071,0
"<anonymized_userid>",1,5031,1828,"Jesse Klaver (GL)",0.959382151029748,0.895639392454679,0
"<anonymized_userid>",1,5032,1829,"Jesse Klaver (GL)",0.959572845156369,0.896129348358648,0
"<anonymized_userid>",1,5033,1830,"Jesse Klaver (GL)",0.95976353928299,0.896619304262616,0
"<anonymized_userid>",1,5034,1831,"Jesse Klaver (GL)",0.959954233409611,0.897109260166585,0
"<anonymized_userid>",1,5035,1832,"Jesse Klaver (GL)",0.960144927536232,0.897599216070554,0
"<anonymized_userid>",1,5036,1833,"Jesse Klaver (GL)",0.960335621662853,0.898089171974522,0
"<anonymized_userid>",1,5037,1834,"Jesse Klaver (GL)",0.960526315789474,0.898579127878491,0
"<anonymized_userid>",1,5038,1835,"Jesse Klaver (GL)",0.960717009916095,0.89906908378246,0
"<anonymized_userid>",1,5039,1836,"Jesse Klaver (GL)",0.960907704042716,0.899559039686428,0
"<anonymized_userid>",1,5040,1837,"Jesse Klaver (GL)",0.961098398169336,0.900048995590397,0
"<anonymized_userid>",1,5041,1838,"Jesse Klaver (GL)",0.961289092295957,0.900538951494365,0
"<anonymized_userid>",1,5042,1839,"Jesse Klaver (GL)",0.961479786422578,0.901028907398334,0
"<anonymized_userid>",1,5043,1840,"Jesse Klaver (GL)",0.961670480549199,0.901518863302303,0
"<anonymized_userid>",1,5044,1841,"Jesse Klaver (GL)",0.96186117467582,0.902008819206271,0
"<anonymized_userid>",1,5045,1842,"Jesse Klaver (GL)",0.962051868802441,0.90249877511024,0
"<anonymized_userid>",1,5046,1843,"Jesse Klaver (GL)",0.962242562929062,0.902988731014209,0
"<anonymized_userid>",1,5047,1844,"Jesse Klaver (GL)",0.962433257055683,0.903478686918177,0
"<anonymized_userid>",1,5048,1845,"Jesse Klaver (GL)",0.962623951182304,0.903968642822146,0
"<anonymized_userid>",1,5049,1846,"Jesse Klaver (GL)",0.962814645308924,0.904458598726115,0
"<anonymized_userid>",1,5050,1847,"Jesse Klaver (GL)",0.963005339435545,0.904948554630083,0
"<anonymized_userid>",1,5051,1848,"Jesse Klaver (GL)",0.963196033562166,0.905438510534052,0
"<anonymized_userid>",1,5052,1849,"Jesse Klaver (GL)",0.963386727688787,0.905928466438021,0
"<anonymized_userid>",1,5053,1850,"Jesse Klaver (GL)",0.963577421815408,0.906418422341989,0
"<anonymized_userid>",1,5054,1851,"Jesse Klaver (GL)",0.963768115942029,0.906908378245958,0
"<anonymized_userid>",1,5055,1852,"Jesse Klaver (GL)",0.96395881006865,0.907398334149927,0
"<anonymized_userid>",1,5056,1853,"Jesse Klaver (GL)",0.964149504195271,0.907888290053895,0
"<anonymized_userid>",1,5057,1854,"Jesse Klaver (GL)",0.964340198321892,0.908378245957864,0
"<anonymized_userid>",1,5058,1855,"Jesse Klaver (GL)",0.964530892448513,0.908868201861832,0
"<anonymized_userid>",1,5059,1856,"Jesse Klaver (GL)",0.964721586575134,0.909358157765801,0
"<anonymized_userid>",1,5060,1857,"Jesse Klaver (GL)",0.964912280701754,0.90984811366977,0
"<anonymized_userid>",1,5061,1858,"Jesse Klaver (GL)",0.965102974828375,0.910338069573738,0
"<anonymized_userid>",1,5062,1859,"Jesse Klaver (GL)",0.965293668954996,0.910828025477707,0
"<anonymized_userid>",1,5063,1860,"Jesse Klaver (GL)",0.965484363081617,0.911317981381676,0
"<anonymized_userid>",1,5064,1861,"Jesse Klaver (GL)",0.965675057208238,0.911807937285644,0
"<anonymized_userid>",1,5065,1862,"Jesse Klaver (GL)",0.965865751334859,0.912297893189613,0
"<anonymized_userid>",1,5066,1863,"Jesse Klaver (GL)",0.96605644546148,0.912787849093582,0
"<anonymized_userid>",1,5067,1864,"Jesse Klaver (GL)",0.966247139588101,0.91327780499755,0
"<anonymized_userid>",1,5068,1865,"Jesse Klaver (GL)",0.966437833714722,0.913767760901519,0
"<anonymized_userid>",1,5069,1866,"Jesse Klaver (GL)",0.966628527841342,0.914257716805488,0
"<anonymized_userid>",1,5070,1867,"Jesse Klaver (GL)",0.966819221967963,0.914747672709456,0
"<anonymized_userid>",1,5071,1868,"Jesse Klaver (GL)",0.967009916094584,0.915237628613425,0
"<anonymized_userid>",1,5072,1869,"Jesse Klaver (GL)",0.967200610221205,0.915727584517393,0
"<anonymized_userid>",1,5073,1870,"Jesse Klaver (GL)",0.967391304347826,0.916217540421362,0
"<anonymized_userid>",1,5074,1871,"Jesse Klaver (GL)",0.967581998474447,0.916707496325331,0
"<anonymized_userid>",1,5075,1872,"Jesse Klaver (GL)",0.967772692601068,0.917197452229299,0
"<anonymized_userid>",1,5076,1873,"Jesse Klaver (GL)",0.967963386727689,0.917687408133268,0
"<anonymized_userid>",1,5077,1874,"Jesse Klaver (GL)",0.96815408085431,0.918177364037237,0
"<anonymized_userid>",1,5078,1875,"Jesse Klaver (GL)",0.968344774980931,0.918667319941205,0
"<anonymized_userid>",1,5079,1876,"Jesse Klaver (GL)",0.968535469107552,0.919157275845174,0
"<anonymized_userid>",1,5080,1877,"Jesse Klaver (GL)",0.968726163234172,0.919647231749143,0
"<anonymized_userid>",1,5081,1878,"Jesse Klaver (GL)",0.968916857360793,0.920137187653111,0
"<anonymized_userid>",1,5082,1879,"Jesse Klaver (GL)",0.969107551487414,0.92062714355708,0
"<anonymized_userid>",1,5083,1880,"Jesse Klaver (GL)",0.969298245614035,0.921117099461048,0
"<anonymized_userid>",1,5084,1881,"Jesse Klaver (GL)",0.969488939740656,0.921607055365017,0
"<anonymized_userid>",1,5085,1882,"Jesse Klaver (GL)",0.969679633867277,0.922097011268986,0
"<anonymized_userid>",1,5086,1883,"Jesse Klaver (GL)",0.969870327993898,0.922586967172954,0
"<anonymized_userid>",1,5087,1884,"Jesse Klaver (GL)",0.970061022120519,0.923076923076923,0
"<anonymized_userid>",1,5088,1885,"Jesse Klaver (GL)",0.97025171624714,0.923566878980892,0
"<anonymized_userid>",1,5089,1886,"Jesse Klaver (GL)",0.97044241037376,0.92405683488486,0
"<anonymized_userid>",1,5090,1887,"Jesse Klaver (GL)",0.970633104500381,0.924546790788829,0
"<anonymized_userid>",1,5091,1888,"Jesse Klaver (GL)",0.970823798627002,0.925036746692798,0
"<anonymized_userid>",1,5092,1889,"Jesse Klaver (GL)",0.971014492753623,0.925526702596766,0
"<anonymized_userid>",1,5093,1890,"Jesse Klaver (GL)",0.971205186880244,0.926016658500735,0
"<anonymized_userid>",1,5094,1891,"Jesse Klaver (GL)",0.971395881006865,0.926506614404704,0
"<anonymized_userid>",1,5095,1892,"Jesse Klaver (GL)",0.971586575133486,0.926996570308672,0
"<anonymized_userid>",1,5096,1893,"Jesse Klaver (GL)",0.971777269260107,0.927486526212641,0
"<anonymized_userid>",1,5097,1894,"Jesse Klaver (GL)",0.971967963386728,0.92797648211661,0
"<anonymized_userid>",1,5098,1895,"Jesse Klaver (GL)",0.972158657513349,0.928466438020578,0
"<anonymized_userid>",1,5099,1896,"Jesse Klaver (GL)",0.972349351639969,0.928956393924547,0
"<anonymized_userid>",1,5100,1897,"Jesse Klaver (GL)",0.97254004576659,0.929446349828515,0
"<anonymized_userid>",1,5101,1898,"Jesse Klaver (GL)",0.972730739893211,0.929936305732484,0
"<anonymized_userid>",1,5102,1899,"Jesse Klaver (GL)",0.972921434019832,0.930426261636453,0
"<anonymized_userid>",1,5103,1900,"Jesse Klaver (GL)",0.973112128146453,0.930916217540421,0
"<anonymized_userid>",1,5104,1901,"Jesse Klaver (GL)",0.973302822273074,0.93140617344439,0
"<anonymized_userid>",1,5105,1902,"Jesse Klaver (GL)",0.973493516399695,0.931896129348359,0
"<anonymized_userid>",1,5106,1903,"Jesse Klaver (GL)",0.973684210526316,0.932386085252327,0
"<anonymized_userid>",1,5107,1904,"Jesse Klaver (GL)",0.973874904652937,0.932876041156296,0
"<anonymized_userid>",1,5108,1905,"Jesse Klaver (GL)",0.974065598779558,0.933365997060265,0
"<anonymized_userid>",1,5109,1906,"Jesse Klaver (GL)",0.974256292906179,0.933855952964233,0
"<anonymized_userid>",1,5110,1907,"Jesse Klaver (GL)",0.974446987032799,0.934345908868202,0
"<anonymized_userid>",1,5111,1908,"Jesse Klaver (GL)",0.97463768115942,0.934835864772171,0
"<anonymized_userid>",1,5112,1909,"Jesse Klaver (GL)",0.974828375286041,0.935325820676139,0
"<anonymized_userid>",1,5113,1910,"Jesse Klaver (GL)",0.975019069412662,0.935815776580108,0
"<anonymized_userid>",1,5114,1911,"Jesse Klaver (GL)",0.975209763539283,0.936305732484076,0
"<anonymized_userid>",1,5115,1912,"Jesse Klaver (GL)",0.975400457665904,0.936795688388045,0
"<anonymized_userid>",1,5116,1913,"Jesse Klaver (GL)",0.975591151792525,0.937285644292014,0
"<anonymized_userid>",1,5117,1914,"Jesse Klaver (GL)",0.975781845919146,0.937775600195982,0
"<anonymized_userid>",1,5118,1915,"Jesse Klaver (GL)",0.975972540045767,0.938265556099951,0
"<anonymized_userid>",1,5119,1916,"Jesse Klaver (GL)",0.976163234172387,0.93875551200392,0
"<anonymized_userid>",1,5120,1917,"Jesse Klaver (GL)",0.976353928299008,0.939245467907888,0
"<anonymized_userid>",1,5121,1918,"Jesse Klaver (GL)",0.976544622425629,0.939735423811857,0
"<anonymized_userid>",1,5122,1919,"Jesse Klaver (GL)",0.97673531655225,0.940225379715826,0
"<anonymized_userid>",1,5123,1920,"Jesse Klaver (GL)",0.976926010678871,0.940715335619794,0
"<anonymized_userid>",1,5124,1921,"Jesse Klaver (GL)",0.977116704805492,0.941205291523763,0
"<anonymized_userid>",1,5125,1922,"Jesse Klaver (GL)",0.977307398932113,0.941695247427731,0
"<anonymized_userid>",1,5126,1923,"Jesse Klaver (GL)",0.977498093058734,0.9421852033317,0
"<anonymized_userid>",1,5127,1924,"Jesse Klaver (GL)",0.977688787185355,0.942675159235669,0
"<anonymized_userid>",1,5128,1925,"Jesse Klaver (GL)",0.977879481311976,0.943165115139637,0
"<anonymized_userid>",1,5129,1926,"Jesse Klaver (GL)",0.978070175438597,0.943655071043606,0
"<anonymized_userid>",1,5130,1927,"Jesse Klaver (GL)",0.978260869565217,0.944145026947575,0
"<anonymized_userid>",1,5131,1928,"Jesse Klaver (GL)",0.978451563691838,0.944634982851543,0
"<anonymized_userid>",1,5132,1929,"Jesse Klaver (GL)",0.978642257818459,0.945124938755512,0
"<anonymized_userid>",1,5133,1930,"Jesse Klaver (GL)",0.97883295194508,0.945614894659481,0
"<anonymized_userid>",1,5134,1931,"Jesse Klaver (GL)",0.979023646071701,0.946104850563449,0
"<anonymized_userid>",1,5135,1932,"Jesse Klaver (GL)",0.979214340198322,0.946594806467418,0
"<anonymized_userid>",1,5136,1933,"Jesse Klaver (GL)",0.979405034324943,0.947084762371387,0
"<anonymized_userid>",1,5137,1934,"Jesse Klaver (GL)",0.979595728451564,0.947574718275355,0
"<anonymized_userid>",1,5138,1935,"Jesse Klaver (GL)",0.979786422578185,0.948064674179324,0
"<anonymized_userid>",1,5139,1936,"Jesse Klaver (GL)",0.979977116704805,0.948554630083293,0
"<anonymized_userid>",1,5140,1937,"Jesse Klaver (GL)",0.980167810831426,0.949044585987261,0
"<anonymized_userid>",1,5141,1938,"Jesse Klaver (GL)",0.980358504958047,0.94953454189123,0
"<anonymized_userid>",1,5142,1939,"Jesse Klaver (GL)",0.980549199084668,0.950024497795198,0
"<anonymized_userid>",1,5143,1940,"Jesse Klaver (GL)",0.980739893211289,0.950514453699167,0
"<anonymized_userid>",1,5144,1941,"Jesse Klaver (GL)",0.98093058733791,0.951004409603136,0
"<anonymized_userid>",1,5145,1942,"Jesse Klaver (GL)",0.981121281464531,0.951494365507104,0
"<anonymized_userid>",1,5146,1943,"Jesse Klaver (GL)",0.981311975591152,0.951984321411073,0
"<anonymized_userid>",1,5147,1944,"Jesse Klaver (GL)",0.981502669717773,0.952474277315042,0
"<anonymized_userid>",1,5148,1945,"Jesse Klaver (GL)",0.981693363844394,0.95296423321901,0
"<anonymized_userid>",1,5149,1946,"Jesse Klaver (GL)",0.981884057971015,0.953454189122979,0
"<anonymized_userid>",1,5150,1947,"Jesse Klaver (GL)",0.982074752097635,0.953944145026948,0
"<anonymized_userid>",1,5151,1948,"Jesse Klaver (GL)",0.982265446224256,0.954434100930916,0
"<anonymized_userid>",1,5152,1949,"Jesse Klaver (GL)",0.982456140350877,0.954924056834885,0
"<anonymized_userid>",1,5153,1950,"Jesse Klaver (GL)",0.982646834477498,0.955414012738854,0
"<anonymized_userid>",1,5154,1951,"Jesse Klaver (GL)",0.982837528604119,0.955903968642822,0
"<anonymized_userid>",1,5155,1952,"Jesse Klaver (GL)",0.98302822273074,0.956393924546791,0
"<anonymized_userid>",1,5156,1953,"Jesse Klaver (GL)",0.983218916857361,0.956883880450759,0
"<anonymized_userid>",1,5157,1954,"Jesse Klaver (GL)",0.983409610983982,0.957373836354728,0
"<anonymized_userid>",1,5158,1955,"Jesse Klaver (GL)",0.983600305110603,0.957863792258697,0
"<anonymized_userid>",1,5159,1956,"Jesse Klaver (GL)",0.983790999237223,0.958353748162665,0
"<anonymized_userid>",1,5160,1957,"Jesse Klaver (GL)",0.983981693363844,0.958843704066634,0
"<anonymized_userid>",1,5161,1958,"Jesse Klaver (GL)",0.984172387490465,0.959333659970603,0
"<anonymized_userid>",1,5162,1959,"Jesse Klaver (GL)",0.984363081617086,0.959823615874571,0
"<anonymized_userid>",1,5163,1960,"Jesse Klaver (GL)",0.984553775743707,0.96031357177854,0
"<anonymized_userid>",1,5164,1961,"Jesse Klaver (GL)",0.984744469870328,0.960803527682509,0
"<anonymized_userid>",1,5165,1962,"Jesse Klaver (GL)",0.984935163996949,0.961293483586477,0
"<anonymized_userid>",1,5166,1963,"Jesse Klaver (GL)",0.98512585812357,0.961783439490446,0
"<anonymized_userid>",1,5167,1964,"Jesse Klaver (GL)",0.985316552250191,0.962273395394414,0
"<anonymized_userid>",1,5168,1965,"Jesse Klaver (GL)",0.985507246376812,0.962763351298383,0
"<anonymized_userid>",1,5169,1966,"Jesse Klaver (GL)",0.985697940503433,0.963253307202352,0
"<anonymized_userid>",1,5170,1967,"Jesse Klaver (GL)",0.985888634630053,0.96374326310632,0
"<anonymized_userid>",1,5171,1968,"Jesse Klaver (GL)",0.986079328756674,0.964233219010289,0
"<anonymized_userid>",1,5172,1969,"Jesse Klaver (GL)",0.986270022883295,0.964723174914258,0
"<anonymized_userid>",1,5173,1970,"Jesse Klaver (GL)",0.986460717009916,0.965213130818226,0
"<anonymized_userid>",1,5174,1971,"Jesse Klaver (GL)",0.986651411136537,0.965703086722195,0
"<anonymized_userid>",1,5175,1972,"Jesse Klaver (GL)",0.986842105263158,0.966193042626164,0
"<anonymized_userid>",1,5176,1973,"Jesse Klaver (GL)",0.987032799389779,0.966682998530132,0
"<anonymized_userid>",1,5177,1974,"Jesse Klaver (GL)",0.9872234935164,0.967172954434101,0
"<anonymized_userid>",1,5178,1975,"Jesse Klaver (GL)",0.987414187643021,0.96766291033807,0
"<anonymized_userid>",1,5179,1976,"Jesse Klaver (GL)",0.987604881769641,0.968152866242038,0
"<anonymized_userid>",1,5180,1977,"Jesse Klaver (GL)",0.987795575896262,0.968642822146007,0
"<anonymized_userid>",1,5181,1978,"Jesse Klaver (GL)",0.987986270022883,0.969132778049976,0
"<anonymized_userid>",1,5182,1979,"Jesse Klaver (GL)",0.988176964149504,0.969622733953944,0
"<anonymized_userid>",1,5183,1980,"Jesse Klaver (GL)",0.988367658276125,0.970112689857913,0
"<anonymized_userid>",1,5184,1981,"Jesse Klaver (GL)",0.988558352402746,0.970602645761881,0
"<anonymized_userid>",1,5185,1982,"Jesse Klaver (GL)",0.988749046529367,0.97109260166585,0
"<anonymized_userid>",1,5186,1983,"Jesse Klaver (GL)",0.988939740655988,0.971582557569819,0
"<anonymized_userid>",1,5187,1984,"Jesse Klaver (GL)",0.989130434782609,0.972072513473787,0
"<anonymized_userid>",1,5188,1985,"Jesse Klaver (GL)",0.98932112890923,0.972562469377756,0
"<anonymized_userid>",1,5189,1986,"Jesse Klaver (GL)",0.989511823035851,0.973052425281725,0
"<anonymized_userid>",1,5190,1987,"Jesse Klaver (GL)",0.989702517162471,0.973542381185693,0
"<anonymized_userid>",1,5191,1988,"Jesse Klaver (GL)",0.989893211289092,0.974032337089662,0
"<anonymized_userid>",1,5192,1989,"Jesse Klaver (GL)",0.990083905415713,0.974522292993631,0
"<anonymized_userid>",1,5193,1990,"Jesse Klaver (GL)",0.990274599542334,0.975012248897599,0
"<anonymized_userid>",1,5194,1991,"Jesse Klaver (GL)",0.990465293668955,0.975502204801568,0
"<anonymized_userid>",1,5195,1992,"Jesse Klaver (GL)",0.990655987795576,0.975992160705537,0
"<anonymized_userid>",1,5196,1993,"Jesse Klaver (GL)",0.990846681922197,0.976482116609505,0
"<anonymized_userid>",1,5197,1994,"Jesse Klaver (GL)",0.991037376048818,0.976972072513474,0
"<anonymized_userid>",1,5198,1995,"Jesse Klaver (GL)",0.991228070175439,0.977462028417442,0
"<anonymized_userid>",1,5199,1996,"Jesse Klaver (GL)",0.99141876430206,0.977951984321411,0
"<anonymized_userid>",1,5200,1997,"Jesse Klaver (GL)",0.99160945842868,0.97844194022538,0
"<anonymized_userid>",1,5201,1998,"Jesse Klaver (GL)",0.991800152555301,0.978931896129348,0
"<anonymized_userid>",1,5202,1999,"Jesse Klaver (GL)",0.991990846681922,0.979421852033317,0
"<anonymized_userid>",1,5203,2000,"Jesse Klaver (GL)",0.992181540808543,0.979911807937286,0
"<anonymized_userid>",1,5204,2001,"Jesse Klaver (GL)",0.992372234935164,0.980401763841254,0
"<anonymized_userid>",1,5205,2002,"Jesse Klaver (GL)",0.992562929061785,0.980891719745223,0
"<anonymized_userid>",1,5206,2003,"Jesse Klaver (GL)",0.992753623188406,0.981381675649192,0
"<anonymized_userid>",1,5207,2004,"Jesse Klaver (GL)",0.992944317315027,0.98187163155316,0
"<anonymized_userid>",1,5208,2005,"Jesse Klaver (GL)",0.993135011441648,0.982361587457129,0
"<anonymized_userid>",1,5209,2006,"Jesse Klaver (GL)",0.993325705568268,0.982851543361097,0
"<anonymized_userid>",1,5210,2007,"Jesse Klaver (GL)",0.993516399694889,0.983341499265066,0
"<anonymized_userid>",1,5211,2008,"Jesse Klaver (GL)",0.99370709382151,0.983831455169035,0
"<anonymized_userid>",1,5212,2009,"Jesse Klaver (GL)",0.993897787948131,0.984321411073003,0
"<anonymized_userid>",1,5213,2010,"Jesse Klaver (GL)",0.994088482074752,0.984811366976972,0
"<anonymized_userid>",1,5214,2011,"Jesse Klaver (GL)",0.994279176201373,0.985301322880941,0
"<anonymized_userid>",1,5215,2012,"Jesse Klaver (GL)",0.994469870327994,0.985791278784909,0
"<anonymized_userid>",1,5216,2013,"Jesse Klaver (GL)",0.994660564454615,0.986281234688878,0
"<anonymized_userid>",1,5217,2014,"Jesse Klaver (GL)",0.994851258581236,0.986771190592847,0
"<anonymized_userid>",1,5218,2015,"Jesse Klaver (GL)",0.995041952707857,0.987261146496815,0
"<anonymized_userid>",1,5219,2016,"Jesse Klaver (GL)",0.995232646834478,0.987751102400784,0
"<anonymized_userid>",1,5220,2017,"Jesse Klaver (GL)",0.995423340961098,0.988241058304753,0
"<anonymized_userid>",1,5221,2018,"Jesse Klaver (GL)",0.995614035087719,0.988731014208721,0
"<anonymized_userid>",1,5222,2019,"Jesse Klaver (GL)",0.99580472921434,0.98922097011269,0
"<anonymized_userid>",1,5223,2020,"Jesse Klaver (GL)",0.995995423340961,0.989710926016659,0
"<anonymized_userid>",1,5224,2021,"Jesse Klaver (GL)",0.996186117467582,0.990200881920627,0
"<anonymized_userid>",1,5225,2022,"Jesse Klaver (GL)",0.996376811594203,0.990690837824596,0
"<anonymized_userid>",1,5226,2023,"Jesse Klaver (GL)",0.996567505720824,0.991180793728564,0
"<anonymized_userid>",1,5227,2024,"Jesse Klaver (GL)",0.996758199847445,0.991670749632533,0
"<anonymized_userid>",1,5228,2025,"Jesse Klaver (GL)",0.996948893974066,0.992160705536502,0
"<anonymized_userid>",1,5229,2026,"Jesse Klaver (GL)",0.997139588100686,0.99265066144047,0
"<anonymized_userid>",1,5230,2027,"Jesse Klaver (GL)",0.997330282227307,0.993140617344439,0
"<anonymized_userid>",1,5231,2028,"Jesse Klaver (GL)",0.997520976353928,0.993630573248408,0
"<anonymized_userid>",1,5232,2029,"Jesse Klaver (GL)",0.997711670480549,0.994120529152376,0
"<anonymized_userid>",1,5233,2030,"Jesse Klaver (GL)",0.99790236460717,0.994610485056345,0
"<anonymized_userid>",1,5234,2031,"Jesse Klaver (GL)",0.998093058733791,0.995100440960314,0
"<anonymized_userid>",1,5235,2032,"Jesse Klaver (GL)",0.998283752860412,0.995590396864282,0
"<anonymized_userid>",1,5236,2033,"Jesse Klaver (GL)",0.998474446987033,0.996080352768251,0
"<anonymized_userid>",1,5237,2034,"Jesse Klaver (GL)",0.998665141113654,0.99657030867222,0
"<anonymized_userid>",1,5238,2035,"Jesse Klaver (GL)",0.998855835240275,0.997060264576188,0
"<anonymized_userid>",1,5239,2036,"Jesse Klaver (GL)",0.999046529366896,0.997550220480157,0
"<anonymized_userid>",1,5240,2037,"Jesse Klaver (GL)",0.999237223493516,0.998040176384125,0
"<anonymized_userid>",1,5241,2038,"Jesse Klaver (GL)",0.999427917620137,0.998530132288094,0
"<anonymized_userid>",1,5242,2039,"Jesse Klaver (GL)",0.999618611746758,0.999020088192063,0
"<anonymized_userid>",1,5243,2040,"Jesse Klaver (GL)",0.999809305873379,0.999510044096031,0
"<anonymized_userid>",1,5244,2041,"Jesse Klaver (GL)",1,1,0
